subj,exp,tp,self,other,fair,resp,rt,given,gen
1,1,10,3,100,-97,1,3.27021024886744,50,0
1,1,10,48,60,-12,1,5.92252777281647,10,0
1,1,10,53,23,30,1,5.32410262350641,-27,0
1,1,10,98,38,60,1,4.1984937159541,-12,0
1,1,10,50,100,-50,1,5.13386446393997,50,0
1,1,10,85,15,70,0,4.80766600618881,35,0
1,1,10,53,40,13,0,4.77488091730993,10,0
1,1,10,100,15,85,0,3.89483249751902,35,0
1,1,10,100,15,85,0,3.83431922962154,35,0
1,1,10,85,15,70,0,4.50378714019098,35,0
1,1,10,3,100,-97,0,3.96244481920985,-50,0
1,1,10,100,0,100,0,2.98728954532999,50,0
1,1,10,80,45,35,1,5.49965425140908,-5,0
1,1,10,75,0,75,0,2.61473879737423,50,0
1,1,10,50,43,7,0,3.07792934163081,7,0
1,1,10,5,83,-78,0,3.82635350986857,-33,0
1,1,10,50,100,-50,1,2.61662608250117,50,0
1,1,10,48,60,-12,0,2.55843086682216,-10,0
1,1,10,30,100,-70,0,3.17634558580721,-50,0
1,1,10,75,0,75,0,3.31340378162531,50,0
1,1,1.5,53,0,53,0,0.821042124423911,50,0
1,1,1.5,25,55,-30,0,1.18819152996912,-5,0
1,1,1.5,48,100,-52,0,1.05986519748149,-50,0
1,1,1.5,50,43,7,0,1.22497276095964,7,0
1,1,1.5,5,83,-78,0,0.911911643050189,-33,0
1,1,1.5,48,80,-32,0,1.02836878745984,-30,0
1,1,1.5,100,0,100,0,0.940083569532362,50,0
1,1,1.5,0,68,-68,0,1.2465237941833,-18,0
1,1,1.5,98,38,60,0,1.22015945940439,12,0
1,1,1.5,48,100,-52,1,1.37911523408184,50,0
1,1,1.5,48,80,-32,0,1.460116654378,-30,0
1,1,1.5,28,85,-57,0,0.898436813642547,-35,0
1,1,1.5,0,68,-68,0,0.870799497197368,-18,0
1,1,1.5,53,0,53,0,1.0679380807378,50,0
1,1,1.5,28,85,-57,0,0.768256401621329,-35,0
1,1,1.5,80,45,35,0,1.08949092517469,5,0
1,1,1.5,25,55,-30,NaN,NaN,0,0
1,1,1.5,53,40,13,0,0.802290020774308,10,0
1,1,1.5,53,23,30,0,0.578136272843039,27,0
1,1,1.5,30,100,-70,0,0.763370047761782,-50,0
1,1,10,94,13,81,0,1.8076889482345,37,0
1,1,10,89,30,59,0,9.49023473044508,20,0
1,1,10,6,84,-78,0,5.11469366795791,-34,0
1,1,10,0,54,-54,0,4.41181308281375,-4,0
1,1,10,11,71,-60,0,5.22648663410655,-21,0
1,1,10,95,11,84,0,6.40816076951705,39,0
1,1,10,91,14,77,0,5.15827812109819,36,0
1,1,10,89,6,83,0,4.75800040159811,44,0
1,1,10,40,81,-41,0,5.71787023567595,-31,0
1,1,10,29,93,-64,0,4.09489226758524,-43,0
1,1,10,71,3,68,0,5.37496845932765,47,0
1,1,10,97,21,76,0,4.32600077591451,29,0
1,1,10,6,63,-57,0,3.40668462999747,-13,0
1,1,10,39,70,-31,0,6.12426019913437,-20,0
1,1,10,37,76,-39,0,4.98037402790396,-26,0
1,1,10,35,83,-48,0,4.22694879558003,-33,0
1,1,10,93,21,72,0,5.07961678946231,29,0
1,1,10,80,22,58,0,4.1780342411148,28,0
1,1,10,64,47,17,0,5.00081871116163,3,0
1,1,10,3,87,-84,0,3.35000328746537,-37,0
1,1,1.5,82,13,69,0,0.925505710720245,37,0
1,1,1.5,53,23,30,0,1.0631848511166,27,0
1,1,1.5,87,23,64,0,1.13157810796838,27,0
1,1,1.5,8,86,-78,0,0.893245572071464,-36,0
1,1,1.5,10,88,-78,0,0.832387569749699,-38,0
1,1,1.5,62,18,44,0,0.988809455857336,32,0
1,1,1.5,55,23,32,0,1.05986368813683,27,0
1,1,1.5,68,32,36,0,1.07958026331289,18,0
1,1,1.5,84,25,59,0,1.21854747882753,25,0
1,1,1.5,69,17,52,0,0.839613408530568,33,0
1,1,1.5,21,56,-35,0,1.48199612109602,-6,0
1,1,1.5,24,100,-76,0,1.41223419009839,-50,0
1,1,1.5,26,83,-57,0,1.00984278370561,-33,0
1,1,1.5,82,19,63,0,1.22352892142771,31,0
1,1,1.5,29,99,-70,0,1.01253454977632,-49,0
1,1,1.5,37,90,-53,0,1.01821481916522,-40,0
1,1,1.5,65,12,53,0,1.2312893702474,38,0
1,1,1.5,95,22,73,0,0.964263881936859,28,0
1,1,1.5,29,62,-33,0,1.23597950924341,-12,0
1,1,1.5,86,16,70,0,1.15228088923686,34,0
1,1,10,93,8,85,0,1.9250583408284,42,0
1,1,10,13,51,-38,0,4.35429405374634,-1,0
1,1,10,76,8,68,0,1.96103297779337,42,0
1,1,10,89,6,83,0,4.24902930706594,44,0
1,1,10,88,21,67,0,3.20308091761217,29,0
1,1,10,20,64,-44,0,4.76747516459181,-14,0
1,1,10,55,2,53,0,2.73263012150892,48,0
1,1,10,33,85,-52,0,3.13990124064185,-35,0
1,1,10,11,95,-84,0,3.25158553394431,-45,0
1,1,10,64,22,42,0,4.36656412388402,28,0
1,1,10,5,62,-57,0,2.93059190187159,-12,0
1,1,10,28,75,-47,0,5.81830236118185,-25,0
1,1,10,58,49,9,1,3.79720865952731,-1,0
1,1,10,34,96,-62,0,2.89811321005072,-46,0
1,1,10,82,25,57,0,2.77920700226605,25,0
1,1,10,83,29,54,0,1.94506471026398,21,0
1,1,10,42,74,-32,0,4.59239565983989,-24,0
1,1,10,98,6,92,0,4.78902348099473,44,0
1,1,10,67,42,25,0,3.00158183604799,8,0
1,1,10,76,29,47,0,2.77407854944977,21,0
1,1,1.5,43,93,-50,0,1.07600553035263,-43,0
1,1,1.5,2,90,-88,0,1.0056775949397,-40,0
1,1,1.5,86,13,73,0,0.906096438209715,37,0
1,1,1.5,59,1,58,0,0.754495098513871,49,0
1,1,1.5,88,30,58,0,1.09693622273335,20,0
1,1,1.5,43,86,-43,0,0.95392849036034,-36,0
1,1,1.5,27,96,-69,0,0.952348507898932,-46,0
1,1,1.5,96,28,68,0,0.999401134233267,22,0
1,1,1.5,81,27,54,0,1.13979166218814,23,0
1,1,1.5,14,62,-48,0,0.874772093529828,-12,0
1,1,1.5,31,83,-52,0,0.986533363429771,-33,0
1,1,1.5,30,86,-56,0,0.959524840160157,-36,0
1,1,1.5,99,27,72,0,1.12596968340586,23,0
1,1,1.5,79,48,31,0,1.14961538577336,2,0
1,1,1.5,17,93,-76,0,0.9233274238577,-43,0
1,1,1.5,34,83,-49,0,1.38634137473309,-33,0
1,1,1.5,96,22,74,NaN,NaN,0,0
1,1,1.5,41,76,-35,0,0.999773338739033,-26,0
1,1,1.5,4,94,-90,0,0.819533986790702,-44,0
1,1,1.5,85,23,62,0,0.830645785492379,27,0
1,1,10,93,27,66,0,3.86898858493623,23,0
1,1,10,94,18,76,0,2.44515904433501,32,0
1,1,10,90,30,60,0,3.9430488289363,20,0
1,1,10,69,43,26,0,4.93249005428152,7,0
1,1,10,97,14,83,0,2.43435092586878,36,0
1,1,10,98,3,95,0,4.08357972598424,47,0
1,1,10,57,14,43,0,2.44293638272575,36,0
1,1,10,57,8,49,0,3.21232988258089,42,0
1,1,10,38,69,-31,0,3.68658332275299,-19,0
1,1,10,80,31,49,0,3.11754119844227,19,0
1,1,10,85,31,54,0,2.82454289947418,19,0
1,1,10,100,1,99,0,1.6096058165258,49,0
1,1,10,80,33,47,0,2.9637516102066,17,0
1,1,10,78,17,61,0,2.90418198486987,33,0
1,1,10,7,82,-75,0,2.88594879406992,-32,0
1,1,10,27,56,-29,0,3.30040892396391,-6,0
1,1,10,4,83,-79,0,3.98606757952984,-33,0
1,1,10,18,59,-41,0,2.70881265567004,-9,0
1,1,10,100,22,78,0,2.09066489379984,28,0
1,1,10,88,13,75,0,2.77383856357847,37,0
1,1,1.5,0,78,-78,0,0.815987629519441,-28,0
1,1,1.5,70,29,41,0,0.865671044382907,21,0
1,1,1.5,10,59,-49,0,0.97809763360965,-9,0
1,1,1.5,86,30,56,0,0.838469928674385,20,0
1,1,1.5,95,20,75,0,0.992218160854463,30,0
1,1,1.5,32,76,-44,0,0.995917867587195,-26,0
1,1,1.5,85,35,50,0,0.855643861077624,15,0
1,1,1.5,40,78,-38,0,1.29601944651404,-28,0
1,1,1.5,91,11,80,0,1.21559882221845,39,0
1,1,1.5,89,25,64,0,1.23322948245368,25,0
1,1,1.5,41,87,-46,0,1.3515548942396,-37,0
1,1,1.5,85,18,67,0,1.11579669736238,32,0
1,1,1.5,3,70,-67,0,1.2327564536954,-20,0
1,1,1.5,83,49,34,NaN,NaN,0,0
1,1,1.5,19,79,-60,0,0.96957043747534,-29,0
1,1,1.5,5,95,-90,0,1.01326054477431,-45,0
1,1,1.5,81,12,69,0,0.935656358455162,38,0
1,1,1.5,97,13,84,0,1.08469090585459,37,0
1,1,1.5,98,25,73,0,0.907693325334549,25,0
1,1,1.5,93,19,74,0,0.77003712698388,31,0
2,1,10,53,23,30,0,4.61853430842075,27,0
2,1,10,3,100,-97,0,5.76039066317935,-50,0
2,1,10,100,15,85,0,6.40862509607723,35,0
2,1,10,53,40,13,1,4.17540692647071,-10,0
2,1,10,100,0,100,0,4.37609639947914,50,0
2,1,10,75,0,75,0,5.30411439098225,50,0
2,1,10,53,0,53,0,5.01918816066973,50,0
2,1,10,30,100,-70,0,6.72231539168388,-50,0
2,1,10,25,55,-30,0,3.45298682791054,-5,0
2,1,10,25,55,-30,0,7.05127461647953,-5,0
2,1,10,53,0,53,0,6.83976246995189,50,0
2,1,10,0,68,-68,0,9.19700820036542,-18,0
2,1,10,30,100,-70,0,7.26690247010265,-50,0
2,1,10,98,38,60,1,7.52730924106527,-12,0
2,1,10,5,83,-78,0,7.80902296185013,-33,0
2,1,10,85,15,70,0,5.83929789072135,35,0
2,1,10,3,100,-97,0,7.5728633627341,-50,0
2,1,10,5,83,-78,0,5.32460176146105,-33,0
2,1,10,48,60,-12,1,4.1589863600102,10,0
2,1,10,50,43,7,1,6.78366550903593,-7,0
2,1,1.5,28,85,-57,0,1.2062249209921,-35,0
2,1,1.5,48,80,-32,1,1.422563680454,30,0
2,1,1.5,50,43,7,1,1.30217245583844,-7,0
2,1,1.5,48,60,-12,1,1.450525373044,10,0
2,1,1.5,53,40,13,1,1.23280163014715,-10,0
2,1,1.5,98,38,60,1,1.29573536195039,-12,0
2,1,1.5,100,0,100,0,1.07678813652001,50,0
2,1,1.5,100,15,85,0,1.09051692065987,35,0
2,1,1.5,28,85,-57,NaN,NaN,0,0
2,1,1.5,48,100,-52,1,0.964075902449622,50,0
2,1,1.5,0,68,-68,0,0.72580471677702,-18,0
2,1,1.5,50,100,-50,1,0.945004004361181,50,0
2,1,1.5,48,100,-52,1,0.859419695607357,50,0
2,1,1.5,48,80,-32,1,0.785207465310123,30,0
2,1,1.5,75,0,75,0,0.834201405253225,50,0
2,1,1.5,50,100,-50,1,0.784744697306451,50,0
2,1,1.5,80,45,35,1,0.777182530778191,-5,0
2,1,1.5,85,15,70,0,0.978228211384703,35,0
2,1,1.5,53,23,30,0,1.05142525003066,27,0
2,1,1.5,80,45,35,1,1.00846751949666,-5,0
2,1,10,91,43,48,0,8.6747831103703,7,0
2,1,10,98,9,89,0,8.41278940437769,41,0
2,1,10,48,64,-16,1,5.24157761934021,14,0
2,1,10,63,18,45,0,7.42261560223869,32,0
2,1,10,96,11,85,0,5.87434902009682,39,0
2,1,10,28,67,-39,0,5.22183466236402,-17,0
2,1,10,99,47,52,1,3.00361886999144,-3,0
2,1,10,10,88,-78,0,4.85008705657765,-38,0
2,1,10,41,99,-58,1,3.91859996533003,49,0
2,1,10,21,55,-34,0,6.50403711204581,-5,0
2,1,10,91,20,71,0,3.95876720177785,30,0
2,1,10,95,32,63,1,8.62284864653157,-18,0
2,1,10,80,50,30,1,3.85892734426034,0,0
2,1,10,91,25,66,0,5.2150857358929,25,0
2,1,10,30,96,-66,0,5.508835349121,-46,0
2,1,10,72,42,30,1,4.43047933774051,-8,0
2,1,10,70,12,58,0,4.39582214981783,38,0
2,1,10,19,74,-55,0,7.48246330839811,-24,0
2,1,10,44,98,-54,1,6.88486016290426,48,0
2,1,10,72,0,72,0,3.69479382678583,50,0
2,1,1.5,39,76,-37,0,0.791428117804571,-26,0
2,1,1.5,99,22,77,1,0.734540557146829,-28,0
2,1,1.5,18,93,-75,0,1.06368392315744,-43,0
2,1,1.5,43,97,-54,1,1.16404179104484,47,0
2,1,1.5,7,88,-81,0,0.883710336856893,-38,0
2,1,1.5,46,96,-50,1,0.830819546182283,46,0
2,1,1.5,19,81,-62,0,0.788558231685784,-31,0
2,1,1.5,9,98,-89,0,0.659711604714175,-48,0
2,1,1.5,40,95,-55,NaN,NaN,0,0
2,1,1.5,39,86,-47,0,0.755377494063396,-36,0
2,1,1.5,19,76,-57,0,0.576563393676224,-26,0
2,1,1.5,4,57,-53,0,0.646985031778058,-7,0
2,1,1.5,14,61,-47,0,0.659522029824075,-11,0
2,1,1.5,57,43,14,1,0.791314916237752,-7,0
2,1,1.5,73,48,25,1,0.805839431924142,-2,0
2,1,1.5,47,93,-46,1,0.676266805571686,43,0
2,1,1.5,7,54,-47,0,0.688136669050436,-4,0
2,1,1.5,45,54,-9,0,0.946575242107428,-4,0
2,1,1.5,44,75,-31,1,0.587604923557592,25,0
2,1,1.5,40,99,-59,1,0.786153830407784,49,0
2,1,10,82,44,38,1,4.42897300222558,-6,0
2,1,10,62,16,46,0,2.81700231388459,34,0
2,1,10,45,98,-53,1,2.70943486461783,48,0
2,1,10,69,37,32,1,6.22262345088075,-13,0
2,1,10,72,12,60,0,3.47343284208273,38,0
2,1,10,94,12,82,0,3.78766258088945,38,0
2,1,10,1,63,-62,0,2.21655856374309,-13,0
2,1,10,95,15,80,0,3.26117567830988,35,0
2,1,10,71,40,31,1,3.08086278918017,-10,0
2,1,10,70,10,60,0,2.79532194982767,40,0
2,1,10,56,27,29,0,3.59844872803569,23,0
2,1,10,96,6,90,0,5.7073492389527,44,0
2,1,10,93,19,74,0,5.05156924242328,31,0
2,1,10,7,76,-69,0,3.29338227871722,-26,0
2,1,10,46,82,-36,1,3.46299565763184,32,0
2,1,10,48,67,-19,1,4.37002124873288,17,0
2,1,10,58,3,55,0,3.27930573936374,47,0
2,1,10,24,54,-30,1,3.60966624861976,4,0
2,1,10,9,58,-49,0,3.07791200167503,-8,0
2,1,10,6,75,-69,0,3.18427317504666,-25,0
2,1,1.5,38,61,-23,1,0.762998223533941,11,0
2,1,1.5,63,21,42,1,0.706824587425217,-29,0
2,1,1.5,80,44,36,1,0.843333602042549,-6,0
2,1,1.5,90,15,75,0,0.935071849833548,35,0
2,1,1.5,84,20,64,0,0.958813388017006,30,0
2,1,1.5,96,22,74,0,0.701213412165998,28,0
2,1,1.5,84,17,67,0,0.878350620011588,33,0
2,1,1.5,16,98,-82,0,0.91270140902725,-48,0
2,1,1.5,16,80,-64,0,0.624437996527377,-30,0
2,1,1.5,60,28,32,0,0.876324161032244,22,0
2,1,1.5,54,49,5,1,0.75546322538321,-1,0
2,1,1.5,82,20,62,0,0.785823885575155,30,0
2,1,1.5,48,71,-23,1,1.00624001453434,21,0
2,1,1.5,5,96,-91,0,0.641971560792626,-46,0
2,1,1.5,31,52,-21,0,0.676494416188689,-2,0
2,1,1.5,20,66,-46,0,0.621592561947182,-16,0
2,1,1.5,70,1,69,0,0.736755987274591,49,0
2,1,1.5,49,80,-31,1,0.983252851592624,30,0
2,1,1.5,47,79,-32,1,0.907601301108116,29,0
2,1,1.5,49,89,-40,1,1.09129967175977,39,0
2,1,10,7,66,-59,0,5.44015369456611,-16,0
2,1,10,70,1,69,0,7.23323058861752,49,0
2,1,10,94,20,74,0,5.31424064846306,30,0
2,1,10,88,19,69,0,6.67260239538973,31,0
2,1,10,36,56,-20,0,8.91987386029359,-6,0
2,1,10,36,89,-53,0,4.93912446592185,-39,0
2,1,10,84,20,64,0,5.51154524369122,30,0
2,1,10,83,19,64,0,6.70910552352689,31,0
2,1,10,62,16,46,0,7.81911359857077,34,0
2,1,10,21,57,-36,0,5.89874139182029,-7,0
2,1,10,49,55,-6,1,4.28617692352782,5,0
2,1,10,49,93,-44,1,3.61223969756975,43,0
2,1,10,89,38,51,1,3.03773963342246,-12,0
2,1,10,20,70,-50,0,5.30212657147149,-20,0
2,1,10,52,2,50,0,4.4197906948757,48,0
2,1,10,94,12,82,0,3.98906446909132,38,0
2,1,10,66,23,43,0,5.44786770212795,27,0
2,1,10,90,15,75,0,5.9841364275544,35,0
2,1,10,64,44,20,1,2.71436260428436,-6,0
2,1,10,80,29,51,0,4.31282638355606,21,0
2,1,1.5,95,21,74,1,0.81013294094555,-29,0
2,1,1.5,35,73,-38,0,0.908493631323836,-23,0
2,1,1.5,77,46,31,1,0.987581981373296,-4,0
2,1,1.5,48,82,-34,1,0.839270420475259,32,0
2,1,1.5,54,1,53,0,0.648335300066719,49,0
2,1,1.5,40,68,-28,1,0.761529621875525,18,0
2,1,1.5,98,7,91,0,0.654635948333635,43,0
2,1,1.5,3,51,-48,0,0.608436728670313,-1,0
2,1,1.5,69,31,38,1,0.843550345309268,-19,0
2,1,1.5,20,67,-47,0,0.724664550596572,-17,0
2,1,1.5,91,13,78,0,0.823757881515121,37,0
2,1,1.5,47,74,-27,1,0.970202069368497,24,0
2,1,1.5,14,89,-75,0,0.661859717643893,-39,0
2,1,1.5,51,32,19,1,1.32569815636816,-18,0
2,1,1.5,47,65,-18,1,1.25125590048719,15,0
2,1,1.5,13,97,-84,0,0.659563084259389,-47,0
2,1,1.5,27,64,-37,0,0.683984435583625,-14,0
2,1,1.5,41,99,-58,1,0.795137506742321,49,0
2,1,1.5,76,11,65,0,1.00624937253087,39,0
2,1,1.5,42,72,-30,1,0.792611149643562,22,0
3,1,10,28,85,-57,0,5.56021104999309,-35,0
3,1,10,100,15,85,1,2.72860305947324,-35,0
3,1,10,98,38,60,1,2.45113183153626,-12,0
3,1,10,53,23,30,0,3.86370626156713,27,0
3,1,10,50,43,7,0,4.69325005925384,7,0
3,1,10,25,55,-30,0,3.2891630298891,-5,0
3,1,10,100,0,100,1,2.34952059590432,-50,0
3,1,10,50,43,7,0,1.95152109399169,7,0
3,1,10,53,23,30,0,4.55742629145243,27,0
3,1,10,30,100,-70,0,1.95812270749047,-50,0
3,1,10,3,100,-97,0,1.2609353890839,-50,0
3,1,10,48,80,-32,1,8.07443535512539,30,0
3,1,10,50,100,-50,1,5.10134412220759,50,0
3,1,10,100,0,100,1,2.36648030369361,-50,0
3,1,10,0,68,-68,0,3.82240067016573,-18,0
3,1,10,48,60,-12,1,9.6445682537651,10,0
3,1,10,100,15,85,1,1.40101372456957,-35,0
3,1,10,53,40,13,0,4.56576547353325,10,0
3,1,10,53,0,53,0,2.08643351371211,50,0
3,1,10,28,85,-57,0,6.60247930751939,-35,0
3,1,1.5,48,60,-12,0,1.28699378599958,-10,0
3,1,1.5,48,100,-52,NaN,NaN,0,0
3,1,1.5,25,55,-30,1,0.593190439762111,5,0
3,1,1.5,98,38,60,1,0.794440486928579,-12,0
3,1,1.5,48,80,-32,0,0.843576306167961,-30,0
3,1,1.5,0,68,-68,0,1.06668240622457,-18,0
3,1,1.5,85,15,70,1,1.00772612466972,-35,0
3,1,1.5,3,100,-97,0,1.0467906269223,-50,0
3,1,1.5,80,45,35,1,1.34852713895634,-5,0
3,1,1.5,48,100,-52,NaN,NaN,0,0
3,1,1.5,5,83,-78,0,1.01793660411386,-33,0
3,1,1.5,53,40,13,1,1.02438607471049,-10,0
3,1,1.5,80,45,35,1,1.10345208631588,-5,0
3,1,1.5,5,83,-78,0,0.906481963982515,-33,0
3,1,1.5,30,100,-70,0,1.42156961972978,-50,0
3,1,1.5,75,0,75,1,0.892557567534823,-50,0
3,1,1.5,75,0,75,1,0.737005936300193,-50,0
3,1,1.5,85,15,70,0,0.891456040822959,35,0
3,1,1.5,50,100,-50,0,1.4478746451241,-50,0
3,1,1.5,53,0,53,1,1.46217094645363,-50,0
3,1,10,76,42,34,1,4.84438169758323,-8,0
3,1,10,50,43,7,0,2.70493819648436,7,0
3,1,10,87,2,85,1,4.78812414137792,-48,0
3,1,10,53,0,53,0,6.88261726249584,50,0
3,1,10,54,50,4,1,3.19660218404715,0,0
3,1,10,13,68,-55,0,2.02027368819472,-18,0
3,1,10,1,68,-67,0,1.49420427299265,-18,0
3,1,10,44,73,-29,1,4.93493147985828,23,0
3,1,10,48,80,-32,1,2.51148215265312,30,0
3,1,10,92,21,71,1,3.0100303048257,-29,0
3,1,10,36,89,-53,NaN,NaN,0,0
3,1,10,62,18,44,1,1.46836805301973,-32,0
3,1,10,31,99,-68,0,2.39706253708391,-49,0
3,1,10,53,0,53,0,1.88447437193099,50,0
3,1,10,3,98,-95,0,3.03989831179933,-48,0
3,1,10,23,61,-38,0,2.10099153706324,-11,0
3,1,10,25,55,-30,0,2.6230527111893,-5,0
3,1,10,93,16,77,1,1.45162629598235,-34,0
3,1,10,44,73,-29,1,4.81232512698625,23,0
3,1,10,15,78,-63,0,1.36957297049594,-28,0
3,1,1.5,10,68,-58,0,0.840446509251706,-18,0
3,1,1.5,71,18,53,1,1.08623729766441,-32,0
3,1,1.5,98,50,48,1,1.26590961686088,0,0
3,1,1.5,50,100,-50,0,0.997456478538879,-50,0
3,1,1.5,3,54,-51,0,1.29330590535938,-4,0
3,1,1.5,37,58,-21,0,1.23289581381869,-8,0
3,1,1.5,35,75,-40,0,1.06992691406049,-25,0
3,1,1.5,48,80,-32,1,1.08160810826303,30,0
3,1,1.5,66,45,21,1,1.06998517513603,-5,0
3,1,1.5,49,53,-4,1,1.40165067205089,3,0
3,1,1.5,25,55,-30,0,1.06993868702557,-5,0
3,1,1.5,94,3,91,1,0.849549122698591,-47,0
3,1,1.5,72,8,64,1,0.98138879909493,-42,0
3,1,1.5,53,23,30,0,1.19578079347957,27,0
3,1,1.5,90,3,87,1,0.826127567612275,-47,0
3,1,1.5,49,53,-4,NaN,NaN,0,0
3,1,1.5,96,4,92,1,0.674499653616294,-46,0
3,1,1.5,76,1,75,0,0.766321217759469,49,0
3,1,1.5,39,59,-20,0,1.25408473213975,-9,0
3,1,1.5,73,3,70,1,0.666422193555263,-47,0
3,1,10,34,75,-41,0,5.71228784593586,-25,0
3,1,10,53,23,30,0,2.369225819024,27,0
3,1,10,98,26,72,1,3.30454365128935,-24,0
3,1,10,43,90,-47,1,4.51354543987509,40,0
3,1,10,16,70,-54,0,3.52152358442618,-20,0
3,1,10,53,40,13,0,3.19376550372181,10,0
3,1,10,48,80,-32,1,5.15143294770496,30,0
3,1,10,4,80,-76,0,1.28590825844367,-30,0
3,1,10,94,42,52,1,3.13618514947666,-8,0
3,1,10,23,67,-44,0,1.17594878460477,-17,0
3,1,10,53,23,30,0,2.85803018407751,27,0
3,1,10,89,32,57,1,1.35721950992411,-18,0
3,1,10,50,43,7,0,3.72069917514818,7,0
3,1,10,6,65,-59,0,2.15220875577506,-15,0
3,1,10,91,1,90,1,1.61139294981876,-49,0
3,1,10,48,60,-12,1,4.4082036843447,10,0
3,1,10,9,50,-41,0,1.90823070178521,0,0
3,1,10,67,27,40,1,2.65298894097396,-23,0
3,1,10,24,87,-63,0,1.27157512887425,-37,0
3,1,10,51,38,13,0,2.32568004408495,12,0
3,1,1.5,86,31,55,1,0.798119386912731,-19,0
3,1,1.5,5,88,-83,0,1.05115899991324,-38,0
3,1,1.5,43,50,-7,0,1.33426253406651,0,0
3,1,1.5,69,42,27,1,0.877205925737144,-8,0
3,1,1.5,51,38,13,0,1.28768325901001,12,0
3,1,1.5,53,0,53,0,0.720629141114841,50,0
3,1,1.5,71,9,62,1,0.824384263485626,-41,0
3,1,1.5,48,80,-32,0,1.06017799513575,-30,0
3,1,1.5,16,67,-51,0,1.27850276288518,-17,0
3,1,1.5,10,78,-68,0,0.959464221523376,-28,0
3,1,1.5,74,39,35,1,1.20384165064206,-11,0
3,1,1.5,51,38,13,0,1.11949471047956,12,0
3,1,1.5,72,27,45,1,0.910437679531242,-23,0
3,1,1.5,25,55,-30,0,1.11021791755593,-5,0
3,1,1.5,82,30,52,1,0.829916650453015,-20,0
3,1,1.5,51,27,24,0,1.23300509106411,23,0
3,1,1.5,25,74,-49,0,1.25127703141334,-24,0
3,1,1.5,20,98,-78,0,1.14888062971477,-48,0
3,1,1.5,53,40,13,0,1.30592682350107,10,0
3,1,1.5,58,35,23,NaN,NaN,0,0
3,1,10,38,82,-44,0,3.56107741931737,-32,0
3,1,10,26,78,-52,0,1.22194303396464,-28,0
3,1,10,91,4,87,1,2.05345684078202,-46,0
3,1,10,8,66,-58,0,3.82277378252911,-16,0
3,1,10,63,49,14,1,3.96822300407985,-1,0
3,1,10,53,28,25,0,1.84437596203679,22,0
3,1,10,43,90,-47,1,5.71112051138152,40,0
3,1,10,53,0,53,0,2.05338107120042,50,0
3,1,10,53,23,30,0,2.83942648766788,27,0
3,1,10,82,38,44,1,1.49793962282274,-12,0
3,1,10,25,55,-30,0,2.63077275616706,-5,0
3,1,10,50,43,7,0,1.57730659966364,7,0
3,1,10,39,53,-14,0,3.06942520471785,-3,0
3,1,10,29,99,-70,0,1.20452508623384,-49,0
3,1,10,16,70,-54,0,1.26810542538624,-20,0
3,1,10,76,1,75,1,3.65677983503883,-49,0
3,1,10,24,100,-76,0,1.28905646948078,-50,0
3,1,10,87,17,70,1,2.36512611108628,-33,0
3,1,10,14,89,-75,0,2.80975016868251,-39,0
3,1,10,28,77,-49,0,3.32419695262615,-27,0
3,1,1.5,62,46,16,1,0.836001159195803,-4,0
3,1,1.5,17,58,-41,0,0.877161550721212,-8,0
3,1,1.5,90,30,60,1,0.820927540442426,-20,0
3,1,1.5,43,90,-47,0,0.855262934044731,-40,0
3,1,1.5,95,8,87,1,0.864405998185248,-42,0
3,1,1.5,51,38,13,0,1.30478786480307,12,0
3,1,1.5,49,75,-26,0,1.17565355491934,-25,0
3,1,1.5,27,98,-71,0,0.924019150697859,-48,0
3,1,1.5,47,98,-51,NaN,NaN,0,0
3,1,1.5,76,1,75,0,0.81828224623132,49,0
3,1,1.5,84,28,56,1,0.993971681507901,-22,0
3,1,1.5,46,81,-35,0,1.18102534659738,-31,0
3,1,1.5,57,40,17,1,1.24064574401018,-10,0
3,1,1.5,51,27,24,0,1.15357834379756,23,0
3,1,1.5,43,90,-47,NaN,NaN,0,0
3,1,1.5,20,91,-71,0,1.1097771861223,-41,0
3,1,1.5,51,38,13,1,0.692743821848126,-12,0
3,1,1.5,35,80,-45,0,1.43590606987891,-30,0
3,1,1.5,85,7,78,1,1.0287967096192,-43,0
3,1,1.5,88,27,61,1,0.750479035836179,-23,0
4,1,10,48,80,-32,1,1.56046221996166,30,0
4,1,10,48,80,-32,1,0.857973650332497,30,0
4,1,10,100,15,85,1,1.11700972580775,-35,0
4,1,10,25,55,-30,0,7.03715048252707,-5,0
4,1,10,85,15,70,1,3.06638222517813,-35,0
4,1,10,53,0,53,0,1.98346864439463,50,0
4,1,10,48,100,-52,1,2.08820543343427,50,0
4,1,10,98,38,60,1,5.28493821603251,-12,0
4,1,10,5,83,-78,0,3.23265464745054,-33,0
4,1,10,85,15,70,1,2.6710480743759,-35,0
4,1,10,100,15,85,1,4.10029448799014,-35,0
4,1,10,53,23,30,0,3.39973548204125,27,0
4,1,10,5,83,-78,0,3.76738317124364,-33,0
4,1,10,75,0,75,0,3.97624093112654,50,0
4,1,10,28,85,-57,1,4.48907832553959,35,0
4,1,10,30,100,-70,0,5.75705251913496,-50,0
4,1,10,48,100,-52,1,3.42995615626569,50,0
4,1,10,48,60,-12,1,8.10091785297755,10,0
4,1,10,98,38,60,1,3.35912529073312,-12,0
4,1,10,53,0,53,0,2.5368516295789,50,0
4,1,1.5,50,100,-50,1,1.02943705775078,50,0
4,1,1.5,30,100,-70,1,0.54924980072019,50,0
4,1,1.5,53,23,30,0,0.879782670619988,27,0
4,1,1.5,80,45,35,1,0.733565696134519,-5,0
4,1,1.5,53,40,13,0,0.848709510814388,10,0
4,1,1.5,80,45,35,1,0.711188855245837,-5,0
4,1,1.5,3,100,-97,1,0.835662315594618,50,0
4,1,1.5,0,68,-68,0,0.745447968600729,-18,0
4,1,1.5,3,100,-97,1,0.787909236956239,50,0
4,1,1.5,50,100,-50,1,0.860455639159682,50,0
4,1,1.5,0,68,-68,0,0.706200727858231,-18,0
4,1,1.5,100,0,100,1,0.829979883378655,-50,0
4,1,1.5,50,43,7,0,0.893145019857457,7,0
4,1,1.5,28,85,-57,0,1.44957268265216,-35,0
4,1,1.5,25,55,-30,NaN,NaN,0,0
4,1,1.5,100,0,100,1,0.619687629345208,-50,0
4,1,1.5,53,40,13,0,0.691580781265657,10,0
4,1,1.5,75,0,75,0,0.743774995834883,50,0
4,1,1.5,48,60,-12,0,1.01056494688919,-10,0
4,1,1.5,50,43,7,0,0.986273032159716,7,0
4,1,10,85,35,50,1,1.49662572090028,-15,0
4,1,10,0,96,-96,0,3.32868002399027,-46,0
4,1,10,48,85,-37,1,2.64304645875882,35,0
4,1,10,44,90,-46,1,1.5769724869192,40,0
4,1,10,45,99,-54,1,1.75316380835011,49,0
4,1,10,26,96,-70,1,3.07468188472694,46,0
4,1,10,75,30,45,1,3.73505422531343,-20,0
4,1,10,40,94,-54,1,3.77527590778891,44,0
4,1,10,46,99,-53,1,1.83080338927948,49,0
4,1,10,99,10,89,1,4.42161031035175,-40,0
4,1,10,86,5,81,0,1.36026847872745,45,0
4,1,10,60,44,16,1,3.56856234234056,-6,0
4,1,10,47,83,-36,1,5.14343496759193,33,0
4,1,10,91,18,73,0,5.48719796694013,32,0
4,1,10,100,1,99,1,1.68088335508355,-49,0
4,1,10,61,43,18,1,2.96093060403655,-7,0
4,1,10,78,16,62,0,3.54474406425288,34,0
4,1,10,9,74,-65,0,4.00898434685269,-24,0
4,1,10,54,22,32,0,1.54975302078492,28,0
4,1,10,44,95,-51,1,7.60242872065965,45,0
4,1,1.5,34,57,-23,0,0.914833291479681,-7,0
4,1,1.5,48,55,-7,1,1.30054588671192,5,0
4,1,1.5,50,46,4,1,1.00683320937014,-4,0
4,1,1.5,5,59,-54,NaN,NaN,0,0
4,1,1.5,29,97,-68,1,0.985091204592209,47,0
4,1,1.5,46,86,-40,1,0.767494863760021,36,0
4,1,1.5,62,36,26,1,0.631312707152119,-14,0
4,1,1.5,100,16,84,1,0.787815052996848,-34,0
4,1,1.5,48,91,-43,1,0.826215845591378,41,0
4,1,1.5,59,8,51,0,0.687350351756322,42,0
4,1,1.5,28,98,-70,1,0.808473942242472,48,0
4,1,1.5,29,100,-71,1,0.734260604706833,50,0
4,1,1.5,99,18,81,1,0.654072019440264,-32,0
4,1,1.5,11,82,-71,0,0.745851571015919,-32,0
4,1,1.5,69,46,23,1,0.85832653830812,-4,0
4,1,1.5,79,14,65,0,1.07813861715977,36,0
4,1,1.5,38,97,-59,1,0.729155954856651,47,0
4,1,1.5,80,32,48,1,0.802323307073948,-18,0
4,1,1.5,38,81,-43,0,0.792072047212969,-31,0
4,1,1.5,55,21,34,0,0.886500824517498,29,0
4,1,10,30,72,-42,1,6.09161386640017,22,0
4,1,10,30,99,-69,1,6.28499949598063,49,0
4,1,10,92,18,74,0,4.84573637678886,32,0
4,1,10,51,49,2,NaN,NaN,0,0
4,1,10,36,99,-63,1,2.16616711142979,49,0
4,1,10,15,93,-78,1,1.31618404643041,43,0
4,1,10,77,44,33,1,1.00899189364418,-6,0
4,1,10,24,60,-36,0,4.05851665708315,-10,0
4,1,10,31,98,-67,1,4.62864536912321,48,0
4,1,10,90,19,71,0,4.62384349655304,31,0
4,1,10,48,55,-7,0,4.13775464847686,-5,0
4,1,10,3,63,-60,0,3.27992231645203,-13,0
4,1,10,58,28,30,0,3.46552026082691,22,0
4,1,10,74,13,61,0,3.86780651606659,37,0
4,1,10,70,13,57,0,2.03733130365435,37,0
4,1,10,32,99,-67,1,4.94918568317826,49,0
4,1,10,45,82,-37,1,4.07432869487957,32,0
4,1,10,98,19,79,1,3.9157515850834,-31,0
4,1,10,20,60,-40,0,3.25920486410405,-10,0
4,1,10,48,64,-16,1,3.86829252944653,14,0
4,1,1.5,6,83,-77,0,0.706366757273827,-33,0
4,1,1.5,88,39,49,1,0.914808236131194,-11,0
4,1,1.5,33,95,-62,1,1.02640385126415,45,0
4,1,1.5,4,56,-52,0,0.805536127201322,-6,0
4,1,1.5,65,41,24,0,1.09664697266544,9,0
4,1,1.5,23,98,-75,1,0.881015212627062,48,0
4,1,1.5,46,89,-43,1,1.18670555388053,39,0
4,1,1.5,49,83,-34,1,0.81300533780086,33,0
4,1,1.5,96,46,50,1,1.09745870557208,-4,0
4,1,1.5,32,100,-68,1,1.13715603696573,50,0
4,1,1.5,50,43,7,0,0.996740734004561,7,0
4,1,1.5,37,95,-58,1,1.13584742329977,45,0
4,1,1.5,68,17,51,0,1.0695268223094,33,0
4,1,1.5,36,57,-21,0,0.829211318120088,-7,0
4,1,1.5,60,32,28,0,0.852154772123413,18,0
4,1,1.5,45,57,-12,0,1.28525246443542,-7,0
4,1,1.5,35,93,-58,1,1.27686646959,43,0
4,1,1.5,15,76,-61,0,1.17178162252139,-26,0
4,1,1.5,3,81,-78,0,0.936774531555784,-31,0
4,1,1.5,83,40,43,1,0.885842744288766,-10,0
4,1,10,49,78,-29,1,4.31853381546807,28,0
4,1,10,26,60,-34,0,2.59646343469331,-10,0
4,1,10,69,8,61,0,0.920378975831682,42,0
4,1,10,26,96,-70,1,2.21993588860187,46,0
4,1,10,95,48,47,1,4.37454580098074,-2,0
4,1,10,67,10,57,0,2.90659642123637,40,0
4,1,10,28,50,-22,0,4.74562848785581,0,0
4,1,10,59,36,23,0,4.81421493756125,14,0
4,1,10,46,85,-39,1,4.88804519995392,35,0
4,1,10,24,67,-43,0,3.31925347751667,-17,0
4,1,10,80,15,65,0,2.56288655130083,35,0
4,1,10,45,84,-39,1,3.91208746681741,34,0
4,1,10,8,53,-45,0,3.48618126317342,-3,0
4,1,10,76,33,43,1,3.56578270805176,-17,0
4,1,10,46,54,-8,0,4.20935075867965,-4,0
4,1,10,56,26,30,0,6.45138421451202,24,0
4,1,10,44,89,-45,1,4.32270749310419,39,0
4,1,10,12,77,-65,0,5.06406747325309,-27,0
4,1,10,54,47,7,1,4.48781227577774,-3,0
4,1,10,27,98,-71,1,4.55036642400773,48,0
4,1,1.5,43,91,-48,1,0.826163319921761,41,0
4,1,1.5,27,62,-35,0,0.820626691719099,-12,0
4,1,1.5,49,80,-31,1,0.727049494380481,30,0
4,1,1.5,73,48,25,1,0.637500472535066,-2,0
4,1,1.5,80,47,33,1,0.687333446943285,-3,0
4,1,1.5,82,18,64,NaN,NaN,0,0
4,1,1.5,100,28,72,1,0.607636308746805,-22,0
4,1,1.5,66,9,57,0,0.626818743679905,41,0
4,1,1.5,73,30,43,1,0.797291710166974,-20,0
4,1,1.5,37,89,-52,1,0.77570365993779,39,0
4,1,1.5,42,55,-13,0,0.85746348721932,-5,0
4,1,1.5,11,96,-85,1,0.849166544514901,46,0
4,1,1.5,35,70,-35,1,0.953580029001387,20,0
4,1,1.5,77,25,52,1,0.76597373244158,-25,0
4,1,1.5,46,91,-45,1,0.609738241148079,41,0
4,1,1.5,86,5,81,0,0.676211891072398,45,0
4,1,1.5,30,57,-27,0,0.723367263814453,-7,0
4,1,1.5,38,89,-51,1,0.728516288799256,39,0
4,1,1.5,8,79,-71,0,0.645560747854233,-29,0
4,1,1.5,14,60,-46,0,0.678699011717981,-10,0
5,1,10,53,40,13,1,3.32373898957303,-10,0
5,1,10,53,23,30,0,4.60604635167874,27,0
5,1,10,98,38,60,0,4.10132689007332,12,0
5,1,10,48,80,-32,0,4.1054637393645,-30,0
5,1,10,53,0,53,0,4.2368980584306,50,0
5,1,10,25,55,-30,0,4.78695019166662,-5,0
5,1,10,5,83,-78,0,4.33955404608605,-33,0
5,1,10,80,45,35,1,4.78153823646244,-5,0
5,1,10,53,40,13,1,4.60612212146589,-10,0
5,1,10,53,0,53,0,5.80538790920218,50,0
5,1,10,50,43,7,1,3.30828466969797,-7,0
5,1,10,50,100,-50,0,4.80804105926472,-50,0
5,1,10,30,100,-70,0,5.15917999086923,-50,0
5,1,10,80,45,35,1,5.56828401765597,-5,0
5,1,10,0,68,-68,0,4.33664279574987,-18,0
5,1,10,85,15,70,0,4.44262842786884,35,0
5,1,10,75,0,75,0,4.05660248984532,50,0
5,1,10,48,60,-12,1,5.09411215728687,10,0
5,1,10,100,0,100,0,5.5612289749788,50,0
5,1,10,25,55,-30,0,6.27419671757707,-5,0
5,1,1.5,48,100,-52,0,1.08468983701641,-50,0
5,1,1.5,3,100,-97,0,0.877665947495188,-50,0
5,1,1.5,30,100,-70,0,1.09149825054192,-50,0
5,1,1.5,48,60,-12,NaN,NaN,0,0
5,1,1.5,98,38,60,1,1.1817624063624,-12,0
5,1,1.5,100,15,85,0,1.25472176900257,35,0
5,1,1.5,50,100,-50,1,1.23706680469149,50,0
5,1,1.5,48,100,-52,1,1.24406328426448,50,0
5,1,1.5,75,0,75,0,0.882371221134235,50,0
5,1,1.5,5,83,-78,0,1.0468143011185,-33,0
5,1,1.5,0,68,-68,0,0.79723224243935,-18,0
5,1,1.5,3,100,-97,0,0.701696803609593,-50,0
5,1,1.5,100,15,85,0,0.945507679803995,35,0
5,1,1.5,100,0,100,0,0.699950174157493,50,0
5,1,1.5,53,23,30,NaN,NaN,0,0
5,1,1.5,85,15,70,NaN,NaN,0,0
5,1,1.5,28,85,-57,1,1.1208489306282,35,0
5,1,1.5,48,80,-32,1,0.643862720729885,30,0
5,1,1.5,50,43,7,1,0.762398969176502,-7,0
5,1,1.5,28,85,-57,0,0.860178521961643,-35,0
5,1,10,86,19,67,0,1.72653087984872,31,0
5,1,10,43,70,-27,1,3.94984225503867,20,0
5,1,10,37,94,-57,0,3.95800244987913,-44,0
5,1,10,18,95,-77,0,4.1668179477274,-45,0
5,1,10,27,54,-27,1,4.91823749923242,4,0
5,1,10,75,34,41,0,4.35872048181955,16,0
5,1,10,95,37,58,0,3.03078612321042,13,0
5,1,10,72,35,37,0,2.32450544172934,15,0
5,1,10,83,33,50,0,2.84584837216607,17,0
5,1,10,56,28,28,0,3.67499051930645,22,0
5,1,10,87,43,44,0,3.46053092694274,7,0
5,1,10,100,9,91,0,2.95282897328798,41,0
5,1,10,55,11,44,0,2.17731613861179,39,0
5,1,10,41,79,-38,1,3.63334611567552,29,0
5,1,10,97,6,91,0,2.42223488381569,44,0
5,1,10,66,46,20,1,2.70822025028428,-4,0
5,1,10,84,19,65,0,2.43070449711195,31,0
5,1,10,80,24,56,0,4.39669623911141,26,0
5,1,10,69,22,47,0,3.8673766518059,28,0
5,1,10,3,59,-56,0,2.56680514836989,-9,0
5,1,1.5,28,93,-65,0,1.05778824174558,-43,0
5,1,1.5,98,25,73,0,1.01483522444687,25,0
5,1,1.5,42,98,-56,1,1.12458127189166,48,0
5,1,1.5,99,27,72,NaN,NaN,0,0
5,1,1.5,77,1,76,0,0.874090277628056,49,0
5,1,1.5,60,5,55,0,0.678545360031421,45,0
5,1,1.5,26,95,-69,1,0.650342999755594,45,0
5,1,1.5,59,31,28,1,0.927559899981134,-19,0
5,1,1.5,100,7,93,0,0.673359204829467,43,0
5,1,1.5,88,23,65,1,0.813134539863313,-27,0
5,1,1.5,5,96,-91,0,0.778217346280144,-46,0
5,1,1.5,98,38,60,1,0.657344913019188,-12,0
5,1,1.5,93,23,70,0,1.31717962016955,27,0
5,1,1.5,43,82,-39,1,0.966148154879193,32,0
5,1,1.5,94,18,76,0,1.02127233582542,32,0
5,1,1.5,50,96,-46,1,0.770922919375153,46,0
5,1,1.5,60,35,25,NaN,NaN,0,0
5,1,1.5,82,32,50,1,0.81528597921897,-18,0
5,1,1.5,94,0,94,0,0.661057934494238,50,0
5,1,1.5,4,99,-95,0,0.641539818270758,-49,0
5,1,10,86,8,78,0,1.03874889398139,42,0
5,1,10,90,16,74,0,3.46363175268198,34,0
5,1,10,32,56,-24,1,3.56322223358256,6,0
5,1,10,89,40,49,1,2.71481524054252,-10,0
5,1,10,37,64,-27,0,3.79601932208971,-14,0
5,1,10,97,9,88,0,3.4168295697873,41,0
5,1,10,39,99,-60,0,4.4298302767711,-49,0
5,1,10,4,71,-67,0,5.28180780785806,-21,0
5,1,10,61,39,22,1,3.20425093976701,-11,0
5,1,10,96,16,80,0,4.08856315234516,34,0
5,1,10,83,3,80,0,2.13666247778383,47,0
5,1,10,90,25,65,0,3.26468293019207,25,0
5,1,10,91,18,73,0,3.86700534965712,32,0
5,1,10,99,14,85,0,3.55647992995,36,0
5,1,10,85,8,77,0,2.93081951021668,42,0
5,1,10,53,44,9,1,2.46654209740154,-6,0
5,1,10,55,45,10,1,2.25246437269379,-5,0
5,1,10,62,0,62,0,2.88643833807146,50,0
5,1,10,81,18,63,0,2.93552297262431,32,0
5,1,10,29,79,-50,0,4.30334272867549,-29,0
5,1,1.5,39,57,-18,1,0.99551906036686,7,0
5,1,1.5,81,22,59,1,1.11323210478622,-28,0
5,1,1.5,11,90,-79,0,0.946177834901391,-40,0
5,1,1.5,97,23,74,1,0.937370427212954,-27,0
5,1,1.5,4,89,-85,0,0.937085460360322,-39,0
5,1,1.5,98,15,83,1,0.800788592519893,-35,0
5,1,1.5,56,28,28,1,0.813267967139836,-22,0
5,1,1.5,100,7,93,0,0.642333438876449,43,0
5,1,1.5,4,65,-61,0,0.598192254707101,-15,0
5,1,1.5,16,72,-56,0,1.08270291771987,-22,0
5,1,1.5,48,87,-39,1,1.30631888141761,37,0
5,1,1.5,18,61,-43,NaN,NaN,0,0
5,1,1.5,74,29,45,1,1.38114350907381,-21,0
5,1,1.5,17,56,-39,0,0.698769554077444,-6,0
5,1,1.5,98,4,94,0,1.27452605956387,46,0
5,1,1.5,3,77,-74,0,0.787502918685277,-27,0
5,1,1.5,94,12,82,1,0.55192981834989,-38,0
5,1,1.5,99,10,89,1,0.949772220810701,-40,0
5,1,1.5,96,14,82,1,0.715450982268521,-36,0
5,1,1.5,84,19,65,0,0.722622547407809,31,0
5,1,10,74,6,68,0,2.87444346747725,44,0
5,1,10,16,76,-60,0,3.16294493426904,-26,0
5,1,10,79,0,79,0,2.0152669009276,50,0
5,1,10,93,47,46,0,3.44195978213065,3,0
5,1,10,36,96,-60,1,1.72364317550637,46,0
5,1,10,48,54,-6,1,3.91023608888645,4,0
5,1,10,74,31,43,0,5.18102342452585,19,0
5,1,10,100,6,94,0,4.4000361472099,44,0
5,1,10,16,86,-70,0,4.54605147142138,-36,0
5,1,10,100,0,100,0,3.71154838538678,50,0
5,1,10,62,26,36,0,3.9635825475998,24,0
5,1,10,95,10,85,0,3.43962359731631,40,0
5,1,10,49,67,-18,1,2.62458187563425,17,0
5,1,10,77,48,29,1,3.41846178987726,-2,0
5,1,10,11,61,-50,0,2.66005028687687,-11,0
5,1,10,81,2,79,0,2.01254643348511,48,0
5,1,10,5,64,-59,0,3.5637915635416,-14,0
5,1,10,100,9,91,0,3.37600474772444,41,0
5,1,10,66,50,16,1,2.34764360295594,0,0
5,1,10,29,89,-60,0,3.15224660247441,-39,0
5,1,1.5,62,21,41,1,0.79659438760973,-29,0
5,1,1.5,93,10,83,0,1.12843677679302,40,0
5,1,1.5,96,8,88,0,0.638765013927696,42,0
5,1,1.5,37,65,-28,1,0.647816032051196,15,0
5,1,1.5,93,23,70,0,0.69768885351732,27,0
5,1,1.5,59,15,44,0,1.13021872522768,35,0
5,1,1.5,12,55,-43,0,0.777158682351001,-5,0
5,1,1.5,96,11,85,0,0.973627930985458,39,0
5,1,1.5,12,84,-72,1,0.665967273376737,34,0
5,1,1.5,84,46,38,0,0.842458051500216,4,0
5,1,1.5,73,5,68,0,0.697606140682183,45,0
5,1,1.5,97,37,60,NaN,NaN,0,0
5,1,1.5,46,97,-51,1,1.00048364176473,47,0
5,1,1.5,96,5,91,0,0.82685460702487,45,0
5,1,1.5,61,44,17,1,1.02055207003286,-6,0
5,1,1.5,85,15,70,0,1.02228571900378,35,0
5,1,1.5,53,23,30,1,1.35997445671637,-27,0
5,1,1.5,8,82,-74,0,0.676235739923868,-32,0
5,1,1.5,26,72,-46,0,1.46002016008424,-22,0
5,1,1.5,45,96,-51,1,1.19625496310982,46,0
6,1,10,53,23,30,0,4.31595311538331,27,0
6,1,10,75,0,75,0,1.6379282254602,50,0
6,1,10,28,85,-57,0,1.95607590470172,-35,0
6,1,10,80,45,35,1,1.89422753242616,-5,0
6,1,10,80,45,35,1,1.89900284028772,-5,0
6,1,10,98,38,60,0,2.75183980000656,12,0
6,1,10,5,83,-78,0,1.89764049346559,-33,0
6,1,10,48,60,-12,1,2.34560476152183,10,0
6,1,10,53,23,30,0,3.34022480471322,27,0
6,1,10,3,100,-97,0,1.27860434554168,-50,0
6,1,10,30,100,-70,0,2.09678191007697,-50,0
6,1,10,28,85,-57,0,1.16553106861102,-35,0
6,1,10,53,40,13,0,4.98775220409152,10,0
6,1,10,50,100,-50,1,2.65086101131965,50,0
6,1,10,48,80,-32,1,3.56082688170864,30,0
6,1,10,48,80,-32,1,3.26636677012357,30,0
6,1,10,0,68,-68,0,2.83140683151214,-18,0
6,1,10,25,55,-30,0,3.03054251256253,-5,0
6,1,10,50,100,-50,1,2.11769467339036,50,0
6,1,10,75,0,75,0,2.77707234684203,50,0
6,1,1.5,30,100,-70,NaN,NaN,0,0
6,1,1.5,100,0,100,1,0.795161100733822,-50,0
6,1,1.5,50,43,7,1,1.16363833326977,-7,0
6,1,1.5,5,83,-78,NaN,NaN,0,0
6,1,1.5,48,60,-12,1,1.08191503246053,10,0
6,1,1.5,85,15,70,1,1.01493725685577,-35,0
6,1,1.5,0,68,-68,0,0.870011085611623,-18,0
6,1,1.5,85,15,70,0,0.899092798044876,35,0
6,1,1.5,100,15,85,0,0.99088412261699,35,0
6,1,1.5,98,38,60,0,1.03929347025041,12,0
6,1,1.5,48,100,-52,1,1.08569657880435,50,0
6,1,1.5,53,0,53,0,0.962051454302127,50,0
6,1,1.5,100,0,100,NaN,NaN,0,0
6,1,1.5,100,15,85,0,0.641008825801691,35,0
6,1,1.5,53,0,53,0,1.12754685891196,50,0
6,1,1.5,25,55,-30,0,0.578617688268423,-5,0
6,1,1.5,53,40,13,0,1.36309097956837,10,0
6,1,1.5,50,43,7,0,0.9800565897458,7,0
6,1,1.5,48,100,-52,1,0.908454140237154,50,0
6,1,1.5,3,100,-97,0,0.799559069018869,-50,0
6,1,10,19,65,-46,0,1.31497535305971,-15,0
6,1,10,84,8,76,1,1.4591284309754,-42,0
6,1,10,11,88,-77,0,2.01675452428026,-38,0
6,1,10,38,89,-51,0,1.63948135517785,-39,0
6,1,10,45,75,-30,1,2.43351673332654,25,0
6,1,10,49,90,-41,1,0.79148581321715,40,0
6,1,10,24,95,-71,0,1.68810231484895,-45,0
6,1,10,88,1,87,0,2.28346296998279,49,0
6,1,10,93,0,93,0,1.03080000909176,50,0
6,1,10,26,85,-59,0,1.38568214933912,-35,0
6,1,10,45,90,-45,1,2.46781418438331,40,0
6,1,10,95,4,91,0,3.48776367521714,46,0
6,1,10,43,71,-28,1,3.17867274965829,21,0
6,1,10,46,86,-40,1,2.57837075724819,36,0
6,1,10,37,74,-37,0,2.57832306152341,-24,0
6,1,10,49,57,-8,1,2.13823009712723,7,0
6,1,10,46,66,-20,1,2.02759443388641,16,0
6,1,10,53,0,53,0,2.28167860657413,50,0
6,1,10,32,94,-62,0,2.17303257947788,-44,0
6,1,10,22,86,-64,0,1.38899217214203,-36,0
6,1,1.5,46,65,-19,NaN,NaN,0,0
6,1,1.5,48,100,-52,1,0.96333772946673,50,0
6,1,1.5,35,95,-60,0,0.67641474960692,-45,0
6,1,1.5,94,15,79,1,1.36753241737097,-35,0
6,1,1.5,46,83,-37,0,1.20714920940372,-33,0
6,1,1.5,40,72,-32,1,0.860832375772588,22,0
6,1,1.5,84,17,67,0,1.35261754216117,33,0
6,1,1.5,29,77,-48,1,0.624213290120679,27,0
6,1,1.5,24,59,-35,0,1.46203424761916,-9,0
6,1,1.5,55,1,54,1,1.01021024845977,-49,0
6,1,1.5,50,78,-28,0,1.27864419260004,-28,0
6,1,1.5,48,96,-48,1,0.945632050719723,46,0
6,1,1.5,20,54,-34,0,1.34672832785509,-4,0
6,1,1.5,36,64,-28,0,0.962989067695162,-14,0
6,1,1.5,62,38,24,0,0.819408036586537,12,0
6,1,1.5,47,82,-35,NaN,NaN,0,0
6,1,1.5,31,59,-28,0,0.93172331376627,-9,0
6,1,1.5,49,53,-4,1,0.740800956969906,3,0
6,1,1.5,90,5,85,0,0.82990562372288,45,0
6,1,1.5,4,51,-47,1,0.995721917912306,1,0
6,1,10,18,52,-34,0,1.61886201112065,-2,0
6,1,10,48,64,-16,1,3.04770391670172,14,0
6,1,10,43,71,-28,1,2.28275357156963,21,0
6,1,10,49,61,-12,1,0.988764983525471,11,0
6,1,10,16,89,-73,0,0.998994206758653,-39,0
6,1,10,91,34,57,0,1.54455056529332,16,0
6,1,10,10,70,-60,0,2.31660908251069,-20,0
6,1,10,2,94,-92,0,2.24460363433172,-44,0
6,1,10,49,62,-13,1,1.56793354444017,12,0
6,1,10,18,78,-60,0,1.30210384714883,-28,0
6,1,10,52,14,38,0,1.66171058081818,36,0
6,1,10,41,74,-33,0,1.26521120539473,-24,0
6,1,10,49,63,-14,0,2.24070918798316,-13,0
6,1,10,46,66,-20,1,1.21271059108403,16,0
6,1,10,87,42,45,1,2.27886818137631,-8,0
6,1,10,7,80,-73,0,1.46555739181713,-30,0
6,1,10,78,36,42,0,2.0242738455745,14,0
6,1,10,49,71,-22,1,1.23284784609132,21,0
6,1,10,19,97,-78,0,2.32520004821708,-47,0
6,1,10,87,33,54,0,4.57245075202809,17,0
6,1,1.5,11,80,-69,0,0.910643615421577,-30,0
6,1,1.5,52,14,38,0,1.31903733818035,36,0
6,1,1.5,40,92,-52,0,1.02265460596755,-42,0
6,1,1.5,48,60,-12,1,1.21833898827026,10,0
6,1,1.5,42,89,-47,0,0.813987930843723,-39,0
6,1,1.5,4,67,-63,1,0.801716545804084,17,0
6,1,1.5,98,38,60,1,1.3502327560127,-12,0
6,1,1.5,8,53,-45,0,0.908436933550547,-3,0
6,1,1.5,40,55,-15,0,1.30886275372177,-5,0
6,1,1.5,83,8,75,0,1.42851562545911,42,0
6,1,1.5,12,56,-44,0,0.678161077186815,-6,0
6,1,1.5,88,1,87,0,0.975203097121266,49,0
6,1,1.5,85,42,43,0,0.900954138727684,8,0
6,1,1.5,48,60,-12,0,1.1086364103503,-10,0
6,1,1.5,24,64,-40,0,0.884273616149585,-14,0
6,1,1.5,6,92,-86,NaN,NaN,0,0
6,1,1.5,32,92,-60,NaN,NaN,0,0
6,1,1.5,1,66,-65,0,0.948448815222946,-16,0
6,1,1.5,40,72,-32,0,0.570152904918359,-22,0
6,1,1.5,31,81,-50,0,0.703282535254402,-31,0
6,1,10,57,9,48,0,3.82716674211042,41,0
6,1,10,50,64,-14,1,3.58931903877965,14,0
6,1,10,43,71,-28,1,2.49690102863315,21,0
6,1,10,46,78,-32,1,3.75284231580372,28,0
6,1,10,53,0,53,0,2.701648202059,50,0
6,1,10,14,58,-44,0,2.49215530419315,-8,0
6,1,10,64,36,28,0,2.69936303355644,14,0
6,1,10,34,63,-29,0,2.39458192975871,-13,0
6,1,10,48,100,-52,1,3.50180704693048,50,0
6,1,10,3,61,-58,0,2.44406080870613,-11,0
6,1,10,7,65,-58,0,1.66730033843851,-15,0
6,1,10,84,17,67,0,2.4399327136889,33,0
6,1,10,78,39,39,0,3.16121400193151,11,0
6,1,10,94,12,82,0,2.79820608021691,38,0
6,1,10,62,31,31,0,1.83405515163031,19,0
6,1,10,43,71,-28,0,4.60413822067494,-21,0
6,1,10,59,1,58,0,4.40607750462004,49,0
6,1,10,50,100,-50,1,2.05604946074163,50,0
6,1,10,82,9,73,0,2.25674913888724,41,0
6,1,10,45,75,-30,1,3.65737932617412,25,0
6,1,1.5,98,38,60,1,0.996910990401375,-12,0
6,1,1.5,85,42,43,1,1.23260031133032,-8,0
6,1,1.5,99,32,67,0,1.29817377994914,18,0
6,1,1.5,26,97,-71,0,1.21780256232523,-47,0
6,1,1.5,97,50,47,1,1.02010862034513,0,0
6,1,1.5,71,1,70,0,1.10179328158483,49,0
6,1,1.5,98,37,61,0,1.24411611159303,13,0
6,1,1.5,91,34,57,0,1.06917665195579,16,0
6,1,1.5,20,100,-80,0,0.868771902427397,-50,0
6,1,1.5,45,95,-50,1,0.924468432051071,45,0
6,1,1.5,81,34,47,0,0.800242204593815,16,0
6,1,1.5,42,86,-44,1,1.02660972851663,36,0
6,1,1.5,100,15,85,1,1.02026680109702,-35,0
6,1,1.5,50,99,-49,0,1.05396564063994,-49,0
6,1,1.5,58,42,16,0,1.41436871176484,8,0
6,1,1.5,49,62,-13,1,1.40056774299956,12,0
6,1,1.5,6,83,-77,0,0.690812820525025,-33,0
6,1,1.5,67,38,29,NaN,NaN,0,0
6,1,1.5,47,53,-6,0,0.745770670189813,-3,0
6,1,1.5,94,12,82,0,1.02286651987379,38,0
7,1,10,48,80,-32,0,0.998879807277262,-30,0
7,1,10,5,83,-78,0,3.46640126639159,-33,0
7,1,10,98,38,60,0,3.27868642998146,12,0
7,1,10,85,15,70,0,3.07573716963634,35,0
7,1,10,25,55,-30,0,2.17686238641545,-5,0
7,1,10,53,40,13,0,1.38621911862356,10,0
7,1,10,80,45,35,0,8.7362969253636,5,0
7,1,10,28,85,-57,0,2.38574246743701,-35,0
7,1,10,0,68,-68,0,3.06698809976933,-18,0
7,1,10,3,100,-97,0,1.7440766937998,-50,0
7,1,10,30,100,-70,0,3.42346009613539,-50,0
7,1,10,100,0,100,0,5.74240132072737,50,0
7,1,10,85,15,70,0,2.88800271173932,35,0
7,1,10,50,43,7,0,3.58053130250937,7,0
7,1,10,53,23,30,0,3.79746404156322,27,0
7,1,10,98,38,60,0,4.03692375638821,12,0
7,1,10,3,100,-97,0,3.49111649070255,-50,0
7,1,10,5,83,-78,0,4.80733817727469,-33,0
7,1,10,75,0,75,0,5.30260260699106,50,0
7,1,10,100,15,85,0,4.7769994349519,35,0
7,1,1.5,53,0,53,0,0.699299254283687,50,0
7,1,1.5,80,45,35,0,0.57583784295548,5,0
7,1,1.5,48,60,-12,0,0.849723606660518,-10,0
7,1,1.5,48,100,-52,0,1.28807968834099,-50,0
7,1,1.5,25,55,-30,NaN,NaN,0,0
7,1,1.5,48,60,-12,0,0.322247941076967,-10,0
7,1,1.5,48,100,-52,0,0.414241318070708,-50,0
7,1,1.5,53,40,13,0,0.430906601171046,10,0
7,1,1.5,30,100,-70,0,0.318770409943681,-50,0
7,1,1.5,53,23,30,0,0.618087733149878,27,0
7,1,1.5,50,100,-50,0,0.601251290314394,-50,0
7,1,1.5,53,0,53,0,0.44110645355704,50,0
7,1,1.5,48,80,-32,0,0.687720464205086,-30,0
7,1,1.5,28,85,-57,0,0.588107913094063,-35,0
7,1,1.5,100,15,85,0,0.884779656191313,35,0
7,1,1.5,75,0,75,0,0.881140323261207,50,0
7,1,1.5,50,43,7,0,0.565575805550907,7,0
7,1,1.5,50,100,-50,0,0.750770337494941,-50,0
7,1,1.5,100,0,100,0,0.768631625661328,50,0
7,1,1.5,0,68,-68,0,0.87373698549618,-18,0
7,1,10,28,85,-57,0,2.22866733676528,-35,0
7,1,10,85,27,58,0,3.65521279295717,23,0
7,1,10,20,90,-70,0,3.16419324542949,-40,0
7,1,10,91,31,60,0,2.40518283245729,19,0
7,1,10,90,41,49,0,1.54851809272168,9,0
7,1,10,8,96,-88,0,2.91732898536247,-46,0
7,1,10,87,37,50,0,2.58318231626163,13,0
7,1,10,71,41,30,0,3.20445019634099,9,0
7,1,10,11,70,-59,0,2.77810367183429,-20,0
7,1,10,36,60,-24,0,3.71320756760451,-10,0
7,1,10,76,17,59,0,2.62478831983208,33,0
7,1,10,46,51,-5,0,2.23873346117489,-1,0
7,1,10,74,49,25,0,2.50803866434035,1,0
7,1,10,71,49,22,0,4.43794528115905,1,0
7,1,10,79,46,33,0,3.47458674679274,4,0
7,1,10,41,85,-44,0,2.27020089177222,-35,0
7,1,10,29,67,-38,0,2.4182404788753,-17,0
7,1,10,33,79,-46,0,2.85559375166395,-29,0
7,1,10,71,48,23,0,3.29198617535531,2,0
7,1,10,70,38,32,0,2.9190218668391,12,0
7,1,1.5,76,47,29,0,0.685102052307229,3,0
7,1,1.5,34,81,-47,0,0.736910323215852,-31,0
7,1,1.5,74,43,31,0,0.73875444107216,7,0
7,1,1.5,15,54,-39,0,1.05187774400201,-4,0
7,1,1.5,100,10,90,0,1.12893313243967,40,0
7,1,1.5,76,16,60,NaN,NaN,0,0
7,1,1.5,34,82,-48,0,0.422539395618514,-32,0
7,1,1.5,97,8,89,0,0.292445921875697,42,0
7,1,1.5,50,35,15,0,0.239678009344971,15,0
7,1,1.5,52,45,7,0,0.468976209149332,5,0
7,1,1.5,99,48,51,0,0.694883212358945,2,0
7,1,1.5,31,82,-51,0,0.530043406702134,-32,0
7,1,1.5,0,82,-82,0,0.635916721330432,-32,0
7,1,1.5,75,27,48,0,0.465115304356914,23,0
7,1,1.5,39,94,-55,0,0.540999440989253,-44,0
7,1,1.5,91,50,41,0,0.726202727135387,0,0
7,1,1.5,21,51,-30,0,0.606621540216111,-1,0
7,1,1.5,31,66,-35,0,0.644434559525507,-16,0
7,1,1.5,79,27,52,0,0.929030636134485,23,0
7,1,1.5,13,59,-46,0,0.802085354422161,-9,0
7,1,10,44,80,-36,0,2.91216551574053,-30,0
7,1,10,46,54,-8,0,2.65663308670719,-4,0
7,1,10,67,36,31,0,2.91517877231854,14,0
7,1,10,90,26,64,0,2.14828323862275,24,0
7,1,10,78,43,35,0,1.58419055879585,7,0
7,1,10,83,26,57,0,1.97436985390141,24,0
7,1,10,89,31,58,0,3.80893446066329,19,0
7,1,10,38,58,-20,0,5.18172640196826,-8,0
7,1,10,4,51,-47,0,2.4915756334849,-1,0
7,1,10,33,85,-52,0,2.37277598546461,-35,0
7,1,10,21,100,-79,0,2.58477437348392,-50,0
7,1,10,76,44,32,0,1.32666247365614,6,0
7,1,10,32,87,-55,0,3.45555269747638,-37,0
7,1,10,81,20,61,0,3.65055133151964,30,0
7,1,10,41,97,-56,0,3.50938228335781,-47,0
7,1,10,38,61,-23,0,2.82173763149603,-11,0
7,1,10,81,17,64,0,3.36950855516898,33,0
7,1,10,58,9,49,0,3.32647501299289,41,0
7,1,10,77,40,37,0,2.83881707889395,10,0
7,1,10,98,35,63,0,2.0665995943391,15,0
7,1,1.5,86,38,48,0,0.473972141464401,12,0
7,1,1.5,89,44,45,0,0.620495742339699,6,0
7,1,1.5,40,91,-51,0,0.64832112318436,-41,0
7,1,1.5,38,65,-27,0,0.914842490228693,-15,0
7,1,1.5,9,83,-74,0,0.794637641910413,-33,0
7,1,1.5,51,35,16,0,0.656367140098155,15,0
7,1,1.5,28,68,-40,0,0.995480460219369,-18,0
7,1,1.5,67,48,19,0,0.881235412003662,2,0
7,1,1.5,55,44,11,0,0.595685731154845,6,0
7,1,1.5,61,44,17,0,0.696142609919661,6,0
7,1,1.5,100,11,89,0,0.574713380848152,39,0
7,1,1.5,38,92,-54,0,0.779702973913118,-42,0
7,1,1.5,100,19,81,0,0.760870573103603,31,0
7,1,1.5,65,21,44,0,0.694708128326965,29,0
7,1,1.5,26,62,-36,0,0.783092963030867,-12,0
7,1,1.5,99,46,53,0,0.739566770610509,4,0
7,1,1.5,30,93,-63,0,0.794065600112845,-43,0
7,1,1.5,24,65,-41,0,0.710465993147409,-15,0
7,1,1.5,34,53,-19,0,0.614278146091237,-3,0
7,1,1.5,41,61,-20,0,0.602115843193133,-11,0
7,1,10,9,70,-61,0,3.83699228065598,-20,0
7,1,10,96,26,70,0,2.48646408533477,24,0
7,1,10,72,31,41,0,2.61437655539339,19,0
7,1,10,43,86,-43,0,2.08150166048199,-36,0
7,1,10,65,34,31,0,1.67012995255209,16,0
7,1,10,50,26,24,0,2.97146798699123,24,0
7,1,10,21,67,-46,0,4.73587249751836,-17,0
7,1,10,13,98,-85,0,2.98040331004358,-48,0
7,1,10,33,63,-30,0,4.43276913303725,-13,0
7,1,10,100,39,61,0,3.705417233753,11,0
7,1,10,64,31,33,0,4.82093073559918,19,0
7,1,10,87,31,56,0,2.6141492480192,19,0
7,1,10,60,45,15,0,3.68864448528075,5,0
7,1,10,44,86,-42,0,3.78349535443795,-36,0
7,1,10,61,8,53,0,2.25110556304389,42,0
7,1,10,95,24,71,0,3.70839003988203,26,0
7,1,10,60,41,19,0,4.35452739934317,9,0
7,1,10,78,6,72,0,4.8384807968032,44,0
7,1,10,31,86,-55,0,4.0789650550887,-36,0
7,1,10,88,33,55,0,3.98237904279358,17,0
7,1,1.5,91,36,55,0,0.501719036363284,14,0
7,1,1.5,69,48,21,0,0.668903760583817,2,0
7,1,1.5,1,68,-67,0,0.525348135934109,-18,0
7,1,1.5,78,24,54,0,0.524571426940383,26,0
7,1,1.5,78,48,30,0,0.715788245874137,2,0
7,1,1.5,42,66,-24,0,0.714230299851806,-16,0
7,1,1.5,63,39,24,0,0.721319391965153,11,0
7,1,1.5,35,51,-16,0,0.799771528368183,-1,0
7,1,1.5,8,75,-67,0,1.07419431706421,-25,0
7,1,1.5,87,35,52,0,1.01787400988178,15,0
7,1,1.5,91,12,79,0,1.05721358083611,38,0
7,1,1.5,94,34,60,0,1.34522439982175,16,0
7,1,1.5,51,5,46,0,1.40612436193715,45,0
7,1,1.5,59,13,46,0,0.97633321002013,37,0
7,1,1.5,33,69,-36,0,1.1721173072583,-19,0
7,1,1.5,3,73,-70,0,1.24773398793695,-23,0
7,1,1.5,5,82,-77,0,0.608678173863154,-32,0
7,1,1.5,54,32,22,0,0.371147100221606,18,0
7,1,1.5,67,35,32,0,0.407078569915029,15,0
7,1,1.5,81,25,56,0,0.937579868707871,25,0
8,1,10,25,55,-30,0,1.73184073027551,-5,0
8,1,10,85,15,70,1,2.29325220945066,-35,0
8,1,10,48,80,-32,0,2.61724430651702,-30,0
8,1,10,85,15,70,1,3.09646439771313,-35,0
8,1,10,28,85,-57,0,2.20420960214688,-35,0
8,1,10,53,40,13,1,1.76423942680594,-10,0
8,1,10,98,38,60,1,2.52353087983829,-12,0
8,1,10,30,100,-70,0,1.98288255573789,-50,0
8,1,10,28,85,-57,0,2.25566830872776,-35,0
8,1,10,100,15,85,1,2.92627003934467,-35,0
8,1,10,3,100,-97,0,2.42283643015253,-50,0
8,1,10,50,100,-50,0,2.35743107288181,-50,0
8,1,10,53,40,13,1,2.31944991252749,-10,0
8,1,10,3,100,-97,0,2.16205178200289,-50,0
8,1,10,25,55,-30,0,2.40793919391399,-5,0
8,1,10,0,68,-68,0,2.43916814798285,-18,0
8,1,10,80,45,35,1,5.73309227924256,-5,0
8,1,10,75,0,75,1,3.16611131661193,-50,0
8,1,10,50,43,7,1,2.93446034965018,-7,0
8,1,10,48,100,-52,0,3.00763551367891,-50,0
8,1,1.5,80,45,35,1,1.24424830175485,-5,0
8,1,1.5,53,23,30,1,1.2105687749663,-27,0
8,1,1.5,50,100,-50,0,1.27422902741819,-50,0
8,1,1.5,75,0,75,0,1.25526682292912,50,0
8,1,1.5,48,60,-12,NaN,NaN,0,0
8,1,1.5,5,83,-78,0,0.977434423628438,-33,0
8,1,1.5,53,23,30,1,0.898519220147136,-27,0
8,1,1.5,5,83,-78,0,0.813613425922085,-33,0
8,1,1.5,53,0,53,1,1.0454201572993,-50,0
8,1,1.5,0,68,-68,0,1.01181066412028,-18,0
8,1,1.5,48,80,-32,1,1.42011266596455,30,0
8,1,1.5,30,100,-70,0,1.05847116259793,-50,0
8,1,1.5,100,0,100,1,1.27148866043535,-50,0
8,1,1.5,98,38,60,0,1.11514827896463,12,0
8,1,1.5,50,43,7,1,1.14950882226913,-7,0
8,1,1.5,53,0,53,0,1.11853343817711,50,0
8,1,1.5,100,0,100,0,1.04892847907286,50,0
8,1,1.5,100,15,85,0,1.38193136645168,35,0
8,1,1.5,48,60,-12,0,1.16552327575664,-10,0
8,1,1.5,48,100,-52,0,1.4779042827613,-50,0
8,1,10,51,2,49,0,2.56808825683584,48,0
8,1,10,49,100,-51,0,2.33597995830678,-50,0
8,1,10,51,1,50,0,2.16128171412856,49,0
8,1,10,33,86,-53,0,2.40197516764601,-36,0
8,1,10,92,47,45,1,2.14530197557724,-3,0
8,1,10,51,18,33,0,2.13070087284905,32,0
8,1,10,4,92,-88,0,2.81273166650863,-42,0
8,1,10,36,99,-63,0,2.67590741917957,-49,0
8,1,10,49,98,-49,0,2.06307013714832,-48,0
8,1,10,79,4,75,0,1.84314798916967,46,0
8,1,10,51,2,49,0,2.15058890962791,48,0
8,1,10,51,1,50,0,2.65530727337682,49,0
8,1,10,49,98,-49,0,2.29984291580877,-48,0
8,1,10,16,62,-46,0,1.97383886170792,-12,0
8,1,10,78,21,57,0,2.47791605565362,29,0
8,1,10,15,79,-64,0,2.49786597558341,-29,0
8,1,10,49,99,-50,0,2.12512565387988,-49,0
8,1,10,61,25,36,1,3.23116982637475,-25,0
8,1,10,0,54,-54,0,2.0761706489684,-4,0
8,1,10,55,40,15,1,2.33560594258779,-10,0
8,1,1.5,51,3,48,0,1.03992402801305,47,0
8,1,1.5,8,66,-58,0,1.04496161825409,-16,0
8,1,1.5,40,56,-16,0,1.28936262710158,-6,0
8,1,1.5,31,72,-41,0,1.36432878003689,-22,0
8,1,1.5,51,0,51,0,1.37191746538156,50,0
8,1,1.5,17,58,-41,0,1.41084860754745,-8,0
8,1,1.5,55,15,40,0,1.00847320021421,35,0
8,1,1.5,49,99,-50,0,1.08620507713022,-49,0
8,1,1.5,74,23,51,NaN,NaN,0,0
8,1,1.5,51,2,49,1,1.2357518962599,-48,0
8,1,1.5,15,61,-46,0,1.02271839936475,-11,0
8,1,1.5,51,3,48,1,1.291781201704,-47,0
8,1,1.5,85,2,83,0,1.17407914944852,48,0
8,1,1.5,64,23,41,1,0.91707571266852,-27,0
8,1,1.5,51,4,47,1,0.974146768108767,-46,0
8,1,1.5,49,96,-47,0,0.925212290290801,-46,0
8,1,1.5,76,34,42,1,1.26223456369553,-16,0
8,1,1.5,69,48,21,1,0.897952913859626,-2,0
8,1,1.5,71,46,25,1,0.931005760559856,-4,0
8,1,1.5,49,99,-50,0,1.03543583939427,-49,0
8,1,10,49,96,-47,0,3.66575646957608,-46,0
8,1,10,49,99,-50,0,2.63668980331204,-49,0
8,1,10,49,98,-49,0,4.90387286725309,-48,0
8,1,10,36,58,-22,0,3.00769709495762,-8,0
8,1,10,60,37,23,1,3.26813127317291,-13,0
8,1,10,21,56,-35,0,4.06186447227446,-6,0
8,1,10,32,93,-61,0,2.38388325154665,-43,0
8,1,10,9,72,-63,0,1.99718661934821,-22,0
8,1,10,12,71,-59,0,2.01860483020027,-21,0
8,1,10,51,0,51,0,2.52319429587806,50,0
8,1,10,85,16,69,0,2.85704332212481,34,0
8,1,10,21,98,-77,0,2.25154870218466,-48,0
8,1,10,41,82,-41,0,2.85419669724615,-32,0
8,1,10,48,74,-26,0,2.47259561413921,-24,0
8,1,10,97,48,49,1,1.77793794115678,-2,0
8,1,10,51,1,50,0,2.04073696128944,49,0
8,1,10,51,2,49,0,1.6368162864328,48,0
8,1,10,49,100,-51,0,1.64831357187541,-50,0
8,1,10,69,3,66,0,2.52765833497688,47,0
8,1,10,51,0,51,0,1.38362545540258,50,0
8,1,1.5,36,56,-20,0,0.9926368494489,-6,0
8,1,1.5,49,100,-51,0,0.845703612310899,-50,0
8,1,1.5,57,5,52,1,1.2895035999336,-45,0
8,1,1.5,90,18,72,1,1.45908335297463,-32,0
8,1,1.5,36,51,-15,0,0.973354663796272,-1,0
8,1,1.5,49,98,-49,0,0.939046645700728,-48,0
8,1,1.5,51,2,49,0,1.02612016137391,48,0
8,1,1.5,65,9,56,1,1.18181424127033,-41,0
8,1,1.5,51,0,51,0,0.810832306622615,50,0
8,1,1.5,39,95,-56,0,0.943240210155636,-45,0
8,1,1.5,13,96,-83,0,0.899625570111311,-46,0
8,1,1.5,0,79,-79,0,0.996012952589808,-29,0
8,1,1.5,51,0,51,0,1.24838058679779,50,0
8,1,1.5,85,6,79,NaN,NaN,0,0
8,1,1.5,51,3,48,1,0.947214315830934,-47,0
8,1,1.5,49,96,-47,0,0.873616233304347,-46,0
8,1,1.5,92,0,92,0,0.952669390928349,50,0
8,1,1.5,78,31,47,1,0.990380680375893,-19,0
8,1,1.5,7,70,-63,0,0.842786953819086,-20,0
8,1,1.5,51,2,49,0,0.949195784092808,48,0
8,1,10,51,0,51,0,2.17714976114075,50,0
8,1,10,49,96,-47,0,1.86987637798848,-46,0
8,1,10,25,61,-36,0,1.64661767170946,-11,0
8,1,10,96,12,84,1,2.63275403500302,-38,0
8,1,10,71,38,33,1,2.06665724673803,-12,0
8,1,10,52,14,38,1,1.79985966953973,-36,0
8,1,10,13,81,-68,0,1.66664245515494,-31,0
8,1,10,2,80,-78,0,1.56345668043105,-30,0
8,1,10,49,99,-50,0,3.48828586029776,-49,0
8,1,10,51,3,48,0,2.91922592571427,47,0
8,1,10,49,100,-51,0,2.21896797863337,-50,0
8,1,10,31,55,-24,0,3.56077910220665,-5,0
8,1,10,51,1,50,0,2.89303999552794,49,0
8,1,10,64,32,32,1,3.77211126529437,-18,0
8,1,10,79,31,48,1,2.96764722619446,-19,0
8,1,10,94,23,71,1,2.85938703321153,-27,0
8,1,10,26,85,-59,0,2.84389239817756,-35,0
8,1,10,56,32,24,1,2.04426430081367,-18,0
8,1,10,49,96,-47,0,2.70165594115497,-46,0
8,1,10,49,98,-49,0,2.42014556968934,-48,0
8,1,1.5,51,2,49,1,0.941742637936841,-48,0
8,1,1.5,49,98,-49,0,1.20346066510319,-48,0
8,1,1.5,56,5,51,1,0.766396280967456,-45,0
8,1,1.5,49,99,-50,0,0.826838005907121,-49,0
8,1,1.5,51,1,50,0,1.04460450720217,49,0
8,1,1.5,69,42,27,1,0.916936551051549,-8,0
8,1,1.5,10,81,-71,0,0.906660929540521,-31,0
8,1,1.5,28,76,-48,0,1.13708781761852,-26,0
8,1,1.5,8,51,-43,0,0.934044374136647,-1,0
8,1,1.5,38,66,-28,0,1.32311490432403,-16,0
8,1,1.5,16,53,-37,0,0.894698162064742,-3,0
8,1,1.5,93,48,45,1,1.26972997151461,-2,0
8,1,1.5,54,31,23,0,1.02935378233815,19,0
8,1,1.5,95,50,45,1,1.04705628739794,0,0
8,1,1.5,51,0,51,0,0.82406232025096,50,0
8,1,1.5,51,4,47,1,0.985794082456778,-46,0
8,1,1.5,51,3,48,1,1.0288303414527,-47,0
8,1,1.5,49,96,-47,0,0.998515144914563,-46,0
8,1,1.5,65,18,47,1,1.10487265745178,-32,0
8,1,1.5,16,66,-50,0,1.1351872502546,-16,0
9,1,10,5,83,-78,0,7.67158169759023,-33,0
9,1,10,98,38,60,0,6.89858685599029,12,0
9,1,10,48,80,-32,1,8.14116018687673,30,0
9,1,10,50,100,-50,0,7.36593480881129,-50,0
9,1,10,53,40,13,0,7.16638797992164,10,0
9,1,10,0,68,-68,0,2.71822946301108,-18,0
9,1,10,48,100,-52,0,7.70538538864639,-50,0
9,1,10,53,40,13,0,7.2917296996784,10,0
9,1,10,100,15,85,0,6.67150532382948,35,0
9,1,10,3,100,-97,0,4.73148408407542,-50,0
9,1,10,75,0,75,0,7.15006240914045,50,0
9,1,10,25,55,-30,0,6.66252823716604,-5,0
9,1,10,53,0,53,NaN,NaN,0,0
9,1,10,48,80,-32,0,3.51308652030821,-30,0
9,1,10,30,100,-70,0,4.62069896180583,-50,0
9,1,10,100,0,100,0,1.45132339126576,50,0
9,1,10,100,15,85,0,1.66208388073392,35,0
9,1,10,28,85,-57,1,4.50027927439987,35,0
9,1,10,53,23,30,0,4.14362195773356,27,0
9,1,10,85,15,70,0,3.05772260687991,35,0
9,1,1.5,48,60,-12,0,1.25886483233262,-10,0
9,1,1.5,50,43,7,0,1.37714726190097,7,0
9,1,1.5,80,45,35,NaN,NaN,0,0
9,1,1.5,48,100,-52,0,0.680656590970102,-50,0
9,1,1.5,53,0,53,0,0.638494652030204,50,0
9,1,1.5,50,43,7,0,0.493034332575917,7,0
9,1,1.5,80,45,35,0,0.826252451210166,5,0
9,1,1.5,50,100,-50,0,0.906076616473001,-50,0
9,1,1.5,85,15,70,0,0.830507647040577,35,0
9,1,1.5,5,83,-78,0,0.717597039962129,-33,0
9,1,1.5,25,55,-30,0,0.760781421317006,-5,0
9,1,1.5,28,85,-57,0,1.0105773554551,-35,0
9,1,1.5,30,100,-70,0,0.994305819865986,-50,0
9,1,1.5,48,60,-12,0,0.874730771929535,-10,0
9,1,1.5,98,38,60,0,0.823771360508545,12,0
9,1,1.5,0,68,-68,0,0.886955101894273,-18,0
9,1,1.5,3,100,-97,0,0.747392768827922,-50,0
9,1,1.5,53,23,30,0,1.14987615376231,27,0
9,1,1.5,75,0,75,0,0.799582009123696,50,0
9,1,1.5,100,0,100,0,0.727350241020758,50,0
9,1,10,54,44,10,0,3.17989345709793,6,0
9,1,10,81,50,31,0,4.39495442328371,0,0
9,1,10,84,24,60,0,4.00895539410521,26,0
9,1,10,48,57,-9,1,1.36706924595092,7,0
9,1,10,63,49,14,0,2.40321154385492,1,0
9,1,10,91,48,43,0,3.60981766293116,2,0
9,1,10,98,12,86,0,4.05676627455796,38,0
9,1,10,18,53,-35,1,3.46885343362374,3,0
9,1,10,47,70,-23,1,2.96844892437184,20,0
9,1,10,20,56,-36,0,2.7035813981347,-6,0
9,1,10,13,84,-71,0,4.09472010978971,-34,0
9,1,10,75,43,32,0,3.50488313305505,7,0
9,1,10,25,93,-68,1,3.62645627557504,43,0
9,1,10,95,24,71,0,3.71941159601738,26,0
9,1,10,79,40,39,0,2.96024251839481,10,0
9,1,10,79,47,32,0,3.36729474476488,3,0
9,1,10,82,20,62,0,3.75833263098139,30,0
9,1,10,41,81,-40,0,2.91786534430867,-31,0
9,1,10,90,42,48,0,3.39099294946755,8,0
9,1,10,86,24,62,0,4.27797155515509,26,0
9,1,1.5,98,49,49,0,1.00643596558621,1,0
9,1,1.5,54,49,5,NaN,NaN,0,0
9,1,1.5,74,30,44,0,0.6647675279346,20,0
9,1,1.5,82,11,71,0,0.541226779967474,39,0
9,1,1.5,74,34,40,0,0.550399480058331,16,0
9,1,1.5,10,92,-82,0,0.534970772701854,-42,0
9,1,1.5,36,80,-44,0,0.656142424693826,-30,0
9,1,1.5,52,29,23,1,0.885336159268263,-21,0
9,1,1.5,86,3,83,0,0.512361422379399,47,0
9,1,1.5,63,36,27,0,0.826954908694461,14,0
9,1,1.5,78,44,34,0,0.639406307209356,6,0
9,1,1.5,69,10,59,0,0.700578369747745,40,0
9,1,1.5,84,48,36,0,0.735063990952767,2,0
9,1,1.5,17,76,-59,NaN,NaN,0,0
9,1,1.5,12,97,-85,NaN,NaN,0,0
9,1,1.5,57,50,7,0,1.03723028893364,0,0
9,1,1.5,86,41,45,NaN,NaN,0,0
9,1,1.5,84,29,55,NaN,NaN,0,0
9,1,1.5,1,53,-52,0,0.612680924314191,-3,0
9,1,1.5,10,95,-85,NaN,NaN,0,0
9,1,10,93,20,73,0,5.63189390628577,30,0
9,1,10,98,29,69,0,4.1381378386468,21,0
9,1,10,22,92,-70,0,4.6962247634583,-42,0
9,1,10,89,29,60,0,4.54543035558709,21,0
9,1,10,40,75,-35,1,2.90345455127863,25,0
9,1,10,46,53,-7,1,2.8311590880603,3,0
9,1,10,23,54,-31,0,3.28291109611564,-4,0
9,1,10,56,45,11,1,3.45995664506518,-5,0
9,1,10,26,95,-69,0,4.08624564096499,-45,0
9,1,10,77,48,29,0,4.69496172859908,2,0
9,1,10,29,98,-69,0,4.07020020793425,-48,0
9,1,10,39,68,-29,0,3.72032204370589,-18,0
9,1,10,76,18,58,0,4.68784598823913,32,0
9,1,10,0,75,-75,0,3.68036800078698,-25,0
9,1,10,100,45,55,0,3.60999878647817,5,0
9,1,10,0,52,-52,0,3.77419331799501,-2,0
9,1,10,91,23,68,0,4.90770431340025,27,0
9,1,10,40,69,-29,1,4.09157520129338,19,0
9,1,10,85,15,70,0,4.01228867109057,35,0
9,1,10,81,36,45,0,3.87241329616336,14,0
9,1,1.5,13,50,-37,0,1.48438990949217,0,0
9,1,1.5,85,28,57,0,0.7252730558248,22,0
9,1,1.5,91,35,56,0,0.901076097250552,15,0
9,1,1.5,65,25,40,0,1.2621570546471,25,0
9,1,1.5,14,55,-41,0,1.12911637671277,-5,0
9,1,1.5,23,90,-67,0,0.777470748551423,-40,0
9,1,1.5,85,26,59,0,0.639940923541872,24,0
9,1,1.5,55,48,7,1,1.17173565260418,-2,0
9,1,1.5,80,49,31,0,0.585407944567123,1,0
9,1,1.5,31,89,-58,0,0.701891213580893,-39,0
9,1,1.5,2,54,-52,0,0.460383794759764,-4,0
9,1,1.5,70,44,26,NaN,NaN,0,0
9,1,1.5,71,32,39,0,0.951416368017817,18,0
9,1,1.5,75,11,64,0,0.781841561580222,39,0
9,1,1.5,9,89,-80,0,1.35358520172849,-39,0
9,1,1.5,88,43,45,0,1.16717496172896,7,0
9,1,1.5,20,56,-36,NaN,NaN,0,0
9,1,1.5,1,89,-88,0,0.709988945431178,-39,0
9,1,1.5,98,47,51,0,0.86181304065758,3,0
9,1,1.5,98,22,76,0,0.671562981491661,28,0
9,1,10,96,45,51,0,3.51772418869223,5,0
9,1,10,5,76,-71,0,5.7959486708005,-26,0
9,1,10,100,11,89,0,4.94288786400284,39,0
9,1,10,53,19,34,0,4.55533177607867,31,0
9,1,10,59,19,40,0,6.19991938191561,31,0
9,1,10,93,39,54,0,4.13869509542019,11,0
9,1,10,79,30,49,0,4.4640690551696,20,0
9,1,10,90,24,66,0,3.48801841785462,26,0
9,1,10,100,5,95,0,2.49562198429885,45,0
9,1,10,88,43,45,0,5.26286705894563,7,0
9,1,10,77,46,31,0,4.74854048836278,4,0
9,1,10,95,43,52,0,4.36902326713607,7,0
9,1,10,88,50,38,0,4.04437802778739,0,0
9,1,10,31,75,-44,0,4.70112777783652,-25,0
9,1,10,27,60,-33,0,4.12300285330457,-10,0
9,1,10,15,75,-60,0,4.39239394009383,-25,0
9,1,10,4,56,-52,0,4.25103667269286,-6,0
9,1,10,4,69,-65,0,4.72305368864727,-19,0
9,1,10,72,49,23,0,3.84825443390946,1,0
9,1,10,84,33,51,0,6.07301607532281,17,0
9,1,1.5,30,50,-20,0,0.815210556127568,0,0
9,1,1.5,45,87,-42,0,0.945643055003529,-37,0
9,1,1.5,86,31,55,0,0.599435359426934,19,0
9,1,1.5,64,24,40,0,0.474605313687789,26,0
9,1,1.5,17,77,-60,0,0.427093287084062,-27,0
9,1,1.5,1,54,-53,0,0.300941945077284,-4,0
9,1,1.5,89,15,74,0,0.307517031655152,35,0
9,1,1.5,25,73,-48,0,0.282103888848724,-23,0
9,1,1.5,96,23,73,0,0.345295780791275,27,0
9,1,1.5,5,99,-94,0,0.206553333644479,-49,0
9,1,1.5,2,89,-87,0,0.317166992290367,-39,0
9,1,1.5,5,90,-85,0,0.283758452436814,-40,0
9,1,1.5,21,62,-41,0,0.347643141942171,-12,0
9,1,1.5,77,46,31,0,0.385578261075352,4,0
9,1,1.5,83,13,70,0,0.381431135625462,37,0
9,1,1.5,31,69,-38,0,0.440668496823491,-19,0
9,1,1.5,62,22,40,0,0.449877119755911,28,0
9,1,1.5,97,22,75,0,0.338421538492184,28,0
9,1,1.5,5,82,-77,0,0.383664087070429,-32,0
9,1,1.5,91,37,54,0,0.698798529039777,13,0
10,1,10,100,0,100,0,1.37952662127645,50,0
10,1,10,85,15,70,1,7.82224207377112,-35,0
10,1,10,53,40,13,1,5.10647985759169,-10,0
10,1,10,98,38,60,0,6.16486231565614,12,0
10,1,10,0,68,-68,0,6.14037924225522,-18,0
10,1,10,50,43,7,1,5.06046843956392,-7,0
10,1,10,100,15,85,0,7.26510091573982,35,0
10,1,10,75,0,75,0,6.7641222448492,50,0
10,1,10,48,80,-32,0,6.74800949423479,-30,0
10,1,10,53,40,13,1,4.8760728971356,-10,0
10,1,10,25,55,-30,0,5.13587107720559,-5,0
10,1,10,50,100,-50,0,8.00824055957855,-50,0
10,1,10,50,43,7,1,4.48567679201551,-7,0
10,1,10,80,45,35,1,5.87247517977448,-5,0
10,1,10,3,100,-97,0,5.16402884547279,-50,0
10,1,10,28,85,-57,0,5.45184593242811,-35,0
10,1,10,48,100,-52,0,5.19139963193629,-50,0
10,1,10,48,60,-12,1,4.68588834431648,10,0
10,1,10,75,0,75,0,5.6964055848639,50,0
10,1,10,53,0,53,0,4.61932876191531,50,0
10,1,1.5,48,60,-12,1,0.747833502522553,10,0
10,1,1.5,0,68,-68,0,0.582328844024232,-18,0
10,1,1.5,53,0,53,1,0.590861876129566,-50,0
10,1,1.5,30,100,-70,0,0.622723017158933,-50,0
10,1,1.5,98,38,60,0,0.925907833210658,12,0
10,1,1.5,80,45,35,1,1.08030478840374,-5,0
10,1,1.5,53,23,30,1,0.893339706608458,-27,0
10,1,1.5,48,100,-52,0,0.617151053151247,-50,0
10,1,1.5,25,55,-30,0,0.655648560890768,-5,0
10,1,1.5,50,100,-50,0,0.741509875801057,-50,0
10,1,1.5,5,83,-78,0,0.703351974707402,-33,0
10,1,1.5,48,80,-32,1,0.65046420127328,30,0
10,1,1.5,53,23,30,1,1.00694884682525,-27,0
10,1,1.5,100,15,85,0,0.806668769449971,35,0
10,1,1.5,5,83,-78,0,0.541832034214167,-33,0
10,1,1.5,100,0,100,0,0.567655723723874,50,0
10,1,1.5,3,100,-97,0,0.520246031925126,-50,0
10,1,1.5,85,15,70,0,0.626785618287613,35,0
10,1,1.5,30,100,-70,0,0.720695459815033,-50,0
10,1,1.5,28,85,-57,0,0.523814769516321,-35,0
10,1,10,99,27,72,0,2.97749544146245,23,0
10,1,10,90,40,50,1,2.32997786040323,-10,0
10,1,10,45,85,-40,0,1.50065570923471,-35,0
10,1,10,89,18,71,0,1.75768118969609,32,0
10,1,10,98,14,84,0,1.43491540900322,36,0
10,1,10,16,52,-36,0,3.02895505574088,-2,0
10,1,10,15,51,-36,0,3.01875206454679,-1,0
10,1,10,42,58,-16,0,3.04783416664213,-8,0
10,1,10,11,81,-70,0,3.04423463804596,-31,0
10,1,10,62,10,52,0,2.46467008319814,40,0
10,1,10,10,91,-81,0,3.0425746407509,-41,0
10,1,10,69,16,53,0,3.23171562007337,34,0
10,1,10,79,25,54,1,3.18138983919016,-25,0
10,1,10,49,67,-18,0,2.62045595411473,-17,0
10,1,10,46,55,-9,0,2.80174854833422,-5,0
10,1,10,94,7,87,0,2.99147606607221,43,0
10,1,10,77,11,66,0,3.29393850105043,39,0
10,1,10,69,47,22,1,2.74424363384969,-3,0
10,1,10,45,57,-12,0,3.2327881733363,-7,0
10,1,10,3,79,-76,0,3.50913108367786,-29,0
10,1,1.5,91,14,77,0,0.870589381793252,36,0
10,1,1.5,98,13,85,0,0.625699480757248,37,0
10,1,1.5,68,32,36,1,0.543514671951925,-18,0
10,1,1.5,8,83,-75,0,0.512016381759167,-33,0
10,1,1.5,11,55,-44,0,0.59391018540191,-5,0
10,1,1.5,96,29,67,0,0.641097397112389,21,0
10,1,1.5,100,11,89,0,0.789591234082764,39,0
10,1,1.5,100,33,67,0,0.43606946786349,17,0
10,1,1.5,24,99,-75,0,0.560634771352852,-49,0
10,1,1.5,43,93,-50,1,0.520490548711678,43,0
10,1,1.5,21,79,-58,0,0.392366167548971,-29,0
10,1,1.5,84,41,43,1,0.780290841888927,-9,0
10,1,1.5,79,36,43,1,0.619328460043107,-14,0
10,1,1.5,16,50,-34,0,0.544567905370059,0,0
10,1,1.5,39,55,-16,0,0.769030089188163,-5,0
10,1,1.5,100,17,83,0,0.734939921057958,33,0
10,1,1.5,99,7,92,0,0.508677972940859,43,0
10,1,1.5,30,80,-50,0,0.579865261932355,-30,0
10,1,1.5,80,28,52,1,0.743710526880022,-22,0
10,1,1.5,89,12,77,0,0.62409623550775,38,0
10,1,10,71,20,51,0,3.5558180925309,30,0
10,1,10,52,5,47,0,2.45871806161813,45,0
10,1,10,87,20,67,0,3.53330020959947,30,0
10,1,10,48,57,-9,0,3.13165150233908,-7,0
10,1,10,89,35,54,0,2.91528010729962,15,0
10,1,10,89,14,75,0,2.64442886286088,36,0
10,1,10,65,28,37,1,2.24033166713707,-22,0
10,1,10,5,63,-58,0,2.23630106450219,-13,0
10,1,10,99,11,88,0,2.44829017535449,39,0
10,1,10,75,45,30,0,2.78749986087678,5,0
10,1,10,53,18,35,0,2.81540707490603,32,0
10,1,10,94,21,73,0,2.72250609152616,29,0
10,1,10,19,91,-72,0,2.51435378111455,-41,0
10,1,10,26,53,-27,0,2.51494424387238,-3,0
10,1,10,100,1,99,0,2.25151242360516,49,0
10,1,10,34,55,-21,0,2.82218139738325,-5,0
10,1,10,84,17,67,0,3.06663811127146,33,0
10,1,10,51,8,43,0,2.7404267569982,42,0
10,1,10,29,99,-70,0,3.40422492982361,-49,0
10,1,10,31,67,-36,0,3.2478416530812,-17,0
10,1,1.5,18,61,-43,0,0.630540007514355,-11,0
10,1,1.5,16,76,-60,0,0.483059858654087,-26,0
10,1,1.5,38,85,-47,0,0.580265544967915,-35,0
10,1,1.5,29,58,-29,0,0.642123763871496,-8,0
10,1,1.5,88,18,70,0,0.837318797704938,32,0
10,1,1.5,97,13,84,0,0.568402254604734,37,0
10,1,1.5,89,17,72,0,0.55016492480172,33,0
10,1,1.5,15,52,-37,0,0.788718822337614,-2,0
10,1,1.5,97,18,79,0,0.673871702685574,32,0
10,1,1.5,42,84,-42,0,1.05096247214715,-34,0
10,1,1.5,88,29,59,0,0.483308299784767,21,0
10,1,1.5,100,23,77,0,0.459843140710291,27,0
10,1,1.5,67,5,62,0,0.653734688761688,45,0
10,1,1.5,89,49,40,0,0.696200613383553,1,0
10,1,1.5,87,14,73,0,0.584596208942457,36,0
10,1,1.5,99,8,91,0,0.525160215587675,42,0
10,1,1.5,84,21,63,0,0.468326363839878,29,0
10,1,1.5,94,25,69,0,0.581601934862192,25,0
10,1,1.5,89,37,52,0,0.578066705124002,13,0
10,1,1.5,0,55,-55,0,0.559276042889906,-5,0
10,1,10,36,65,-29,0,2.83799861474654,-15,0
10,1,10,75,12,63,0,2.95110151465451,38,0
10,1,10,8,60,-52,0,2.9882571987946,-10,0
10,1,10,100,3,97,0,3.14399658133334,47,0
10,1,10,0,81,-81,0,3.39835924379986,-31,0
10,1,10,56,33,23,1,2.22662785967805,-17,0
10,1,10,59,3,56,0,2.22798568252438,47,0
10,1,10,72,33,39,0,3.02993734910342,17,0
10,1,10,93,19,74,0,3.02431889671971,31,0
10,1,10,94,20,74,0,4.48275889169599,30,0
10,1,10,72,33,39,0,5.67932472889697,17,0
10,1,10,33,96,-63,0,2.38224951191114,-46,0
10,1,10,99,7,92,0,4.08152707046247,43,0
10,1,10,67,3,64,0,1.36096266534332,47,0
10,1,10,73,32,41,0,1.80237100958584,18,0
10,1,10,95,16,79,0,1.77313676371159,34,0
10,1,10,19,83,-64,0,2.8012009514805,-33,0
10,1,10,4,82,-78,0,2.70772852331538,-32,0
10,1,10,32,93,-61,0,3.45825317785238,-43,0
10,1,10,97,32,65,0,2.55447868391275,18,0
10,1,1.5,11,90,-79,0,0.615131223747085,-40,0
10,1,1.5,100,32,68,0,0.504891283348115,18,0
10,1,1.5,84,21,63,0,0.600036387459113,29,0
10,1,1.5,90,22,68,0,0.491214342549938,28,0
10,1,1.5,60,0,60,0,0.763189458588386,50,0
10,1,1.5,96,40,56,0,0.440203009045945,10,0
10,1,1.5,47,84,-37,0,0.457424537631596,-34,0
10,1,1.5,23,58,-35,0,0.585906335922118,-8,0
10,1,1.5,89,26,63,0,0.70110785397992,24,0
10,1,1.5,4,57,-53,0,0.523533122403023,-7,0
10,1,1.5,69,19,50,0,0.686118673093006,31,0
10,1,1.5,97,33,64,0,0.893170959838244,17,0
10,1,1.5,88,15,73,0,0.764201939207851,35,0
10,1,1.5,27,97,-70,0,0.624691528228141,-47,0
10,1,1.5,19,84,-65,0,0.466519958345089,-34,0
10,1,1.5,24,96,-72,0,0.666321567687191,-46,0
10,1,1.5,71,27,44,1,0.754095245365534,-23,0
10,1,1.5,37,60,-23,0,0.526543697604211,-10,0
10,1,1.5,70,4,66,0,1.2443830989796,46,0
10,1,1.5,90,23,67,0,1.01333345180865,27,0
11,1,10,50,100,-50,0,3.09237788056862,-50,0
11,1,10,53,23,30,1,2.32810413768675,-27,0
11,1,10,28,85,-57,0,1.24278468405191,-35,0
11,1,10,50,100,-50,0,1.03831491719438,-50,0
11,1,10,48,100,-52,0,2.56982286731045,-50,0
11,1,10,30,100,-70,0,2.42713071937851,-50,0
11,1,10,28,85,-57,0,1.44243052714592,-35,0
11,1,10,0,68,-68,0,4.19046986476496,-18,0
11,1,10,100,0,100,1,4.73461510652851,-50,0
11,1,10,53,0,53,1,3.87251049922861,-50,0
11,1,10,25,55,-30,0,3.30137573606589,-5,0
11,1,10,53,40,13,1,3.53776098101753,-10,0
11,1,10,85,15,70,1,3.68406231746758,-35,0
11,1,10,75,0,75,1,3.20023242387151,-50,0
11,1,10,48,60,-12,0,3.2078930442317,-10,0
11,1,10,25,55,-30,0,3.59172221333347,-5,0
11,1,10,5,83,-78,0,3.43200807458834,-33,0
11,1,10,3,100,-97,0,3.08691579817923,-50,0
11,1,10,53,40,13,1,3.09862664289085,-10,0
11,1,10,53,0,53,1,3.45441849088274,-50,0
11,1,1.5,0,68,-68,0,1.24774867669112,-18,0
11,1,1.5,48,60,-12,0,0.934073788625483,-10,0
11,1,1.5,53,23,30,1,0.873142620402632,-27,0
11,1,1.5,48,100,-52,0,0.614909649638321,-50,0
11,1,1.5,85,15,70,NaN,NaN,0,0
11,1,1.5,48,80,-32,0,0.851323572484944,-30,0
11,1,1.5,5,83,-78,0,0.945861007099211,-33,0
11,1,1.5,3,100,-97,0,1.00421931535675,-50,0
11,1,1.5,30,100,-70,0,0.787924897826088,-50,0
11,1,1.5,80,45,35,1,1.34839269164468,-5,0
11,1,1.5,80,45,35,1,0.846013633873554,-5,0
11,1,1.5,98,38,60,1,0.780518756047513,-12,0
11,1,1.5,100,0,100,1,0.62896574239312,-50,0
11,1,1.5,100,15,85,1,0.955456328798846,-35,0
11,1,1.5,100,15,85,1,0.691939984209966,-35,0
11,1,1.5,50,43,7,1,0.791705549967446,-7,0
11,1,1.5,48,80,-32,0,0.759531970821172,-30,0
11,1,1.5,50,43,7,1,0.608631001931371,-7,0
11,1,1.5,98,38,60,1,0.567850130026272,-12,0
11,1,1.5,75,0,75,1,0.600372673870424,-50,0
11,1,10,26,75,-49,0,1.45338910539886,-25,0
11,1,10,51,0,51,1,2.9623079306557,-50,0
11,1,10,37,53,-16,0,1.95543519771854,-3,0
11,1,10,58,10,48,1,4.85288727242823,-40,0
11,1,10,11,97,-86,0,3.16139440386542,-47,0
11,1,10,51,1,50,1,1.39449829391742,-49,0
11,1,10,95,2,93,1,1.61807719857825,-48,0
11,1,10,49,100,-51,0,0.736971825728688,-50,0
11,1,10,2,92,-90,0,3.04727902333798,-42,0
11,1,10,49,97,-48,0,3.2690575599554,-47,0
11,1,10,17,87,-70,0,3.21471838317484,-37,0
11,1,10,49,99,-50,0,2.3083994052904,-49,0
11,1,10,69,44,25,1,2.68573046532219,-6,0
11,1,10,49,96,-47,0,1.58359248299075,-46,0
11,1,10,51,0,51,1,3.69832609855439,-50,0
11,1,10,80,25,55,1,5.62917946817743,-25,0
11,1,10,67,13,54,1,4.37820291039407,-37,0
11,1,10,51,2,49,1,4.12151552721843,-48,0
11,1,10,24,70,-46,0,6.18691320207472,-20,0
11,1,10,12,98,-86,0,4.77701944914679,-48,0
11,1,1.5,51,2,49,1,0.807410470732066,-48,0
11,1,1.5,51,3,48,1,0.534590715225022,-47,0
11,1,1.5,42,63,-21,0,0.791766528227527,-13,0
11,1,1.5,51,0,51,1,0.567546748087807,-50,0
11,1,1.5,66,14,52,1,0.543428336758552,-36,0
11,1,1.5,91,3,88,1,0.448627367384688,-47,0
11,1,1.5,54,27,27,1,0.749182873299105,-23,0
11,1,1.5,51,1,50,1,0.725679376407243,-49,0
11,1,1.5,50,79,-29,0,1.08750626093843,-29,0
11,1,1.5,97,9,88,1,0.762432362531399,-41,0
11,1,1.5,18,83,-65,0,1.16096061297412,-33,0
11,1,1.5,60,16,44,1,0.673240789365082,-34,0
11,1,1.5,22,86,-64,0,1.23645532175124,-36,0
11,1,1.5,51,2,49,1,0.592750995072493,-48,0
11,1,1.5,51,0,51,1,0.599980541393961,-50,0
11,1,1.5,28,64,-36,0,0.877811683535583,-14,0
11,1,1.5,51,4,47,1,0.441579246481524,-46,0
11,1,1.5,51,3,48,1,0.494810550909278,-47,0
11,1,1.5,43,66,-23,0,0.921999187459733,-16,0
11,1,1.5,98,40,58,1,0.811748077775519,-10,0
11,1,10,51,4,47,1,1.41513128448423,-46,0
11,1,10,2,58,-56,0,5.09655157080397,-8,0
11,1,10,99,30,69,1,5.06496392632744,-20,0
11,1,10,53,23,30,1,4.29143627963003,-27,0
11,1,10,95,6,89,1,5.8767569407546,-44,0
11,1,10,51,0,51,1,5.59898919185525,-50,0
11,1,10,49,96,-47,0,5.64396035698701,-46,0
11,1,10,29,96,-67,1,4.94289782589294,46,0
11,1,10,51,1,50,1,4.86206057626623,-49,0
11,1,10,12,64,-52,0,4.16054493443698,-14,0
11,1,10,24,91,-67,0,4.86926204843894,-41,0
11,1,10,51,3,48,1,4.39846188083902,-47,0
11,1,10,56,50,6,1,3.57110824073879,0,0
11,1,10,49,100,-51,0,4.04807174072175,-50,0
11,1,10,51,2,49,1,3.08276746524007,-48,0
11,1,10,19,69,-50,0,3.46787385721109,-19,0
11,1,10,87,5,82,1,3.66215482088501,-45,0
11,1,10,2,52,-50,0,5.11233346907557,-2,0
11,1,10,49,96,-47,0,4.48078826788333,-46,0
11,1,10,5,62,-57,0,4.08207436580597,-12,0
11,1,1.5,49,99,-50,0,0.609648916257356,-49,0
11,1,1.5,32,94,-62,0,0.558844063594734,-44,0
11,1,1.5,51,4,47,1,0.574015877389684,-46,0
11,1,1.5,51,3,48,1,0.500547639215256,-47,0
11,1,1.5,23,50,-27,0,0.685726239105861,0,0
11,1,1.5,49,96,-47,0,0.758821966522191,-46,0
11,1,1.5,37,69,-32,0,0.581947579324151,-19,0
11,1,1.5,87,37,50,1,0.675121153640248,-13,0
11,1,1.5,56,33,23,1,0.565036073872761,-17,0
11,1,1.5,72,19,53,1,0.474198691422316,-31,0
11,1,1.5,49,99,-50,0,0.51404556957732,-49,0
11,1,1.5,37,93,-56,0,0.633894717813746,-43,0
11,1,1.5,51,4,47,1,0.460362965648528,-46,0
11,1,1.5,16,58,-42,0,0.702903090551445,-8,0
11,1,1.5,35,92,-57,0,0.871365798419902,-42,0
11,1,1.5,51,0,51,1,0.440467751656797,-50,0
11,1,1.5,51,1,50,1,0.498315593388725,-49,0
11,1,1.5,60,11,49,1,0.570183303166232,-39,0
11,1,1.5,84,25,59,1,0.503380109596037,-25,0
11,1,1.5,21,54,-33,0,0.559227139894574,-4,0
11,1,10,49,99,-50,0,5.22472123285115,-49,0
11,1,10,49,96,-47,0,5.86653704469518,-46,0
11,1,10,51,0,51,1,4.92999669761411,-50,0
11,1,10,51,2,49,1,4.95984193358254,-48,0
11,1,10,34,88,-54,0,5.27626446583417,-38,0
11,1,10,76,8,68,1,4.7633422064755,-42,0
11,1,10,42,55,-13,0,3.471847104056,-5,0
11,1,10,16,90,-74,0,3.39214278220607,-40,0
11,1,10,0,97,-97,0,4.01970900097513,-47,0
11,1,10,49,85,-36,1,4.82114325795737,35,0
11,1,10,21,77,-56,0,4.76502122174315,-27,0
11,1,10,49,99,-50,0,4.016868681907,-49,0
11,1,10,91,16,75,1,7.98626453828365,-34,0
11,1,10,49,96,-47,0,7.10781685159327,-46,0
11,1,10,37,93,-56,0,4.08891328901427,-43,0
11,1,10,51,3,48,1,3.61568365092353,-47,0
11,1,10,31,80,-49,0,4.88917054482408,-30,0
11,1,10,51,2,49,1,6.59166425379954,-48,0
11,1,10,68,7,61,1,6.43428842002686,-43,0
11,1,10,68,3,65,1,4.6589748951701,-47,0
11,1,1.5,51,4,47,1,1.05685683642787,-46,0
11,1,1.5,49,96,-47,0,0.609832756655123,-46,0
11,1,1.5,87,45,42,1,0.533025807791091,-5,0
11,1,1.5,95,25,70,1,0.610911951114758,-25,0
11,1,1.5,61,38,23,0,0.662038298070001,12,0
11,1,1.5,4,75,-71,0,1.32716289899508,-25,0
11,1,1.5,49,100,-51,0,0.677455534269939,-50,0
11,1,1.5,10,60,-50,0,0.565202405662603,-10,0
11,1,1.5,31,61,-30,0,0.529731472369349,-11,0
11,1,1.5,51,1,50,1,0.592268602696095,-49,0
11,1,1.5,51,2,49,1,0.465357145545568,-48,0
11,1,1.5,51,4,47,1,0.585246744706637,-46,0
11,1,1.5,16,64,-48,0,0.772360649682014,-14,0
11,1,1.5,49,81,-32,0,0.568840573948364,-31,0
11,1,1.5,59,1,58,1,0.876659737785303,-49,0
11,1,1.5,47,66,-19,0,1.06843304597078,-16,0
11,1,1.5,69,29,40,1,0.756080057914915,-21,0
11,1,1.5,49,97,-48,0,1.08047927111511,-47,0
11,1,1.5,49,96,-47,0,0.928157086136707,-46,0
11,1,1.5,96,37,59,1,0.62190282973279,-13,0
12,1,10,85,15,70,1,1.56617843370395,-35,0
12,1,10,100,15,85,1,4.58761247115126,-35,0
12,1,10,0,68,-68,0,1.71490114269272,-18,0
12,1,10,100,0,100,0,4.41440018802678,50,0
12,1,10,50,43,7,1,2.22977507388168,-7,0
12,1,10,53,0,53,0,2.46107998607522,50,0
12,1,10,100,0,100,0,1.4183450362234,50,0
12,1,10,53,40,13,1,1.76654218807198,-10,0
12,1,10,53,23,30,1,6.93248632687209,-27,0
12,1,10,5,83,-78,0,1.68643653327626,-33,0
12,1,10,50,100,-50,1,4.19184832284191,50,0
12,1,10,48,80,-32,0,3.49584494188821,-30,0
12,1,10,53,23,30,1,2.74017527915385,-27,0
12,1,10,5,83,-78,0,2.67872222384358,-33,0
12,1,10,48,60,-12,0,6.67590576886414,-10,0
12,1,10,98,38,60,1,4.05592010772898,-12,0
12,1,10,28,85,-57,0,7.0293150227144,-35,0
12,1,10,75,0,75,0,4.5932640971032,50,0
12,1,10,50,100,-50,1,3.91311708600142,50,0
12,1,10,80,45,35,1,5.10859174017105,-5,0
12,1,1.5,48,60,-12,NaN,NaN,0,0
12,1,1.5,48,100,-52,0,1.17966390994297,-50,0
12,1,1.5,25,55,-30,1,1.43736712562213,5,0
12,1,1.5,85,15,70,1,1.42828171881365,-35,0
12,1,1.5,48,80,-32,0,1.41196892024436,-30,0
12,1,1.5,53,40,13,NaN,NaN,0,0
12,1,1.5,98,38,60,0,1.17739021874195,12,0
12,1,1.5,30,100,-70,0,1.47431309828789,-50,0
12,1,1.5,50,43,7,NaN,NaN,0,0
12,1,1.5,3,100,-97,0,0.773254286300471,-50,0
12,1,1.5,75,0,75,0,1.35903737700482,50,0
12,1,1.5,25,55,-30,NaN,NaN,0,0
12,1,1.5,3,100,-97,0,0.773890026299341,-50,0
12,1,1.5,100,15,85,1,0.823008337029933,-35,0
12,1,1.5,28,85,-57,NaN,NaN,0,0
12,1,1.5,48,100,-52,0,0.891363367330541,-50,0
12,1,1.5,80,45,35,1,0.711761082168323,-5,0
12,1,1.5,30,100,-70,0,0.586291484335106,-50,0
12,1,1.5,0,68,-68,0,0.954797299122674,-18,0
12,1,1.5,53,0,53,0,0.988524121101818,50,0
12,1,10,46,56,-10,0,1.23182719188299,-6,0
12,1,10,26,50,-24,0,0.937366672816097,0,0
12,1,10,81,15,66,1,1.11889096964569,-35,0
12,1,10,32,50,-18,0,1.28514271483618,0,0
12,1,10,94,48,46,1,1.45260013218012,-2,0
12,1,10,98,38,60,1,1.32893300516116,-12,0
12,1,10,25,55,-30,0,3.3544960320196,-5,0
12,1,10,50,100,-50,1,2.78606749616847,50,0
12,1,10,86,50,36,1,2.13734856056544,0,0
12,1,10,22,91,-69,0,2.4660696092642,-41,0
12,1,10,33,98,-65,0,2.09196892024465,-48,0
12,1,10,51,1,50,1,2.29116654753943,-49,0
12,1,10,49,96,-47,0,1.63788272102465,-46,0
12,1,10,56,41,15,1,1.41872418600451,-9,0
12,1,10,51,2,49,1,2.33282291286378,-48,0
12,1,10,5,73,-68,0,1.99745557377992,-23,0
12,1,10,59,48,11,1,2.49221253001633,-2,0
12,1,10,66,3,63,1,2.71879497471673,-47,0
12,1,10,0,58,-58,0,1.80804037307371,-8,0
12,1,10,51,4,47,1,2.17410586395272,-46,0
12,1,1.5,51,0,51,1,0.879311475731811,-50,0
12,1,1.5,2,83,-81,0,1.48372633683357,-33,0
12,1,1.5,53,23,30,NaN,NaN,0,0
12,1,1.5,51,2,49,0,1.30582569762191,48,0
12,1,1.5,75,16,59,NaN,NaN,0,0
12,1,1.5,49,97,-48,1,1.40800052612212,47,0
12,1,1.5,57,26,31,1,1.12633751963949,-24,0
12,1,1.5,47,91,-44,0,0.79998253461963,-41,0
12,1,1.5,51,4,47,1,1.27910258110842,-46,0
12,1,1.5,94,21,73,NaN,NaN,0,0
12,1,1.5,49,97,-48,0,0.932623074364528,-47,0
12,1,1.5,51,4,47,1,1.28565348030497,-46,0
12,1,1.5,13,95,-82,0,1.14466741919205,-45,0
12,1,1.5,51,0,51,0,1.16967741866392,50,0
12,1,1.5,26,53,-27,1,1.20141672300178,3,0
12,1,1.5,68,39,29,0,1.16763345117488,11,0
12,1,1.5,51,44,7,1,1.38335880908107,-6,0
12,1,1.5,48,85,-37,1,1.32625571263998,35,0
12,1,1.5,49,99,-50,NaN,NaN,0,0
12,1,1.5,39,80,-41,0,0.85977348905999,-30,0
12,1,10,49,98,-49,0,1.53381969039219,-48,0
12,1,10,49,96,-47,1,1.95803335457549,46,0
12,1,10,49,100,-51,0,2.56615186907038,-50,0
12,1,10,51,4,47,0,2.0693621145665,46,0
12,1,10,15,80,-65,0,1.9514836628623,-30,0
12,1,10,83,50,33,1,2.11084973408833,0,0
12,1,10,57,37,20,1,2.26363562464576,-13,0
12,1,10,38,86,-48,0,1.29476303678166,-36,0
12,1,10,75,7,68,1,2.30438003814743,-43,0
12,1,10,32,95,-63,0,1.67368641441408,-45,0
12,1,10,59,24,35,1,2.00982925969765,-26,0
12,1,10,51,0,51,0,1.46713008154165,50,0
12,1,10,13,71,-58,0,1.37334394194113,-21,0
12,1,10,28,94,-66,0,2.00810919962623,-44,0
12,1,10,14,92,-78,0,2.23682496558558,-42,0
12,1,10,49,96,-47,1,1.79213962820722,46,0
12,1,10,51,2,49,1,2.15762311209892,-48,0
12,1,10,61,10,51,1,1.45166825688375,-40,0
12,1,10,59,19,40,1,1.73909639275553,-31,0
12,1,10,49,98,-49,0,2.60630582320027,-48,0
12,1,1.5,49,98,-49,0,1.07226671583248,-48,0
12,1,1.5,13,97,-84,0,0.697991243593606,-47,0
12,1,1.5,92,44,48,1,0.899116014359606,-6,0
12,1,1.5,51,3,48,0,1.17221947304552,47,0
12,1,1.5,64,41,23,1,0.913875385563188,-9,0
12,1,1.5,51,1,50,0,1.15495064951119,49,0
12,1,1.5,35,94,-59,0,1.48933117280467,-44,0
12,1,1.5,49,99,-50,0,1.33813674534031,-49,0
12,1,1.5,79,18,61,1,1.00182968231729,-32,0
12,1,1.5,97,12,85,1,1.44542888839715,-38,0
12,1,1.5,100,2,98,1,1.46241334959541,-48,0
12,1,1.5,51,0,51,NaN,NaN,0,0
12,1,1.5,51,3,48,1,1.13047073524285,-47,0
12,1,1.5,100,39,61,1,0.76213970367462,-11,0
12,1,1.5,49,98,-49,1,1.44855144041321,48,0
12,1,1.5,93,29,64,1,1.0261900557316,-21,0
12,1,1.5,49,100,-51,1,1.40517531688783,50,0
12,1,1.5,5,99,-94,0,0.720737513601307,-49,0
12,1,1.5,76,3,73,1,1.02390519530945,-47,0
12,1,1.5,26,77,-51,0,1.12295656618062,-27,0
12,1,10,83,50,33,1,1.54229622370804,0,0
12,1,10,96,40,56,1,2.02048530051161,-10,0
12,1,10,52,29,23,0,2.6711986967839,21,0
12,1,10,51,0,51,0,1.46307655984037,50,0
12,1,10,49,97,-48,0,2.04065329163586,-47,0
12,1,10,51,3,48,0,1.80653977310521,47,0
12,1,10,86,16,70,1,1.95331239643747,-34,0
12,1,10,51,50,1,1,1.98137914008203,0,0
12,1,10,43,78,-35,0,2.68941931909194,-28,0
12,1,10,51,1,50,0,2.28864743534177,49,0
12,1,10,36,65,-29,0,3.14987076693978,-15,0
12,1,10,58,12,46,1,2.8182529656151,-38,0
12,1,10,49,100,-51,0,3.2439814176978,-50,0
12,1,10,49,96,-47,0,4.4209969715921,-46,0
12,1,10,49,98,-49,1,2.87828420924779,48,0
12,1,10,47,88,-41,0,5.02206831122021,-38,0
12,1,10,74,24,50,1,1.52722562366307,-26,0
12,1,10,51,0,51,0,1.40996389409429,50,0
12,1,10,90,33,57,1,1.76484507018358,-17,0
12,1,10,61,10,51,1,2.33693228067114,-40,0
12,1,1.5,25,53,-28,0,0.769022962673262,-3,0
12,1,1.5,49,98,-49,1,0.988850443484807,48,0
12,1,1.5,61,5,56,1,1.072579755898,-45,0
12,1,1.5,4,67,-63,0,0.880904146308239,-17,0
12,1,1.5,80,24,56,1,1.42522980457488,-26,0
12,1,1.5,35,95,-60,0,0.898861839108577,-45,0
12,1,1.5,51,2,49,NaN,NaN,0,0
12,1,1.5,49,97,-48,1,1.1937769756687,47,0
12,1,1.5,48,62,-14,0,1.48470349275794,-12,0
12,1,1.5,49,99,-50,NaN,NaN,0,0
12,1,1.5,81,46,35,1,0.816781345248273,-4,0
12,1,1.5,97,8,89,1,0.714461316872985,-42,0
12,1,1.5,64,47,17,1,1.09628567332129,-3,0
12,1,1.5,59,11,48,1,0.967336712134966,-39,0
12,1,1.5,49,98,-49,0,0.922916719228851,-48,0
12,1,1.5,49,96,-47,0,0.936727612237519,-46,0
12,1,1.5,66,39,27,1,0.861747120641667,-11,0
12,1,1.5,51,3,48,1,0.822826308911317,-47,0
12,1,1.5,79,24,55,1,1.14527085901045,-26,0
12,1,1.5,51,0,51,0,1.00691771540278,50,0
13,1,10,0,68,-68,0,2.47908688270036,-18,0
13,1,10,48,100,-52,0,3.79574064438748,-50,0
13,1,10,48,80,-32,0,4.06726350733152,-30,0
13,1,10,25,55,-30,0,3.67135778159536,-5,0
13,1,10,100,15,85,0,3.34025497193215,35,0
13,1,10,30,100,-70,0,3.70256428389439,-50,0
13,1,10,5,83,-78,0,3.36153716834451,-33,0
13,1,10,75,0,75,0,3.8991329180044,50,0
13,1,10,5,83,-78,0,1.74996676074443,-33,0
13,1,10,85,15,70,1,3.53611662452568,-35,0
13,1,10,48,100,-52,0,4.23439430041981,-50,0
13,1,10,98,38,60,1,5.20849257447298,-12,0
13,1,10,50,43,7,1,1.2075960180664,-7,0
13,1,10,75,0,75,0,4.94778000834594,50,0
13,1,10,3,100,-97,0,3.14895971960686,-50,0
13,1,10,25,55,-30,0,4.71129891677992,-5,0
13,1,10,50,100,-50,1,5.05054167376875,50,0
13,1,10,48,80,-32,1,3.39905850684045,30,0
13,1,10,53,23,30,1,4.71074920997307,-27,0
13,1,10,53,0,53,0,2.16997385470859,50,0
13,1,1.5,53,0,53,0,0.864028961232179,50,0
13,1,1.5,100,0,100,0,0.802456968809565,50,0
13,1,1.5,53,40,13,1,0.922955659441868,-10,0
13,1,1.5,100,0,100,0,0.918695356214812,50,0
13,1,1.5,85,15,70,1,1.22648377493897,-35,0
13,1,1.5,53,23,30,1,1.0574681002945,-27,0
13,1,1.5,80,45,35,NaN,NaN,0,0
13,1,1.5,100,15,85,0,0.811116737726479,35,0
13,1,1.5,50,100,-50,0,0.890215351382722,-50,0
13,1,1.5,28,85,-57,0,0.933935607672538,-35,0
13,1,1.5,48,60,-12,1,1.009046809344,10,0
13,1,1.5,98,38,60,0,1.01676504309762,12,0
13,1,1.5,0,68,-68,0,0.895806603168239,-18,0
13,1,1.5,80,45,35,NaN,NaN,0,0
13,1,1.5,30,100,-70,0,0.720127129628963,-50,0
13,1,1.5,28,85,-57,0,1.46662052243119,-35,0
13,1,1.5,50,43,7,1,0.878880403040966,-7,0
13,1,1.5,48,60,-12,1,0.891990351949062,10,0
13,1,1.5,3,100,-97,0,0.648437030238711,-50,0
13,1,1.5,53,40,13,1,0.926293143500516,-10,0
13,1,10,3,56,-53,0,1.71244512037811,-6,0
13,1,10,100,6,94,0,1.52262601647999,44,0
13,1,10,74,42,32,1,2.60861754900361,-8,0
13,1,10,78,38,40,0,3.12786951305134,12,0
13,1,10,48,61,-13,1,2.73763926106403,11,0
13,1,10,99,9,90,0,1.54681281416015,41,0
13,1,10,28,64,-36,0,4.2881867793094,-14,0
13,1,10,67,21,46,0,8.13084928015815,29,0
13,1,10,48,64,-16,1,3.54639985484391,14,0
13,1,10,19,73,-54,0,5.56267069336718,-23,0
13,1,10,19,56,-37,0,4.51894681462909,-6,0
13,1,10,68,47,21,1,4.82423242218101,-3,0
13,1,10,47,95,-48,0,4.49342031414017,-45,0
13,1,10,100,15,85,0,8.99203578351262,35,0
13,1,10,96,5,91,0,5.66862554858199,45,0
13,1,10,49,64,-15,0,5.33556782332926,-14,0
13,1,10,49,79,-30,0,4.31929577732444,-29,0
13,1,10,49,77,-28,0,4.287993280097,-27,0
13,1,10,24,50,-26,0,5.64942263854573,0,0
13,1,10,17,76,-59,0,5.06020969130441,-26,0
13,1,1.5,99,13,86,0,0.729990759477005,37,0
13,1,1.5,40,73,-33,0,0.859739678400729,-23,0
13,1,1.5,85,19,66,1,1.20018659818561,-31,0
13,1,1.5,37,75,-38,0,0.862520512622723,-25,0
13,1,1.5,96,7,89,0,1.03497992986013,43,0
13,1,1.5,96,13,83,0,0.791367139590875,37,0
13,1,1.5,46,97,-51,0,0.911162169288218,-47,0
13,1,1.5,86,24,62,0,0.86555854080143,26,0
13,1,1.5,14,82,-68,0,1.20598946143218,-32,0
13,1,1.5,70,33,37,NaN,NaN,0,0
13,1,1.5,17,65,-48,0,1.02157263817026,-15,0
13,1,1.5,100,13,87,0,0.706561355746089,37,0
13,1,1.5,27,93,-66,0,0.941062778312698,-43,0
13,1,1.5,91,11,80,0,0.661432570097531,39,0
13,1,1.5,99,8,91,0,0.641954655722657,42,0
13,1,1.5,59,10,49,0,1.08718336062157,40,0
13,1,1.5,82,33,49,0,1.33751368279263,17,0
13,1,1.5,96,11,85,0,0.810474356569102,39,0
13,1,1.5,86,8,78,0,1.22490499042215,42,0
13,1,1.5,94,8,86,0,0.830552692052152,42,0
13,1,10,48,97,-49,0,2.04148675591387,-47,0
13,1,10,15,76,-61,0,4.91752862539943,-26,0
13,1,10,12,54,-42,0,3.71740999015674,-4,0
13,1,10,96,15,81,0,6.42154758288962,35,0
13,1,10,45,60,-15,1,2.08961251530854,10,0
13,1,10,19,68,-49,0,3.73172923367019,-18,0
13,1,10,38,60,-22,0,4.57116081087042,-10,0
13,1,10,29,86,-57,0,5.36043383040851,-36,0
13,1,10,97,8,89,0,2.59812482031703,42,0
13,1,10,98,11,87,0,4.79538171995409,39,0
13,1,10,96,8,88,0,5.88586569438485,42,0
13,1,10,97,11,86,0,4.74277046168027,39,0
13,1,10,88,41,47,1,6.62922415846515,-9,0
13,1,10,99,8,91,0,4.71991823500503,42,0
13,1,10,2,78,-76,0,2.0951355442794,-28,0
13,1,10,96,10,86,0,6.60045013143281,40,0
13,1,10,32,94,-62,0,5.54781623284725,-44,0
13,1,10,14,90,-76,0,4.29010697975173,-40,0
13,1,10,32,100,-68,0,5.39475533795121,-50,0
13,1,10,95,38,57,1,8.15907450599479,-12,0
13,1,1.5,72,32,40,0,0.667533077994449,18,0
13,1,1.5,62,33,29,0,0.877332409350856,17,0
13,1,1.5,96,15,81,0,0.679016244921513,35,0
13,1,1.5,43,92,-49,0,0.976801569469899,-42,0
13,1,1.5,18,59,-41,0,1.10258964104469,-9,0
13,1,1.5,44,84,-40,0,1.06295309354209,-34,0
13,1,1.5,6,92,-86,0,0.833354657232121,-42,0
13,1,1.5,92,12,80,0,0.644449014511338,38,0
13,1,1.5,70,38,32,1,1.03156154441604,-12,0
13,1,1.5,100,4,96,0,0.922610319197702,46,0
13,1,1.5,63,40,23,1,0.984317851629385,-10,0
13,1,1.5,16,56,-40,0,1.13334907262288,-6,0
13,1,1.5,98,7,91,0,0.779671757460164,43,0
13,1,1.5,89,0,89,0,0.625443528007963,50,0
13,1,1.5,13,92,-79,0,0.58066249757394,-42,0
13,1,1.5,25,57,-32,0,0.649771903114015,-7,0
13,1,1.5,24,55,-31,0,1.16360528550103,-5,0
13,1,1.5,54,39,15,1,1.08857890953732,-11,0
13,1,1.5,48,61,-13,NaN,NaN,0,0
13,1,1.5,96,16,80,NaN,NaN,0,0
13,1,10,70,39,31,1,4.99917261401788,-11,0
13,1,10,63,39,24,1,3.78623141091339,-11,0
13,1,10,57,32,25,1,1.90178092905262,-18,0
13,1,10,89,12,77,0,4.12968013437603,38,0
13,1,10,95,48,47,0,4.20838722154986,2,0
13,1,10,28,60,-32,0,2.95509705574659,-10,0
13,1,10,50,11,39,0,1.73702948195933,39,0
13,1,10,66,49,17,1,1.99839197601614,-1,0
13,1,10,97,11,86,0,4.7377337466387,39,0
13,1,10,49,54,-5,1,3.42294886734999,4,0
13,1,10,78,35,43,0,3.85457859257076,15,0
13,1,10,99,17,82,0,1.59003619103714,33,0
13,1,10,90,16,74,0,3.16544549016908,34,0
13,1,10,59,49,10,1,3.41705815968817,-1,0
13,1,10,94,19,75,0,1.17003754945654,31,0
13,1,10,78,40,38,1,5.54677296720911,-10,0
13,1,10,0,54,-54,0,3.959139106355,-4,0
13,1,10,3,92,-89,0,4.70656558193878,-42,0
13,1,10,22,100,-78,0,4.29577973666164,-50,0
13,1,10,2,82,-80,0,4.56638128978739,-32,0
13,1,1.5,36,85,-49,0,0.731833680980344,-35,0
13,1,1.5,91,19,72,0,0.505619518711683,31,0
13,1,1.5,89,18,71,0,1.09677892915897,32,0
13,1,1.5,20,86,-66,0,0.728470537902467,-36,0
13,1,1.5,28,64,-36,0,1.30954534904413,-14,0
13,1,1.5,62,36,26,1,0.796493208403263,-14,0
13,1,1.5,45,94,-49,1,1.17623224105773,44,0
13,1,1.5,99,19,80,0,0.67588312742555,31,0
13,1,1.5,76,25,51,0,0.763696148624149,25,0
13,1,1.5,26,56,-30,0,0.672133589667283,-6,0
13,1,1.5,65,7,58,0,0.709919668890507,43,0
13,1,1.5,93,14,79,0,0.516375176903239,36,0
13,1,1.5,96,15,81,0,0.634185707665893,35,0
13,1,1.5,29,87,-58,0,0.642675221428362,-37,0
13,1,1.5,94,8,86,0,0.595815810227577,42,0
13,1,1.5,34,60,-26,0,0.830998857160012,-10,0
13,1,1.5,12,71,-59,0,0.552762084764254,-21,0
13,1,1.5,84,13,71,0,0.797256036026738,37,0
13,1,1.5,74,4,70,0,0.624323889047446,46,0
13,1,1.5,66,30,36,0,1.01678345721848,20,0
14,1,10,85,15,70,1,1.04302660045505,-35,0
14,1,10,48,80,-32,0,2.37384685900906,-30,0
14,1,10,3,100,-97,0,2.51055178780553,-50,0
14,1,10,48,100,-52,1,2.65844374823064,50,0
14,1,10,48,100,-52,1,2.98432389041045,50,0
14,1,10,48,80,-32,1,2.92814180191635,30,0
14,1,10,3,100,-97,0,3.32329134118663,-50,0
14,1,10,50,43,7,1,3.126220092121,-7,0
14,1,10,5,83,-78,0,2.35400549213591,-33,0
14,1,10,80,45,35,1,1.89200906930637,-5,0
14,1,10,50,43,7,1,4.51278533018194,-7,0
14,1,10,98,38,60,1,3.7080870123591,-12,0
14,1,10,80,45,35,1,3.80701974798831,-5,0
14,1,10,30,100,-70,0,2.47854079970602,-50,0
14,1,10,48,60,-12,1,2.6678298183997,10,0
14,1,10,53,40,13,1,2.89642574163372,-10,0
14,1,10,75,0,75,1,1.97217600388285,-50,0
14,1,10,53,0,53,1,2.57362256897068,-50,0
14,1,10,53,0,53,1,2.83083947071827,-50,0
14,1,10,30,100,-70,0,2.55733814626001,-50,0
14,1,1.5,85,15,70,1,0.864271666754576,-35,0
14,1,1.5,0,68,-68,0,0.606703991084942,-18,0
14,1,1.5,75,0,75,1,0.767253094150874,-50,0
14,1,1.5,25,55,-30,0,0.641055987582149,-5,0
14,1,1.5,5,83,-78,1,0.552227774735002,33,0
14,1,1.5,98,38,60,1,0.754808468584088,-12,0
14,1,1.5,28,85,-57,0,0.605259237223436,-35,0
14,1,1.5,53,40,13,1,0.676440684241243,-10,0
14,1,1.5,53,23,30,1,0.562313581520357,-27,0
14,1,1.5,28,85,-57,0,0.644187293853975,-35,0
14,1,1.5,25,55,-30,0,0.594726661583991,-5,0
14,1,1.5,48,60,-12,0,0.986574941298386,-10,0
14,1,1.5,100,0,100,1,0.562962301966763,-50,0
14,1,1.5,100,0,100,1,0.556127040434149,-50,0
14,1,1.5,50,100,-50,0,1.1660259891687,-50,0
14,1,1.5,0,68,-68,0,0.598382015641619,-18,0
14,1,1.5,50,100,-50,0,0.893599928658659,-50,0
14,1,1.5,53,23,30,1,0.985336365221883,-27,0
14,1,1.5,100,15,85,1,0.721063534354471,-35,0
14,1,1.5,100,15,85,1,0.555553183956363,-35,0
14,1,10,51,4,47,1,0.870303951842288,-46,0
14,1,10,83,9,74,1,1.67192982821143,-41,0
14,1,10,51,0,51,1,2.60058959712842,-50,0
14,1,10,46,81,-35,0,2.61519350484559,-31,0
14,1,10,51,2,49,1,2.05376082581824,-48,0
14,1,10,22,74,-52,0,3.61909910983195,-24,0
14,1,10,74,4,70,1,3.26472688798822,-46,0
14,1,10,54,50,4,1,3.82974247206948,0,0
14,1,10,27,57,-30,0,3.57993468833047,-7,0
14,1,10,51,3,48,1,2.84351653683552,-47,0
14,1,10,51,3,48,1,2.79066951743334,-47,0
14,1,10,30,74,-44,0,3.49316040470876,-24,0
14,1,10,0,80,-80,0,2.77482341119139,-30,0
14,1,10,95,37,58,1,2.68666625722835,-13,0
14,1,10,51,0,51,1,1.73719309732041,-50,0
14,1,10,36,56,-20,0,2.70662897618058,-6,0
14,1,10,51,1,50,1,2.56521093788797,-49,0
14,1,10,51,4,47,1,3.58840035429603,-46,0
14,1,10,19,96,-77,0,3.44270963606868,-46,0
14,1,10,4,95,-91,0,3.60711876162532,-45,0
14,1,1.5,51,4,47,1,0.749479542564586,-46,0
14,1,1.5,52,14,38,1,1.01386557500155,-36,0
14,1,1.5,51,3,48,1,0.708266625510078,-47,0
14,1,1.5,49,99,-50,NaN,NaN,0,0
14,1,1.5,43,75,-32,0,0.913971682603005,-25,0
14,1,1.5,51,1,50,1,0.667683109168138,-49,0
14,1,1.5,33,52,-19,0,0.67883663313296,-2,0
14,1,1.5,92,41,51,1,0.505989915602186,-9,0
14,1,1.5,77,3,74,1,0.56389387539275,-47,0
14,1,1.5,46,57,-11,0,0.62771842805887,-7,0
14,1,1.5,12,63,-51,0,0.648285794310141,-13,0
14,1,1.5,58,34,24,1,0.660731627362111,-16,0
14,1,1.5,49,98,-49,0,0.553254135606039,-48,0
14,1,1.5,33,61,-28,0,0.657801668941829,-11,0
14,1,1.5,40,90,-50,0,0.726293144865849,-40,0
14,1,1.5,49,99,-50,0,0.695410248112239,-49,0
14,1,1.5,49,100,-51,0,0.674596253378695,-50,0
14,1,1.5,85,26,59,1,0.534447883859684,-24,0
14,1,1.5,78,26,52,1,0.703614192054374,-24,0
14,1,1.5,49,97,-48,0,0.674112958156911,-47,0
14,1,10,51,8,43,1,2.15818761081937,-42,0
14,1,10,51,4,47,1,2.14884923624049,-46,0
14,1,10,49,96,-47,0,2.99206536822021,-46,0
14,1,10,37,92,-55,0,3.73381033263649,-42,0
14,1,10,32,70,-38,0,2.56540685206528,-20,0
14,1,10,51,0,51,1,3.42784913813375,-50,0
14,1,10,49,98,-49,0,3.93618786740808,-48,0
14,1,10,98,33,65,1,4.07901413319087,-17,0
14,1,10,74,45,29,1,5.00778499057924,-5,0
14,1,10,34,55,-21,0,3.72358234468084,-5,0
14,1,10,49,99,-50,0,3.64178500567323,-49,0
14,1,10,65,37,28,1,3.82064348107269,-13,0
14,1,10,36,83,-47,0,3.69612236143621,-33,0
14,1,10,79,36,43,1,2.81699325882073,-14,0
14,1,10,49,96,-47,0,2.82085811124489,-46,0
14,1,10,49,97,-48,0,3.32867822640765,-47,0
14,1,10,15,75,-60,0,2.6729341525097,-25,0
14,1,10,24,84,-60,0,2.82752462697499,-34,0
14,1,10,1,74,-73,0,3.26326402187624,-24,0
14,1,10,51,3,48,1,2.36165006940428,-47,0
14,1,1.5,49,96,-47,0,0.695446170742798,-46,0
14,1,1.5,49,98,-49,0,0.521281183231622,-48,0
14,1,1.5,94,43,51,1,0.737150231660053,-7,0
14,1,1.5,51,2,49,1,0.704916462878828,-48,0
14,1,1.5,8,71,-63,0,0.80144026916787,-21,0
14,1,1.5,12,58,-46,0,1.14985506989615,-8,0
14,1,1.5,50,41,9,1,0.804860163965714,-9,0
14,1,1.5,71,41,30,0,0.513293378815433,9,0
14,1,1.5,82,32,50,1,0.681877378150602,-18,0
14,1,1.5,51,0,51,1,0.706331029656212,-50,0
14,1,1.5,3,76,-73,0,0.536769572525372,-26,0
14,1,1.5,49,96,-47,0,0.74325224891254,-46,0
14,1,1.5,49,98,-49,0,0.509705341955851,-48,0
14,1,1.5,52,36,16,1,0.669622931216509,-14,0
14,1,1.5,65,8,57,1,0.758742147560042,-42,0
14,1,1.5,49,100,-51,0,0.676466947003064,-50,0
14,1,1.5,84,16,68,1,0.59031934725499,-34,0
14,1,1.5,3,100,-97,0,0.578767051903924,-50,0
14,1,1.5,10,78,-68,0,0.744024132662162,-28,0
14,1,1.5,51,0,51,1,0.950411115991301,-50,0
14,1,10,49,98,-49,0,2.30744885739296,-48,0
14,1,10,80,7,73,1,3.87472575597167,-43,0
14,1,10,51,2,49,1,3.98687651027285,-48,0
14,1,10,49,97,-48,0,4.05431264572144,-47,0
14,1,10,15,78,-63,1,3.8630599571843,28,0
14,1,10,58,6,52,1,3.24857076038825,-44,0
14,1,10,49,100,-51,0,3.65086890312705,-50,0
14,1,10,0,83,-83,0,3.63577536089906,-33,0
14,1,10,36,62,-26,0,2.86868833908011,-12,0
14,1,10,2,91,-89,0,3.67711174312899,-41,0
14,1,10,89,29,60,1,5.12999921322444,-21,0
14,1,10,59,26,33,1,3.30298479134399,-24,0
14,1,10,51,3,48,1,4.62929177889964,-47,0
14,1,10,16,63,-47,0,4.5425908498928,-13,0
14,1,10,49,96,-47,0,3.98715574080416,-46,0
14,1,10,70,38,32,1,3.56594176720319,-12,0
14,1,10,51,4,47,1,3.68946912801948,-46,0
14,1,10,49,99,-50,0,3.40770439106382,-49,0
14,1,10,88,21,67,1,3.36129718238772,-29,0
14,1,10,50,33,17,1,3.50165172969537,-17,0
14,1,1.5,49,99,-50,0,0.955689327709479,-49,0
14,1,1.5,53,38,15,1,0.64872803509752,-12,0
14,1,1.5,39,57,-18,0,0.697923624764371,-7,0
14,1,1.5,100,21,79,1,0.673046750334834,-29,0
14,1,1.5,51,4,47,1,0.712858986669744,-46,0
14,1,1.5,51,3,48,1,0.655969312916568,-47,0
14,1,1.5,73,46,27,1,0.745074643200496,-4,0
14,1,1.5,49,96,-47,0,0.918218099774094,-46,0
14,1,1.5,7,64,-57,0,0.93990842556741,-14,0
14,1,1.5,0,93,-93,0,0.673013242671004,-43,0
14,1,1.5,42,58,-16,0,0.894808619519608,-8,0
14,1,1.5,49,99,-50,0,0.829814921073194,-49,0
14,1,1.5,51,4,47,1,0.607590283883837,-46,0
14,1,1.5,56,14,42,1,0.55408669539429,-36,0
14,1,1.5,92,44,48,1,0.583211496348667,-6,0
14,1,1.5,33,55,-22,0,0.666377517765795,-5,0
14,1,1.5,64,42,22,1,0.570138375682291,-8,0
14,1,1.5,49,100,-51,0,1.21392745852427,-50,0
14,1,1.5,51,0,51,1,0.52024878494376,-50,0
14,1,1.5,2,61,-59,0,1.49412669328194,-11,0
15,1,10,98,38,60,0,8.71629905724376,12,0
15,1,10,50,43,7,0,4.5816792548776,7,0
15,1,10,25,55,-30,0,2.58967639315097,-5,0
15,1,10,50,100,-50,0,6.52617473211149,-50,0
15,1,10,53,23,30,0,2.09502899987319,27,0
15,1,10,48,100,-52,0,6.40359984195447,-50,0
15,1,10,100,15,85,0,2.05037126755042,35,0
15,1,10,75,0,75,0,1.58099642508841,50,0
15,1,10,85,15,70,0,3.91851176385489,35,0
15,1,10,25,55,-30,0,4.64136739305013,-5,0
15,1,10,48,80,-32,0,3.34328985171987,-30,0
15,1,10,53,40,13,0,3.13765665689471,10,0
15,1,10,75,0,75,0,3.71606933422436,50,0
15,1,10,0,68,-68,0,3.18295676843582,-18,0
15,1,10,48,60,-12,1,6.64727559138464,10,0
15,1,10,3,100,-97,0,2.11664017026851,-50,0
15,1,10,48,80,-32,0,3.23201757560582,-30,0
15,1,10,28,85,-57,0,2.36709591840008,-35,0
15,1,10,100,0,100,0,2.12840826774845,50,0
15,1,10,80,45,35,0,2.40378669944312,5,0
15,1,1.5,30,100,-70,0,0.528222013999311,-50,0
15,1,1.5,98,38,60,0,0.724063151928021,12,0
15,1,1.5,53,0,53,0,0.463939415442383,50,0
15,1,1.5,0,68,-68,0,0.71851146198469,-18,0
15,1,1.5,85,15,70,0,1.3383222800976,35,0
15,1,1.5,53,0,53,0,1.06864164339368,50,0
15,1,1.5,3,100,-97,0,0.746335719347371,-50,0
15,1,1.5,100,0,100,0,0.821477786884316,50,0
15,1,1.5,53,23,30,0,0.909318315035762,27,0
15,1,1.5,100,15,85,0,0.873080640762964,35,0
15,1,1.5,28,85,-57,0,0.894883800435309,-35,0
15,1,1.5,50,100,-50,0,1.13930969664943,-50,0
15,1,1.5,80,45,35,NaN,NaN,0,0
15,1,1.5,53,40,13,NaN,NaN,0,0
15,1,1.5,5,83,-78,0,0.670771939512633,-33,0
15,1,1.5,48,60,-12,1,1.37194847757792,10,0
15,1,1.5,30,100,-70,0,0.972813334936745,-50,0
15,1,1.5,48,100,-52,0,0.717983189601455,-50,0
15,1,1.5,50,43,7,0,1.47313195865172,7,0
15,1,1.5,5,83,-78,0,0.92602591023433,-33,0
15,1,10,99,46,53,0,1.6158602892956,4,0
15,1,10,94,14,80,0,1.16675510724554,36,0
15,1,10,21,89,-68,0,1.9795405064001,-39,0
15,1,10,47,79,-32,0,2.9882585100745,-29,0
15,1,10,87,19,68,0,3.62010276933825,31,0
15,1,10,74,30,44,0,2.85038304047794,20,0
15,1,10,90,48,42,0,2.31086026665571,2,0
15,1,10,56,25,31,0,1.40217531773942,25,0
15,1,10,85,17,68,0,2.18163759682739,33,0
15,1,10,63,21,42,0,2.12570502249537,29,0
15,1,10,80,12,68,0,1.76505799448023,38,0
15,1,10,46,99,-53,0,3.04106582498616,-49,0
15,1,10,76,33,43,0,3.30213562184326,17,0
15,1,10,33,58,-25,1,6.08842861378162,8,0
15,1,10,13,91,-78,0,4.00992401705707,-41,0
15,1,10,100,46,54,0,2.06404205121999,4,0
15,1,10,91,24,67,0,3.97275658338958,26,0
15,1,10,59,48,11,0,3.37225125312125,2,0
15,1,10,60,48,12,0,2.77065073873473,2,0
15,1,10,100,39,61,0,3.79372416708657,11,0
15,1,1.5,16,57,-41,0,1.04429221083365,-7,0
15,1,1.5,27,61,-34,0,1.01740525961395,-11,0
15,1,1.5,80,31,49,0,0.582466229794136,19,0
15,1,1.5,81,17,64,0,0.701643271981993,33,0
15,1,1.5,54,12,42,0,0.951434000650352,38,0
15,1,1.5,87,27,60,0,1.06387240031745,23,0
15,1,1.5,99,8,91,0,0.588221078202423,42,0
15,1,1.5,46,61,-15,NaN,NaN,0,0
15,1,1.5,90,20,70,0,1.13530327889475,30,0
15,1,1.5,62,10,52,0,1.05628580515395,40,0
15,1,1.5,31,62,-31,0,0.914592888380412,-12,0
15,1,1.5,1,100,-99,0,1.42037807471752,-50,0
15,1,1.5,74,27,47,0,0.802056682855437,23,0
15,1,1.5,71,20,51,0,0.832470682375515,30,0
15,1,1.5,86,38,48,0,1.18154522462737,12,0
15,1,1.5,86,18,68,0,0.900536918675243,32,0
15,1,1.5,46,52,-6,1,1.3822986919804,2,0
15,1,1.5,87,43,44,0,0.773267347316505,7,0
15,1,1.5,14,61,-47,0,0.7883448448747,-11,0
15,1,1.5,66,37,29,0,1.25949407880398,13,0
15,1,10,85,20,65,0,1.48020658240785,30,0
15,1,10,30,77,-47,0,1.61631249045513,-27,0
15,1,10,85,39,46,0,3.08236374495118,11,0
15,1,10,37,64,-27,0,4.86737077097314,-14,0
15,1,10,98,13,85,0,4.99653759486409,37,0
15,1,10,2,65,-63,0,6.37700117652093,-15,0
15,1,10,94,15,79,0,8.35833142675619,35,0
15,1,10,96,6,90,0,5.21985644347205,44,0
15,1,10,49,65,-16,1,4.31089618917667,15,0
15,1,10,38,84,-46,0,5.10287942935884,-34,0
15,1,10,6,59,-53,0,4.53334082245783,-9,0
15,1,10,7,61,-54,0,5.50865118248294,-11,0
15,1,10,75,45,30,0,5.40492686218113,5,0
15,1,10,98,29,69,0,6.95327389789418,21,0
15,1,10,46,85,-39,1,7.26244576301178,35,0
15,1,10,53,25,28,0,7.00820245282739,25,0
15,1,10,76,14,62,0,5.8040173280715,36,0
15,1,10,76,49,27,0,4.37565513848767,1,0
15,1,10,99,25,74,0,6.00559640969277,25,0
15,1,10,22,70,-48,0,6.67306947157431,-20,0
15,1,1.5,73,42,31,0,0.864161893582605,8,0
15,1,1.5,100,22,78,0,0.683929544296006,28,0
15,1,1.5,18,97,-79,0,0.509076215348614,-47,0
15,1,1.5,73,41,32,0,0.702329422339972,9,0
15,1,1.5,10,85,-75,0,1.09477180669001,-35,0
15,1,1.5,53,30,23,0,1.14382446337186,20,0
15,1,1.5,71,34,37,0,1.3428044448674,16,0
15,1,1.5,73,18,55,0,0.893845971603696,32,0
15,1,1.5,98,47,51,0,0.782748780051406,3,0
15,1,1.5,37,99,-62,0,0.659266468874193,-49,0
15,1,1.5,97,49,48,0,0.699038738196577,1,0
15,1,1.5,94,24,70,0,0.570867783216272,26,0
15,1,1.5,26,74,-48,0,0.760059933993944,-24,0
15,1,1.5,63,44,19,NaN,NaN,0,0
15,1,1.5,82,19,63,0,0.888340467759917,31,0
15,1,1.5,3,57,-54,0,1.02474794387217,-7,0
15,1,1.5,70,46,24,0,0.73977759504578,4,0
15,1,1.5,89,18,71,0,0.666916456723811,32,0
15,1,1.5,91,41,50,0,0.804035742137785,9,0
15,1,1.5,12,92,-80,0,0.60048877042118,-42,0
15,1,10,7,94,-87,0,4.59495821137352,-44,0
15,1,10,57,49,8,0,3.92548948736294,1,0
15,1,10,16,52,-36,0,4.45162825395164,-2,0
15,1,10,86,34,52,0,5.49217632900309,16,0
15,1,10,75,18,57,0,5.09920325731127,32,0
15,1,10,88,42,46,0,4.53831141277988,8,0
15,1,10,4,81,-77,0,3.47090325293357,-31,0
15,1,10,79,30,49,0,3.97446154477166,20,0
15,1,10,33,84,-51,0,3.05862559900561,-34,0
15,1,10,28,68,-40,0,4.41965087004792,-18,0
15,1,10,60,42,18,0,4.4822599016934,8,0
15,1,10,85,27,58,0,3.69756772601158,23,0
15,1,10,6,100,-94,0,4.72040116776679,-50,0
15,1,10,19,74,-55,0,1.74167696066615,-24,0
15,1,10,45,51,-6,1,2.30706968590221,1,0
15,1,10,86,30,56,0,3.81774244832923,20,0
15,1,10,58,16,42,0,3.67522421915874,34,0
15,1,10,34,68,-34,1,5.22673183307325,18,0
15,1,10,86,26,60,0,2.65173813460751,24,0
15,1,10,74,23,51,0,4.58827752787965,27,0
15,1,1.5,1,58,-57,0,0.536160891374493,-8,0
15,1,1.5,2,68,-66,0,0.382010708064627,-18,0
15,1,1.5,57,36,21,NaN,NaN,0,0
15,1,1.5,53,16,37,0,0.473726642419933,34,0
15,1,1.5,29,70,-41,0,0.474273328868549,-20,0
15,1,1.5,3,77,-74,0,0.522846314226626,-27,0
15,1,1.5,62,43,19,0,1.12132458789256,7,0
15,1,1.5,50,97,-47,0,0.870992908303378,-47,0
15,1,1.5,68,36,32,0,0.974035002556775,14,0
15,1,1.5,85,46,39,0,0.63371136780097,4,0
15,1,1.5,68,7,61,0,0.568222496990529,43,0
15,1,1.5,97,26,71,0,0.796060338499956,24,0
15,1,1.5,34,51,-17,1,1.19113653801742,1,0
15,1,1.5,19,94,-75,0,0.530114436611257,-44,0
15,1,1.5,99,8,91,0,0.671884330216017,42,0
15,1,1.5,25,82,-57,0,0.791092163137364,-32,0
15,1,1.5,35,73,-38,0,1.12945968072472,-23,0
15,1,1.5,76,3,73,0,0.767167159703604,47,0
15,1,1.5,83,32,51,0,0.914880570427158,18,0
15,1,1.5,53,35,18,0,1.38464754193137,15,0
16,1,10,48,60,-12,0,1.75558833413743,-10,0
16,1,10,48,80,-32,0,3.64164118854387,-30,0
16,1,10,0,68,-68,0,3.36716927225825,-18,0
16,1,10,53,23,30,0,4.0641724584948,27,0
16,1,10,98,38,60,1,3.11695019015315,-12,0
16,1,10,3,100,-97,0,4.09666694559564,-50,0
16,1,10,85,15,70,1,4.27680722455443,-35,0
16,1,10,53,40,13,0,4.40952102015945,10,0
16,1,10,28,85,-57,0,3.16889808136693,-35,0
16,1,10,98,38,60,1,4.25792495835594,-12,0
16,1,10,53,23,30,0,3.67935651614061,27,0
16,1,10,48,100,-52,0,4.85222746523323,-50,0
16,1,10,85,15,70,1,4.68134795208971,-35,0
16,1,10,48,80,-32,0,4.13393671317135,-30,0
16,1,10,5,83,-78,0,4.44814256129757,-33,0
16,1,10,75,0,75,1,4.78210066476822,-50,0
16,1,10,50,43,7,1,7.26200654172317,-7,0
16,1,10,53,0,53,1,7.29776424280317,-50,0
16,1,10,25,55,-30,0,4.56487747572282,-5,0
16,1,10,30,100,-70,0,5.13417368106821,-50,0
16,1,1.5,53,0,53,1,0.986725010277951,-50,0
16,1,1.5,50,100,-50,0,0.883737252612264,-50,0
16,1,1.5,80,45,35,1,1.11275510368978,-5,0
16,1,1.5,100,0,100,1,0.708585374301038,-50,0
16,1,1.5,80,45,35,1,1.23977714170542,-5,0
16,1,1.5,3,100,-97,0,0.702707966700473,-50,0
16,1,1.5,100,0,100,1,0.539215814564159,-50,0
16,1,1.5,5,83,-78,0,0.693762956836508,-33,0
16,1,1.5,0,68,-68,0,0.794937985552679,-18,0
16,1,1.5,50,100,-50,0,0.995381130613168,-50,0
16,1,1.5,25,55,-30,0,1.0837716657843,-5,0
16,1,1.5,75,0,75,1,0.688218813642379,-50,0
16,1,1.5,28,85,-57,0,0.916671564205899,-35,0
16,1,1.5,30,100,-70,0,0.919766334762244,-50,0
16,1,1.5,48,60,-12,0,1.33084828188294,-10,0
16,1,1.5,53,40,13,NaN,NaN,0,0
16,1,1.5,100,15,85,1,0.674325551830407,-35,0
16,1,1.5,100,15,85,1,0.471559215762682,-35,0
16,1,1.5,50,43,7,0,0.604106379167206,7,0
16,1,1.5,48,100,-52,0,0.555320575505903,-50,0
16,1,10,7,76,-69,0,0.946263873765929,-26,0
16,1,10,44,67,-23,0,1.63252984834617,-17,0
16,1,10,49,100,-51,0,5.73054792129915,-50,0
16,1,10,91,11,80,1,5.29950210800962,-39,0
16,1,10,87,19,68,1,5.18256765755541,-31,0
16,1,10,17,84,-67,0,4.67827884047801,-34,0
16,1,10,19,97,-78,0,3.89819953924598,-47,0
16,1,10,51,3,48,0,4.78974521895907,47,0
16,1,10,51,0,51,0,3.98828326287367,50,0
16,1,10,49,99,-50,0,1.85908383702917,-49,0
16,1,10,51,2,49,0,3.61449764788085,48,0
16,1,10,49,100,-51,0,2.90810419362788,-50,0
16,1,10,60,24,36,1,3.87054131034711,-26,0
16,1,10,66,37,29,1,2.89807486696373,-13,0
16,1,10,51,1,50,0,3.10922171612037,49,0
16,1,10,49,96,-47,0,3.0236153273454,-46,0
16,1,10,24,97,-73,0,2.06938212980458,-47,0
16,1,10,87,32,55,1,1.93747523252932,-18,0
16,1,10,42,96,-54,0,4.62343662034436,-46,0
16,1,10,8,100,-92,0,3.91671201477584,-50,0
16,1,1.5,26,58,-32,0,0.71940741141043,-8,0
16,1,1.5,99,22,77,1,0.481890110489985,-28,0
16,1,1.5,86,20,66,1,1.21239119948586,-30,0
16,1,1.5,51,3,48,0,0.770738884219099,47,0
16,1,1.5,49,96,-47,0,0.642536232895509,-46,0
16,1,1.5,99,6,93,1,0.502972404761749,-44,0
16,1,1.5,51,1,50,1,1.12088868717365,-49,0
16,1,1.5,51,2,49,0,1.36260952691373,48,0
16,1,1.5,56,46,10,1,1.06686725138934,-4,0
16,1,1.5,0,90,-90,0,0.64660151528733,-40,0
16,1,1.5,96,28,68,1,0.874420338990603,-22,0
16,1,1.5,49,98,-49,0,0.741551080367572,-48,0
16,1,1.5,70,29,41,1,0.685954487273193,-21,0
16,1,1.5,13,84,-71,0,0.616464330496456,-34,0
16,1,1.5,88,20,68,1,0.574274686747231,-30,0
16,1,1.5,98,35,63,1,0.55016946696378,-15,0
16,1,1.5,36,76,-40,0,0.694687282573796,-26,0
16,1,1.5,51,2,49,0,0.889841968271867,48,0
16,1,1.5,49,99,-50,0,0.684964052021314,-49,0
16,1,1.5,51,4,47,0,0.720116503884128,46,0
16,1,10,80,35,45,1,3.82692412368488,-15,0
16,1,10,51,4,47,0,3.56709410664553,46,0
16,1,10,49,98,-49,0,4.28464346615146,-48,0
16,1,10,21,63,-42,0,5.38933256275959,-13,0
16,1,10,51,3,48,0,5.0743678136223,47,0
16,1,10,51,2,49,0,3.54818980393975,48,0
16,1,10,36,85,-49,0,4.7151045573828,-35,0
16,1,10,67,8,59,1,4.67563959165091,-42,0
16,1,10,57,42,15,1,5.90950456824794,-8,0
16,1,10,70,30,40,1,4.88503378397581,-20,0
16,1,10,49,89,-40,0,5.89219353505359,-39,0
16,1,10,51,2,49,0,3.77242724275675,48,0
16,1,10,26,61,-35,0,3.20990107440593,-11,0
16,1,10,7,79,-72,0,2.34299794295839,-29,0
16,1,10,6,66,-60,0,3.93492563907239,-16,0
16,1,10,51,3,48,0,5.09366545284865,47,0
16,1,10,49,99,-50,0,4.51016838023133,-49,0
16,1,10,89,16,73,1,2.31083611652502,-34,0
16,1,10,62,11,51,1,2.32812239638588,-39,0
16,1,10,49,96,-47,0,3.36074698942502,-46,0
16,1,1.5,49,99,-50,0,0.501658063072682,-49,0
16,1,1.5,50,18,32,0,0.878864468148095,32,0
16,1,1.5,27,78,-51,0,0.777298215998599,-28,0
16,1,1.5,51,2,49,1,1.06369097595234,-48,0
16,1,1.5,20,79,-59,0,0.650800526058447,-29,0
16,1,1.5,33,96,-63,0,0.957884054978422,-46,0
16,1,1.5,39,87,-48,0,1.20423859819675,-37,0
16,1,1.5,51,3,48,0,0.952601029275684,47,0
16,1,1.5,49,100,-51,0,0.639056880045246,-50,0
16,1,1.5,87,5,82,0,0.481510961853928,45,0
16,1,1.5,13,88,-75,0,0.657345669953429,-38,0
16,1,1.5,98,11,87,1,0.707857867762868,-39,0
16,1,1.5,49,97,-48,0,0.532319595937224,-47,0
16,1,1.5,100,9,91,1,0.450825581263416,-41,0
16,1,1.5,43,73,-30,0,0.588733954684358,-23,0
16,1,1.5,49,100,-51,0,0.617889156581441,-50,0
16,1,1.5,49,96,-47,0,0.821039773076336,-46,0
16,1,1.5,41,64,-23,0,1.17612122512946,-14,0
16,1,1.5,51,1,50,0,0.76511112305343,49,0
16,1,1.5,47,76,-29,0,0.530198959657355,-26,0
16,1,10,43,79,-36,0,4.90614173719041,-29,0
16,1,10,49,99,-50,0,4.63268470762159,-49,0
16,1,10,78,6,72,1,4.9699045157231,-44,0
16,1,10,56,2,54,0,6.36568226096642,48,0
16,1,10,43,88,-45,0,3.64108755908637,-38,0
16,1,10,51,0,51,0,4.17063111665266,50,0
16,1,10,51,4,47,0,5.66267578736552,46,0
16,1,10,57,8,49,0,3.99889670785888,42,0
16,1,10,4,56,-52,0,3.55301217612578,-6,0
16,1,10,51,2,49,0,3.63726679133833,48,0
16,1,10,34,94,-60,0,2.70012396007223,-44,0
16,1,10,30,52,-22,0,1.57862221752657,-2,0
16,1,10,68,48,20,1,2.28400229441286,-2,0
16,1,10,51,1,50,0,3.44325649455459,49,0
16,1,10,19,88,-69,0,4.46020437822153,-38,0
16,1,10,38,78,-40,0,2.9801892243504,-28,0
16,1,10,49,98,-49,0,4.67259764833216,-48,0
16,1,10,49,99,-50,0,5.61649361188029,-49,0
16,1,10,51,0,51,0,3.83407813923441,50,0
16,1,10,35,73,-38,0,5.03488624504644,-23,0
16,1,1.5,49,96,-47,0,0.909902734691059,-46,0
16,1,1.5,15,77,-62,0,0.65300810088047,-27,0
16,1,1.5,68,42,26,1,0.742117086492726,-8,0
16,1,1.5,51,0,51,0,0.827885579421491,50,0
16,1,1.5,30,85,-55,0,0.686290770378037,-35,0
16,1,1.5,49,100,-51,0,0.661400688766662,-50,0
16,1,1.5,51,2,49,0,1.14991921678848,48,0
16,1,1.5,28,89,-61,0,1.10618792329115,-39,0
16,1,1.5,74,48,26,1,0.752577785291578,-2,0
16,1,1.5,18,53,-35,0,0.732997595809138,-3,0
16,1,1.5,49,99,-50,0,0.840049730255487,-49,0
16,1,1.5,49,98,-49,0,0.617131161177895,-48,0
16,1,1.5,7,91,-84,0,0.60295202854104,-41,0
16,1,1.5,78,48,30,1,0.797483956570431,-2,0
16,1,1.5,64,21,43,1,1.05652941365224,-29,0
16,1,1.5,31,68,-37,0,0.616898721331381,-18,0
16,1,1.5,51,3,48,1,1.10667121705592,-47,0
16,1,1.5,73,23,50,1,1.08905740831688,-27,0
16,1,1.5,49,100,-51,0,0.624011380699812,-50,0
16,1,1.5,52,43,9,1,0.969844141736758,-7,0
17,1,10,53,23,30,1,7.0733405511055,-27,0
17,1,10,28,85,-57,0,4.38054633734646,-35,0
17,1,10,75,0,75,1,3.42060659058552,-50,0
17,1,10,50,43,7,0,3.44362477674076,7,0
17,1,10,30,100,-70,0,4.06589553293816,-50,0
17,1,10,25,55,-30,0,3.50266178146558,-5,0
17,1,10,80,45,35,1,3.24233579212523,-5,0
17,1,10,48,80,-32,0,4.05664140826411,-30,0
17,1,10,85,15,70,1,3.82217933293578,-35,0
17,1,10,98,38,60,1,2.41364577179047,-12,0
17,1,10,53,40,13,1,2.3816463513831,-10,0
17,1,10,75,0,75,1,3.23896752740984,-50,0
17,1,10,100,15,85,1,2.99666256934506,-35,0
17,1,10,100,15,85,1,5.09308978775152,-35,0
17,1,10,48,60,-12,0,3.01690808016428,-10,0
17,1,10,50,100,-50,1,4.24000837493804,50,0
17,1,10,3,100,-97,0,3.40606702524747,-50,0
17,1,10,48,100,-52,0,6.63766284555459,-50,0
17,1,10,98,38,60,1,5.91495483075778,-12,0
17,1,10,0,68,-68,0,2.53393067663637,-18,0
17,1,1.5,48,60,-12,1,1.460101139568,10,0
17,1,1.5,85,15,70,1,1.18645755438047,-35,0
17,1,1.5,3,100,-97,NaN,NaN,0,0
17,1,1.5,80,45,35,1,0.856748270220123,-5,0
17,1,1.5,5,83,-78,0,0.918459540684125,-33,0
17,1,1.5,28,85,-57,0,0.865567400320288,-35,0
17,1,1.5,50,100,-50,1,1.02333730600367,50,0
17,1,1.5,53,23,30,1,0.742404165663174,-27,0
17,1,1.5,100,0,100,1,0.720197104019462,-50,0
17,1,1.5,5,83,-78,0,0.706739440523961,-33,0
17,1,1.5,53,0,53,NaN,NaN,0,0
17,1,1.5,0,68,-68,0,0.76242327403088,-18,0
17,1,1.5,48,100,-52,0,0.779557109573943,-50,0
17,1,1.5,50,43,7,1,1.28398569242927,-7,0
17,1,1.5,48,80,-32,0,0.975631291090394,-30,0
17,1,1.5,25,55,-30,0,0.864064088054874,-5,0
17,1,1.5,53,40,13,1,0.877170676816604,-10,0
17,1,1.5,30,100,-70,0,1.09828496930277,-50,0
17,1,1.5,100,0,100,1,0.710013823689223,-50,0
17,1,1.5,53,0,53,1,0.793803861077322,-50,0
17,1,10,51,3,48,1,4.72482295887676,-47,0
17,1,10,84,7,77,1,3.01406325790958,-43,0
17,1,10,19,83,-64,0,2.38849879886766,-33,0
17,1,10,49,57,-8,0,2.50049526095245,-7,0
17,1,10,49,96,-47,0,2.76705878872599,-46,0
17,1,10,71,46,25,1,2.65554984658229,-4,0
17,1,10,9,74,-65,0,3.12412352624233,-24,0
17,1,10,51,4,47,1,2.68587539821237,-46,0
17,1,10,97,13,84,1,2.21705539269169,-37,0
17,1,10,49,98,-49,0,2.36703705408945,-48,0
17,1,10,49,98,-49,0,2.30172538093393,-48,0
17,1,10,51,1,50,1,2.96036391734742,-49,0
17,1,10,94,40,54,1,4.91280853552962,-10,0
17,1,10,51,2,49,1,4.13863622515419,-48,0
17,1,10,60,41,19,1,2.66741182561236,-9,0
17,1,10,81,12,69,1,2.39132641453398,-38,0
17,1,10,45,57,-12,0,2.46984067109588,-7,0
17,1,10,50,58,-8,0,1.80992009307374,-8,0
17,1,10,93,38,55,1,2.43263761677736,-12,0
17,1,10,51,4,47,1,2.72592418039494,-46,0
17,1,1.5,96,25,71,1,0.666090239046753,-25,0
17,1,1.5,51,4,47,1,0.66256771879489,-46,0
17,1,1.5,40,72,-32,0,0.659762441504427,-22,0
17,1,1.5,0,61,-61,0,0.752243314269435,-11,0
17,1,1.5,20,64,-44,0,0.688677958674816,-14,0
17,1,1.5,49,99,-50,0,0.819866405508947,-49,0
17,1,1.5,25,61,-36,0,0.873645137864514,-11,0
17,1,1.5,51,1,50,0,0.540736032413406,49,0
17,1,1.5,50,63,-13,0,1.45325684257114,-13,0
17,1,1.5,49,98,-49,0,0.841499008667597,-48,0
17,1,1.5,49,99,-50,0,0.725304743293236,-49,0
17,1,1.5,29,70,-41,0,0.607114815782552,-20,0
17,1,1.5,23,92,-69,0,0.73230148460425,-42,0
17,1,1.5,51,1,50,1,0.829429041255935,-49,0
17,1,1.5,68,3,65,1,0.70721579128076,-47,0
17,1,1.5,18,62,-44,0,0.860987731561181,-12,0
17,1,1.5,44,58,-14,0,0.816768918120943,-8,0
17,1,1.5,42,58,-16,0,0.734522039838339,-8,0
17,1,1.5,49,100,-51,0,0.863044069548778,-50,0
17,1,1.5,49,98,-49,0,0.323474505887134,-48,0
17,1,10,36,59,-23,0,2.59702903944344,-9,0
17,1,10,4,81,-77,0,2.1788443946607,-31,0
17,1,10,51,2,49,1,2.2728762751467,-48,0
17,1,10,49,99,-50,0,1.94687727433484,-49,0
17,1,10,99,22,77,1,1.81029109122392,-28,0
17,1,10,49,97,-48,0,4.2116108665723,-47,0
17,1,10,51,3,48,1,3.60765606857603,-47,0
17,1,10,36,96,-60,0,2.22791274858173,-46,0
17,1,10,13,51,-38,0,4.87189731094986,-1,0
17,1,10,82,12,70,1,4.18376789327522,-38,0
17,1,10,96,36,60,1,4.69906771804017,-14,0
17,1,10,55,16,39,1,3.25966010759657,-34,0
17,1,10,70,1,69,1,3.74195739816059,-49,0
17,1,10,51,2,49,1,3.08484541800135,-48,0
17,1,10,26,90,-64,0,2.50189925801533,-40,0
17,1,10,49,96,-47,0,2.98247830491891,-46,0
17,1,10,49,100,-51,0,2.39559757222014,-50,0
17,1,10,37,86,-49,0,3.09618818074523,-36,0
17,1,10,13,86,-73,0,3.01657028770569,-36,0
17,1,10,49,97,-48,0,2.81234108994249,-47,0
17,1,1.5,47,99,-52,0,1.28736301324534,-49,0
17,1,1.5,49,100,-51,0,0.705679273316491,-50,0
17,1,1.5,49,98,-49,0,0.658827550319984,-48,0
17,1,1.5,97,43,54,1,0.717971718870103,-7,0
17,1,1.5,91,27,64,1,0.573804977997497,-23,0
17,1,1.5,98,44,54,1,1.05964169352956,-6,0
17,1,1.5,11,61,-50,0,0.78195365497595,-11,0
17,1,1.5,49,96,-47,0,0.923036492615211,-46,0
17,1,1.5,85,46,39,1,1.02680216909721,-4,0
17,1,1.5,51,1,50,1,0.813843496598565,-49,0
17,1,1.5,1,94,-93,0,0.639634659961303,-44,0
17,1,1.5,49,98,-49,0,0.850796300743241,-48,0
17,1,1.5,61,47,14,1,0.87649780873835,-3,0
17,1,1.5,23,54,-31,0,0.550273009212106,-4,0
17,1,1.5,86,31,55,1,0.684101610484504,-19,0
17,1,1.5,49,96,-47,0,0.740529855247587,-46,0
17,1,1.5,96,11,85,1,0.683023029214382,-39,0
17,1,1.5,51,2,49,1,0.627448774492223,-48,0
17,1,1.5,71,0,71,1,0.56659451276937,-50,0
17,1,1.5,51,0,51,1,0.955853678671701,-50,0
17,1,10,38,69,-31,0,3.73090684551426,-19,0
17,1,10,38,57,-19,0,6.02504951226365,-7,0
17,1,10,49,99,-50,0,4.21051598432314,-49,0
17,1,10,58,24,34,1,2.77261259176157,-26,0
17,1,10,8,80,-72,0,3.38506050032811,-30,0
17,1,10,49,100,-51,0,3.86002235151682,-50,0
17,1,10,49,97,-48,0,3.78756270020676,-47,0
17,1,10,51,4,47,1,3.11830528514838,-46,0
17,1,10,25,70,-45,0,2.76402288280951,-20,0
17,1,10,72,9,63,1,3.24120136491547,-41,0
17,1,10,51,3,48,1,3.40017784472002,-47,0
17,1,10,51,1,50,1,3.20243824677891,-49,0
17,1,10,72,22,50,1,2.64484765183806,-28,0
17,1,10,51,4,47,1,2.54199935808356,-46,0
17,1,10,15,56,-41,0,2.84320910184033,-6,0
17,1,10,55,40,15,1,2.4523313093523,-10,0
17,1,10,12,88,-76,0,2.54099624429364,-38,0
17,1,10,51,2,49,1,2.92212876972189,-48,0
17,1,10,34,86,-52,0,2.57590116281426,-36,0
17,1,10,100,7,93,1,2.17176071480935,-43,0
17,1,1.5,82,41,41,1,1.0098524742134,-9,0
17,1,1.5,27,58,-31,0,1.31681555702744,-8,0
17,1,1.5,85,19,66,1,0.650535485121509,-31,0
17,1,1.5,51,1,50,1,1.49036390225228,-49,0
17,1,1.5,49,96,-47,0,0.993176877225778,-46,0
17,1,1.5,44,91,-47,NaN,NaN,0,0
17,1,1.5,49,99,-50,0,0.723384246775822,-49,0
17,1,1.5,51,4,47,1,0.849254952867341,-46,0
17,1,1.5,28,91,-63,0,0.688874777872115,-41,0
17,1,1.5,98,28,70,1,0.848108148988103,-22,0
17,1,1.5,73,49,24,1,1.02107992264064,-1,0
17,1,1.5,49,97,-48,0,0.750665138260956,-47,0
17,1,1.5,36,67,-31,0,0.9065242072611,-17,0
17,1,1.5,68,26,42,1,1.07223691462787,-24,0
17,1,1.5,8,68,-60,0,0.999901029987086,-18,0
17,1,1.5,83,13,70,1,1.1381650061885,-37,0
17,1,1.5,51,2,49,1,1.11122402025285,-48,0
17,1,1.5,49,99,-50,NaN,NaN,0,0
17,1,1.5,21,81,-60,0,1.3087049156602,-31,0
17,1,1.5,51,0,51,1,0.651003987259173,-50,0
18,1,10,0,68,-68,0,3.86626773776152,-18,0
18,1,10,80,45,35,1,4.69441197725246,-5,0
18,1,10,53,40,13,1,4.40242254874101,-10,0
18,1,10,85,15,70,0,4.22566653360263,35,0
18,1,10,100,0,100,0,5.72774505902635,50,0
18,1,10,98,38,60,1,5.32134783140282,-12,0
18,1,10,48,100,-52,1,6.0523919844054,50,0
18,1,10,48,80,-32,1,5.32923025909986,30,0
18,1,10,0,68,-68,0,4.1156391690929,-18,0
18,1,10,3,100,-97,0,5.32773087114401,-50,0
18,1,10,75,0,75,0,5.25077758400585,50,0
18,1,10,50,43,7,1,6.21588232532304,-7,0
18,1,10,5,83,-78,0,5.87064968171399,-33,0
18,1,10,3,100,-97,0,6.67481759988368,-50,0
18,1,10,30,100,-70,1,6.67080061668094,50,0
18,1,10,50,43,7,1,7.21876850375702,-7,0
18,1,10,50,100,-50,1,7.5831870947186,50,0
18,1,10,5,83,-78,0,7.85426599295533,-33,0
18,1,10,53,23,30,0,7.52249191845112,27,0
18,1,10,85,15,70,0,8.00425852167245,35,0
18,1,1.5,48,60,-12,1,0.729136679419753,10,0
18,1,1.5,100,15,85,0,0.964956565705506,35,0
18,1,1.5,48,60,-12,1,0.686772252982337,10,0
18,1,1.5,53,0,53,0,0.643904609361925,50,0
18,1,1.5,48,80,-32,1,0.627067210094538,30,0
18,1,1.5,80,45,35,1,0.618933928482875,-5,0
18,1,1.5,100,15,85,0,0.698809618439554,35,0
18,1,1.5,100,0,100,0,0.559314314781659,50,0
18,1,1.5,50,100,-50,1,0.593169329673401,50,0
18,1,1.5,98,38,60,NaN,NaN,0,0
18,1,1.5,28,85,-57,0,1.3508930492535,-35,0
18,1,1.5,53,40,13,1,0.840556268063665,-10,0
18,1,1.5,25,55,-30,1,0.775044455138413,5,0
18,1,1.5,25,55,-30,0,0.62415114653777,-5,0
18,1,1.5,30,100,-70,1,0.879335989044193,50,0
18,1,1.5,53,0,53,0,0.892448615206376,50,0
18,1,1.5,48,100,-52,1,0.760817627051438,50,0
18,1,1.5,53,23,30,1,0.802688496147312,-27,0
18,1,1.5,75,0,75,0,0.562505985588359,50,0
18,1,1.5,28,85,-57,1,0.56435886323743,35,0
18,1,10,55,16,39,0,7.55134857098528,34,0
18,1,10,42,60,-18,1,7.46233225944161,10,0
18,1,10,94,15,79,0,6.49007229509152,35,0
18,1,10,40,86,-46,1,6.96478148114329,36,0
18,1,10,97,39,58,1,7.79532830343669,-11,0
18,1,10,32,94,-62,1,6.48956334238392,44,0
18,1,10,36,68,-32,1,6.61230969466487,18,0
18,1,10,71,44,27,1,8.0735720845405,-6,0
18,1,10,59,18,41,0,6.25179548942106,32,0
18,1,10,71,47,24,1,7.63121580858569,-3,0
18,1,10,94,49,45,1,5.80085041012353,-1,0
18,1,10,11,80,-69,0,3.90245862219672,-30,0
18,1,10,89,18,71,0,5.91190171744893,32,0
18,1,10,34,78,-44,0,7.20072724719284,-28,0
18,1,10,20,93,-73,0,6.74122536276991,-43,0
18,1,10,34,79,-45,0,6.21990383657612,-29,0
18,1,10,56,44,12,1,6.52787878740855,-6,0
18,1,10,2,51,-49,0,7.51188269964405,-1,0
18,1,10,100,7,93,NaN,NaN,0,0
18,1,10,20,79,-59,0,6.50944419432562,-29,0
18,1,1.5,68,16,52,1,1.20663091747701,-34,0
18,1,1.5,95,21,74,0,1.16497347042241,29,0
18,1,1.5,43,100,-57,1,1.06070457676105,50,0
18,1,1.5,88,11,77,0,0.673102374923474,39,0
18,1,1.5,44,95,-51,1,0.692218892185338,45,0
18,1,1.5,17,65,-48,0,0.646667926735972,-15,0
18,1,1.5,38,57,-19,1,0.98717630588726,7,0
18,1,1.5,83,15,68,0,1.01755226979367,35,0
18,1,1.5,73,14,59,0,0.839285093774379,36,0
18,1,1.5,21,79,-58,0,0.972372906227974,-29,0
18,1,1.5,20,62,-42,0,0.69885308771336,-12,0
18,1,1.5,14,70,-56,0,0.58128048422077,-20,0
18,1,1.5,100,6,94,0,0.788462875541882,44,0
18,1,1.5,23,95,-72,0,0.755606748265564,-45,0
18,1,1.5,19,92,-73,0,0.516064503826783,-42,0
18,1,1.5,38,72,-34,1,0.885933054563793,22,0
18,1,1.5,74,26,48,1,1.06503067477752,-24,0
18,1,1.5,94,3,91,0,0.65273370117211,47,0
18,1,1.5,43,94,-51,1,0.897180426411069,44,0
18,1,1.5,92,36,56,1,0.788294130248687,-14,0
18,1,10,40,100,-60,1,7.37550178808669,50,0
18,1,10,60,32,28,1,8.02788678696015,-18,0
18,1,10,43,98,-55,1,7.01474759624762,48,0
18,1,10,99,7,92,0,6.9219192711862,43,0
18,1,10,37,93,-56,1,6.63314747429104,43,0
18,1,10,4,64,-60,0,7.43512230739361,-14,0
18,1,10,0,50,-50,0,6.55674479791196,0,0
18,1,10,82,4,78,0,7.48206761007168,46,0
18,1,10,3,71,-68,0,8.02644596176833,-21,0
18,1,10,31,91,-60,1,6.99661638243924,41,0
18,1,10,31,91,-60,1,7.98375974198279,41,0
18,1,10,59,49,10,1,6.74002029799522,-1,0
18,1,10,53,23,30,1,6.50657824117661,-27,0
18,1,10,43,90,-47,1,7.24996162957177,40,0
18,1,10,88,32,56,1,9.32299755058921,-18,0
18,1,10,44,57,-13,1,7.8968015796454,7,0
18,1,10,99,48,51,1,8.15970161390578,-2,0
18,1,10,65,29,36,1,8.45249280896678,-21,0
18,1,10,9,87,-78,0,8.04518212292169,-37,0
18,1,10,100,28,72,1,7.50208369973552,-22,0
18,1,1.5,61,45,16,1,0.688049464668438,-5,0
18,1,1.5,47,96,-49,1,0.825887200524448,46,0
18,1,1.5,29,58,-29,1,0.694997906794015,8,0
18,1,1.5,12,67,-55,0,0.632809379963874,-17,0
18,1,1.5,41,87,-46,1,0.652657328078931,37,0
18,1,1.5,19,69,-50,1,0.943755938424147,19,0
18,1,1.5,40,95,-55,1,0.591509346908424,45,0
18,1,1.5,74,1,73,0,0.725372059481742,49,0
18,1,1.5,35,51,-16,1,0.781835019286518,1,0
18,1,1.5,47,67,-20,1,0.866946341371658,17,0
18,1,1.5,84,28,56,1,1.16198525995424,-22,0
18,1,1.5,62,18,44,1,0.7356830307981,-32,0
18,1,1.5,48,59,-11,1,0.654162451566663,9,0
18,1,1.5,14,98,-84,0,0.599910689023091,-48,0
18,1,1.5,47,89,-42,1,0.643758202444587,39,0
18,1,1.5,80,47,33,1,0.758917355818994,-3,0
18,1,1.5,80,49,31,1,0.572709793072136,-1,0
18,1,1.5,97,17,80,0,0.761891076534084,33,0
18,1,1.5,95,14,81,0,0.735617525020643,36,0
18,1,1.5,91,44,47,0,0.590154856519803,6,0
18,1,10,70,25,45,1,7.61845938894476,-25,0
18,1,10,47,66,-19,1,8.77136345317194,16,0
18,1,10,91,39,52,1,9.83801784379102,-11,0
18,1,10,36,70,-34,1,7.26165154274349,20,0
18,1,10,98,38,60,NaN,NaN,0,0
18,1,10,6,69,-63,0,6.40790752542671,-19,0
18,1,10,42,69,-27,1,5.84989944436893,19,0
18,1,10,6,79,-73,0,6.75412275567214,-29,0
18,1,10,55,41,14,1,6.58933467591123,-9,0
18,1,10,64,49,15,1,7.51995500352859,-1,0
18,1,10,41,86,-45,1,7.45026832942676,36,0
18,1,10,66,50,16,1,7.17730334784937,0,0
18,1,10,17,50,-33,0,8.29975356572322,0,0
18,1,10,59,39,20,1,8.53713411956414,-11,0
18,1,10,45,80,-35,1,8.91646840580142,30,0
18,1,10,48,97,-49,1,8.38506925375259,47,0
18,1,10,70,31,39,1,7.49044359511026,-19,0
18,1,10,37,98,-61,1,9.28818319304992,48,0
18,1,10,19,90,-71,0,8.38918947647471,-40,0
18,1,10,96,9,87,0,9.89459611791244,41,0
18,1,1.5,52,24,28,1,0.848889387572854,-26,0
18,1,1.5,46,80,-34,1,0.633337652347109,30,0
18,1,1.5,42,94,-52,1,0.659142399854318,44,0
18,1,1.5,100,14,86,0,0.835576017903804,36,0
18,1,1.5,74,1,73,0,0.716700241908256,49,0
18,1,1.5,15,85,-70,0,0.69046865031487,-35,0
18,1,1.5,65,13,52,0,0.945605797372991,37,0
18,1,1.5,59,36,23,1,0.934632221556967,-14,0
18,1,1.5,98,13,85,0,0.779665781945369,37,0
18,1,1.5,32,67,-35,1,0.648182106320746,17,0
18,1,1.5,4,77,-73,0,0.533965089001867,-27,0
18,1,1.5,72,50,22,1,0.699076169592445,0,0
18,1,1.5,35,51,-16,1,0.889496930998575,1,0
18,1,1.5,38,79,-41,1,0.664588435323822,29,0
18,1,1.5,88,15,73,1,0.640402918139443,-35,0
18,1,1.5,73,27,46,1,0.817570080122096,-23,0
18,1,1.5,35,61,-26,1,0.915266057854751,11,0
18,1,1.5,49,78,-29,1,0.649010437417019,28,0
18,1,1.5,12,59,-47,0,0.745459390454926,-9,0
18,1,1.5,15,71,-56,0,1.02257146117699,-21,0
19,1,10,25,55,-30,0,2.97085886311652,-5,0
19,1,10,75,0,75,0,2.89124745647314,50,0
19,1,10,100,0,100,0,2.63908982875182,50,0
19,1,10,48,60,-12,1,2.74100502334113,10,0
19,1,10,98,38,60,1,2.60748718604555,-12,0
19,1,10,3,100,-97,0,1.8713592455897,-50,0
19,1,10,53,0,53,0,2.50888412736094,50,0
19,1,10,50,43,7,1,1.79283035073604,-7,0
19,1,10,48,100,-52,0,1.80166402125906,-50,0
19,1,10,80,45,35,1,2.82228276157366,-5,0
19,1,10,50,100,-50,0,3.38954882461803,-50,0
19,1,10,48,60,-12,0,4.0771237265235,-10,0
19,1,10,30,100,-70,0,3.44120057580585,-50,0
19,1,10,75,0,75,0,2.99087567133211,50,0
19,1,10,5,83,-78,0,3.23068191802304,-33,0
19,1,10,0,68,-68,0,2.53304563353231,-18,0
19,1,10,53,0,53,0,3.4956253201035,50,0
19,1,10,48,80,-32,1,3.85197787722791,30,0
19,1,10,48,80,-32,0,2.4728041241251,-30,0
19,1,10,53,40,13,1,2.87807830510246,-10,0
19,1,1.5,53,40,13,0,1.30278577636454,10,0
19,1,1.5,80,45,35,NaN,NaN,0,0
19,1,1.5,30,100,-70,0,1.02301775870183,-50,0
19,1,1.5,53,23,30,1,0.958715773535005,-27,0
19,1,1.5,100,15,85,0,0.897170178533997,35,0
19,1,1.5,0,68,-68,0,0.686291387857636,-18,0
19,1,1.5,85,15,70,0,0.938092505144596,35,0
19,1,1.5,25,55,-30,0,0.851807923481829,-5,0
19,1,1.5,98,38,60,1,0.68094101447241,-12,0
19,1,1.5,100,15,85,0,0.717468089644171,35,0
19,1,1.5,28,85,-57,0,0.639933861924874,-35,0
19,1,1.5,28,85,-57,0,0.645787455376194,-35,0
19,1,1.5,53,23,30,1,0.971619579713661,-27,0
19,1,1.5,3,100,-97,0,0.836707397198552,-50,0
19,1,1.5,5,83,-78,0,0.83446449073017,-33,0
19,1,1.5,50,100,-50,0,0.744288481437252,-50,0
19,1,1.5,50,43,7,1,1.2020644842105,-7,0
19,1,1.5,48,100,-52,0,0.657093454832648,-50,0
19,1,1.5,100,0,100,0,0.773566410451167,50,0
19,1,1.5,85,15,70,0,1.10273361294094,35,0
19,1,10,49,77,-28,0,2.65842048267041,-27,0
19,1,10,37,62,-25,1,1.52628551947237,12,0
19,1,10,90,12,78,1,1.55318862410059,-38,0
19,1,10,92,27,65,0,2.33454448672092,23,0
19,1,10,13,98,-85,0,2.15256417237651,-48,0
19,1,10,74,42,32,1,3.47325904472382,-8,0
19,1,10,100,9,91,0,3.71693317305289,41,0
19,1,10,41,54,-13,1,1.79114469935848,4,0
19,1,10,89,13,76,0,4.31509308413479,37,0
19,1,10,17,59,-42,0,3.63774921668846,-9,0
19,1,10,56,7,49,0,2.80869853666081,43,0
19,1,10,53,40,13,0,3.63917857902015,10,0
19,1,10,46,99,-53,0,5.03607914188979,-49,0
19,1,10,1,63,-62,0,3.19987712212605,-13,0
19,1,10,99,6,93,0,3.99826277283864,44,0
19,1,10,48,95,-47,0,4.55699250894759,-45,0
19,1,10,74,3,71,0,3.29234765794172,47,0
19,1,10,48,64,-16,0,2.30269883732581,-14,0
19,1,10,98,6,92,0,2.60864607136682,44,0
19,1,10,13,65,-52,0,1.99723188110329,-15,0
19,1,1.5,48,81,-33,1,1.0089550672019,31,0
19,1,1.5,41,56,-15,0,0.775349566376462,-6,0
19,1,1.5,68,35,33,1,0.711126973454157,-15,0
19,1,1.5,32,85,-53,0,0.738273990389644,-35,0
19,1,1.5,92,10,82,1,0.740135029203884,-40,0
19,1,1.5,96,6,90,0,0.860658498819248,44,0
19,1,1.5,93,17,76,0,0.905011596896657,33,0
19,1,1.5,79,14,65,0,0.731460746917946,36,0
19,1,1.5,75,0,75,0,0.629279905264411,50,0
19,1,1.5,34,82,-48,1,1.07513771284175,32,0
19,1,1.5,50,67,-17,1,0.964769206026176,17,0
19,1,1.5,40,96,-56,0,0.644543442245777,-46,0
19,1,1.5,99,2,97,0,0.681095874635503,48,0
19,1,1.5,29,64,-35,0,0.562210360672907,-14,0
19,1,1.5,91,42,49,1,0.736745312278799,-8,0
19,1,1.5,99,6,93,0,0.743797336239368,44,0
19,1,1.5,0,99,-99,0,1.27233417031857,-49,0
19,1,1.5,97,7,90,0,1.2586249705364,43,0
19,1,1.5,4,67,-63,0,0.644864029953169,-17,0
19,1,1.5,27,93,-66,0,0.704034196822249,-43,0
19,1,10,15,77,-62,0,3.21365333741778,-27,0
19,1,10,98,4,94,0,4.18673272423075,46,0
19,1,10,17,59,-42,0,4.66346204134425,-9,0
19,1,10,72,11,61,0,4.00131499724012,39,0
19,1,10,19,91,-72,0,4.2134758368793,-41,0
19,1,10,96,8,88,0,3.22484281441211,42,0
19,1,10,93,14,79,0,2.95647437642401,36,0
19,1,10,52,50,2,1,3.81894526844917,0,0
19,1,10,100,7,93,0,2.38242948327752,43,0
19,1,10,96,12,84,0,1.69171300295602,38,0
19,1,10,1,56,-55,0,1.56992076673305,-6,0
19,1,10,98,11,87,0,2.52740697270747,39,0
19,1,10,5,79,-74,0,1.53536159294163,-29,0
19,1,10,94,20,74,0,4.11814265206522,30,0
19,1,10,25,87,-62,0,2.02951373505493,-37,0
19,1,10,94,7,87,0,1.85351229089974,43,0
19,1,10,89,13,76,0,1.53150427681067,37,0
19,1,10,5,67,-62,0,3.22635700268256,-17,0
19,1,10,72,31,41,1,3.68536132125701,-19,0
19,1,10,35,80,-45,1,4.25350220838845,30,0
19,1,1.5,64,45,19,1,1.27567256905786,-5,0
19,1,1.5,84,35,49,1,1.32529845950194,-15,0
19,1,1.5,95,11,84,0,1.06094008470791,39,0
19,1,1.5,64,30,34,1,0.687294809269588,-20,0
19,1,1.5,21,54,-33,0,1.12845277690212,-4,0
19,1,1.5,48,60,-12,0,0.824050522041944,-10,0
19,1,1.5,48,80,-32,0,0.891879877612155,-30,0
19,1,1.5,32,56,-24,0,0.652984679605652,-6,0
19,1,1.5,87,44,43,1,0.671452282434984,-6,0
19,1,1.5,33,90,-57,0,0.727932169029373,-40,0
19,1,1.5,6,64,-58,0,0.796358324880202,-14,0
19,1,1.5,24,53,-29,0,0.856759222526307,-3,0
19,1,1.5,10,50,-40,0,0.873851498052318,0,0
19,1,1.5,75,43,32,1,0.818243114956203,-7,0
19,1,1.5,79,14,65,0,0.95609975368825,36,0
19,1,1.5,100,2,98,0,0.681059650036332,48,0
19,1,1.5,100,1,99,0,0.569593839720255,49,0
19,1,1.5,37,58,-21,0,0.774072045489447,-8,0
19,1,1.5,94,48,46,1,1.00312834032957,-2,0
19,1,1.5,56,42,14,0,0.998881307879856,8,0
19,1,10,93,10,83,0,1.08670241631626,40,0
19,1,10,30,70,-40,0,1.13218481629156,-20,0
19,1,10,20,68,-48,0,3.91038974247567,-18,0
19,1,10,91,11,80,0,3.6598468262855,39,0
19,1,10,82,27,55,0,4.11599664640198,23,0
19,1,10,100,38,62,1,2.53672786409697,-12,0
19,1,10,46,77,-31,0,4.96530321700084,-27,0
19,1,10,94,11,83,0,3.79306128255848,39,0
19,1,10,37,62,-25,0,4.41126396281652,-12,0
19,1,10,4,75,-71,0,4.48448414257473,-25,0
19,1,10,27,70,-43,0,3.9450687593162,-20,0
19,1,10,71,12,59,0,3.71722327172392,38,0
19,1,10,37,62,-25,0,4.86605837915704,-12,0
19,1,10,17,51,-34,0,3.85724885836498,-1,0
19,1,10,9,74,-65,0,4.82474754371469,-24,0
19,1,10,96,5,91,0,5.00916366052297,45,0
19,1,10,97,10,87,0,4.61099251981614,40,0
19,1,10,28,91,-63,0,3.77150432511189,-41,0
19,1,10,48,78,-30,1,3.28634976983631,28,0
19,1,10,90,9,81,0,4.54935938203562,41,0
19,1,1.5,39,89,-50,0,0.896285694558173,-39,0
19,1,1.5,74,3,71,0,1.03861365638659,47,0
19,1,1.5,99,2,97,0,0.9436315483199,48,0
19,1,1.5,97,5,92,0,0.852685162539274,45,0
19,1,1.5,84,37,47,1,0.972367919570388,-13,0
19,1,1.5,23,80,-57,0,0.560215894583962,-30,0
19,1,1.5,23,74,-51,0,0.96459261110067,-24,0
19,1,1.5,24,69,-45,0,0.800327031656707,-19,0
19,1,1.5,58,11,47,0,0.890713747370683,39,0
19,1,1.5,21,66,-45,0,0.993792959099665,-16,0
19,1,1.5,93,10,83,0,0.714148105076674,40,0
19,1,1.5,19,53,-34,0,0.695898151714573,-3,0
19,1,1.5,56,42,14,0,0.86303513443454,8,0
19,1,1.5,44,87,-43,0,0.744116716459757,-37,0
19,1,1.5,97,8,89,0,0.685268042914686,42,0
19,1,1.5,13,82,-69,0,1.08434751545974,-32,0
19,1,1.5,88,44,44,1,0.794055647822461,-6,0
19,1,1.5,25,73,-48,0,0.781117126402023,-23,0
19,1,1.5,75,7,68,0,0.647579667447644,43,0
19,1,1.5,97,48,49,1,0.688055223994525,-2,0
20,1,10,80,45,35,1,0.926759636542556,-5,0
20,1,10,3,100,-97,0,1.83841568638309,-50,0
20,1,10,48,100,-52,0,2.08448727947507,-50,0
20,1,10,75,0,75,1,2.1132604790655,-50,0
20,1,10,75,0,75,1,1.46064110844418,-50,0
20,1,10,48,60,-12,0,3.13091091530077,-10,0
20,1,10,53,0,53,1,0.749954006274493,-50,0
20,1,10,100,0,100,1,1.08500800809452,-50,0
20,1,10,30,100,-70,1,4.29451750890257,50,0
20,1,10,85,15,70,1,3.05055267815987,-35,0
20,1,10,100,0,100,1,2.91232473728087,-50,0
20,1,10,28,85,-57,1,2.69213018702976,35,0
20,1,10,5,83,-78,0,2.97672966068603,-33,0
20,1,10,25,55,-30,1,2.93783893038017,5,0
20,1,10,100,15,85,1,2.24435217379141,-35,0
20,1,10,98,38,60,1,3.19150229396655,-12,0
20,1,10,50,43,7,1,3.33594969675323,-7,0
20,1,10,53,40,13,1,3.01014504273735,-10,0
20,1,10,80,45,35,1,3.27398087768051,-5,0
20,1,10,48,80,-32,0,4.23908753195974,-30,0
20,1,1.5,48,100,-52,1,0.777498286319315,50,0
20,1,1.5,85,15,70,0,1.03461657110711,35,0
20,1,1.5,53,23,30,1,1.20969821230028,-27,0
20,1,1.5,30,100,-70,0,0.682076954979493,-50,0
20,1,1.5,53,0,53,1,0.638560041412347,-50,0
20,1,1.5,25,55,-30,0,0.701013968249754,-5,0
20,1,1.5,0,68,-68,0,1.4736363817392,-18,0
20,1,1.5,3,100,-97,0,1.10321086947806,-50,0
20,1,1.5,98,38,60,0,0.978871742017873,12,0
20,1,1.5,28,85,-57,0,1.49196270863104,-35,0
20,1,1.5,5,83,-78,0,0.712136127864142,-33,0
20,1,1.5,0,68,-68,0,0.820017212163293,-18,0
20,1,1.5,53,23,30,1,0.747128185621477,-27,0
20,1,1.5,50,43,7,1,0.885608793081701,-7,0
20,1,1.5,100,15,85,1,1.09005832104594,-35,0
20,1,1.5,48,60,-12,NaN,NaN,0,0
20,1,1.5,50,100,-50,1,0.833681433065067,50,0
20,1,1.5,53,40,13,1,0.487464217081651,-10,0
20,1,1.5,50,100,-50,0,0.835306710107034,-50,0
20,1,1.5,48,80,-32,0,0.865123178173235,-30,0
20,1,10,51,3,48,1,1.27922770908481,-47,0
20,1,10,1,66,-65,0,1.79620466963752,-16,0
20,1,10,76,5,71,1,2.38833046801119,-45,0
20,1,10,49,99,-50,0,4.41613858389064,-49,0
20,1,10,49,96,-47,0,3.02948475280755,-46,0
20,1,10,51,14,37,1,2.4265519488381,-36,0
20,1,10,49,98,-49,0,2.98450798787053,-48,0
20,1,10,30,81,-51,0,2.23164548981003,-31,0
20,1,10,50,61,-11,1,2.80563876290034,11,0
20,1,10,0,83,-83,0,2.0281332733648,-33,0
20,1,10,98,23,75,1,2.54141260789584,-27,0
20,1,10,30,63,-33,0,2.37462790940845,-13,0
20,1,10,26,96,-70,0,2.38192656251704,-46,0
20,1,10,100,8,92,1,2.18923855835237,-42,0
20,1,10,51,0,51,1,3.64910592801971,-50,0
20,1,10,51,2,49,1,4.06205398858219,-48,0
20,1,10,50,30,20,1,2.85009147862911,-20,0
20,1,10,60,35,25,1,2.25461581039053,-15,0
20,1,10,49,98,-49,0,5.2586382503232,-48,0
20,1,10,49,97,-48,0,3.14167445137718,-47,0
20,1,1.5,67,15,52,1,0.784086333527739,-35,0
20,1,1.5,45,81,-36,1,0.719236149418066,31,0
20,1,1.5,98,0,98,1,0.777008046736228,-50,0
20,1,1.5,28,80,-52,NaN,NaN,0,0
20,1,1.5,49,100,-51,1,0.587390983015212,50,0
20,1,1.5,51,1,50,0,0.579237127480155,49,0
20,1,1.5,49,98,-49,0,0.962453545918834,-48,0
20,1,1.5,93,43,50,1,0.674802753475888,-7,0
20,1,1.5,49,99,-50,0,0.982692531679277,-49,0
20,1,1.5,51,4,47,0,0.717746714624809,46,0
20,1,1.5,51,2,49,1,0.958158214001742,-48,0
20,1,1.5,26,74,-48,0,1.21460573995319,-24,0
20,1,1.5,49,98,-49,NaN,NaN,0,0
20,1,1.5,49,99,-50,0,1.30412034842811,-49,0
20,1,1.5,49,100,-51,0,0.818417292339291,-50,0
20,1,1.5,62,15,47,1,0.912162028453167,-35,0
20,1,1.5,17,89,-72,0,0.666661878422019,-39,0
20,1,1.5,27,82,-55,0,0.845752375320444,-32,0
20,1,1.5,6,67,-61,0,0.730924318402685,-17,0
20,1,1.5,49,88,-39,0,0.836001618679802,-38,0
20,1,10,49,100,-51,0,1.70160805168598,-50,0
20,1,10,51,4,47,1,3.45160639139249,-46,0
20,1,10,95,38,57,1,2.40657347832348,-12,0
20,1,10,47,90,-43,0,2.21919479299868,-40,0
20,1,10,65,9,56,1,2.36719069720493,-41,0
20,1,10,51,0,51,1,2.80510716689969,-50,0
20,1,10,98,13,85,1,1.52156605530035,-37,0
20,1,10,25,64,-39,0,4.42234597093375,-14,0
20,1,10,49,99,-50,1,3.17767143990568,49,0
20,1,10,57,22,35,1,4.25537743260065,-28,0
20,1,10,51,2,49,1,3.024039893593,-48,0
20,1,10,64,1,63,1,2.8757991714665,-49,0
20,1,10,49,100,-51,0,2.3502735072434,-50,0
20,1,10,67,2,65,1,2.08562503377834,-48,0
20,1,10,34,50,-16,1,4.12765794624283,0,0
20,1,10,51,1,50,1,4.98363678624628,-49,0
20,1,10,51,3,48,1,2.46088773759584,-47,0
20,1,10,2,82,-80,0,2.71148438693854,-32,0
20,1,10,61,27,34,1,2.55133150705478,-23,0
20,1,10,60,3,57,1,1.54185605737075,-47,0
20,1,1.5,22,53,-31,0,1.17348629114531,-3,0
20,1,1.5,60,2,58,1,0.459787415376923,-48,0
20,1,1.5,49,96,-47,1,1.15836070951445,46,0
20,1,1.5,51,0,51,1,0.884637068193115,-50,0
20,1,1.5,51,2,49,1,0.997745664109971,-48,0
20,1,1.5,62,42,20,1,1.35476052766717,-8,0
20,1,1.5,49,98,-49,1,1.08098526629146,48,0
20,1,1.5,70,17,53,1,0.978052764192398,-33,0
20,1,1.5,2,69,-67,1,1.19177397846397,19,0
20,1,1.5,0,65,-65,1,0.796056752520599,15,0
20,1,1.5,25,70,-45,0,1.4945455225934,-20,0
20,1,1.5,51,3,48,0,0.918725020315833,47,0
20,1,1.5,63,5,58,1,0.845780449386439,-45,0
20,1,1.5,49,100,-51,NaN,NaN,0,0
20,1,1.5,49,98,-49,1,0.39345232454798,48,0
20,1,1.5,50,16,34,1,0.742795723488598,-34,0
20,1,1.5,51,38,13,1,0.613142145373786,-12,0
20,1,1.5,46,81,-35,1,0.640961732375217,31,0
20,1,1.5,81,4,77,1,0.731424821622568,-46,0
20,1,1.5,49,99,-50,NaN,NaN,0,0
20,1,10,65,28,37,1,2.01100899944322,-22,0
20,1,10,51,0,51,1,1.23038396812262,-50,0
20,1,10,48,82,-34,0,3.66184793098728,-32,0
20,1,10,50,65,-15,0,1.86205978452017,-15,0
20,1,10,49,96,-47,0,1.9434960053768,-46,0
20,1,10,51,1,50,1,2.3016072668197,-49,0
20,1,10,51,4,47,1,1.58540255436128,-46,0
20,1,10,33,71,-38,0,1.54957431209368,-21,0
20,1,10,100,0,100,1,1.43889216061689,-50,0
20,1,10,98,0,98,1,2.30106963338585,-50,0
20,1,10,42,88,-46,0,3.90561020584209,-38,0
20,1,10,0,71,-71,0,3.10441926175008,-21,0
20,1,10,49,100,-51,0,2.43147638130358,-50,0
20,1,10,91,48,43,1,1.68003932124338,-2,0
20,1,10,14,89,-75,0,2.64091101793565,-39,0
20,1,10,49,98,-49,0,2.21073453772442,-48,0
20,1,10,51,1,50,1,3.66588486075671,-49,0
20,1,10,24,81,-57,0,1.40081195573111,-31,0
20,1,10,80,0,80,1,1.64018531845613,-50,0
20,1,10,51,3,48,1,2.76619228686104,-47,0
20,1,1.5,49,96,-47,0,0.783844232453703,-46,0
20,1,1.5,70,7,63,1,0.538938467730986,-43,0
20,1,1.5,34,55,-21,0,0.840806208096183,-5,0
20,1,1.5,51,4,47,1,0.801825821903549,-46,0
20,1,1.5,48,79,-31,0,0.916278048600361,-29,0
20,1,1.5,49,98,-49,0,1.13000892276614,-48,0
20,1,1.5,52,32,20,1,1.11966106397267,-18,0
20,1,1.5,51,2,49,1,0.933346476265797,-48,0
20,1,1.5,36,65,-29,NaN,NaN,0,0
20,1,1.5,79,1,78,1,0.842241909733275,-49,0
20,1,1.5,51,1,50,1,0.72058853447561,-49,0
20,1,1.5,15,82,-67,1,1.04635545453311,32,0
20,1,1.5,36,90,-54,0,1.15144513154701,-40,0
20,1,1.5,78,9,69,1,0.995779875829612,-41,0
20,1,1.5,95,4,91,1,0.814695516586653,-46,0
20,1,1.5,51,0,51,NaN,NaN,0,0
20,1,1.5,65,36,29,1,0.968331590973321,-14,0
20,1,1.5,49,100,-51,0,0.860014603991658,-50,0
20,1,1.5,51,2,49,1,0.748534303835186,-48,0
20,1,1.5,20,69,-49,0,1.00019052272182,-19,0
21,1,10,5,83,-78,0,1.21567376285748,-33,0
21,1,10,100,15,85,0,4.69112465346916,35,0
21,1,10,0,68,-68,0,0.766524346647202,-18,0
21,1,10,48,100,-52,0,5.54076147167143,-50,0
21,1,10,50,100,-50,0,6.65364306009724,-50,0
21,1,10,50,43,7,1,6.70630155328399,-7,0
21,1,10,53,23,30,1,7.13292077779988,-27,0
21,1,10,98,38,60,1,7.12678825493276,-12,0
21,1,10,48,80,-32,0,4.8399066314887,-30,0
21,1,10,50,43,7,1,5.63783162604159,-7,0
21,1,10,75,0,75,0,5.0754939197941,50,0
21,1,10,53,0,53,0,1.49593413320326,50,0
21,1,10,25,55,-30,0,6.02885716257151,-5,0
21,1,10,80,45,35,1,5.61904373737343,-5,0
21,1,10,30,100,-70,0,6.14531381712368,-50,0
21,1,10,30,100,-70,0,7.33077984357806,-50,0
21,1,10,3,100,-97,0,5.71655764309253,-50,0
21,1,10,5,83,-78,0,9.98214644679319,-33,0
21,1,10,100,15,85,NaN,NaN,0,0
21,1,10,98,38,60,1,2.93964774634878,-12,0
21,1,1.5,75,0,75,1,1.19321451100404,-50,0
21,1,1.5,80,45,35,1,0.450209632155747,-5,0
21,1,1.5,25,55,-30,0,0.624823070393177,-5,0
21,1,1.5,48,80,-32,0,0.632616793034686,-30,0
21,1,1.5,53,40,13,1,0.879825234816963,-10,0
21,1,1.5,85,15,70,1,0.565662261546095,-35,0
21,1,1.5,28,85,-57,0,0.678826703719096,-35,0
21,1,1.5,85,15,70,1,0.844627300582943,-35,0
21,1,1.5,48,60,-12,0,0.811135243129684,-10,0
21,1,1.5,100,0,100,1,0.93900777842282,-50,0
21,1,1.5,53,0,53,1,0.573334028034878,-50,0
21,1,1.5,53,40,13,1,0.606615077194874,-10,0
21,1,1.5,28,85,-57,0,0.950419131091621,-35,0
21,1,1.5,53,23,30,1,0.728214417424169,-27,0
21,1,1.5,50,100,-50,0,0.723264023996308,-50,0
21,1,1.5,100,0,100,1,0.974505773087003,-50,0
21,1,1.5,48,100,-52,0,0.815565813551075,-50,0
21,1,1.5,48,60,-12,0,1.33466704500461,-10,0
21,1,1.5,3,100,-97,0,0.760316959607735,-50,0
21,1,1.5,0,68,-68,0,0.657447246812808,-18,0
21,1,10,72,21,51,1,0.980201185782789,-29,0
21,1,10,53,13,40,1,9.3770588828811,-37,0
21,1,10,49,98,-49,0,3.67955813876688,-48,0
21,1,10,51,0,51,0,7.69905240712978,50,0
21,1,10,42,94,-52,0,5.70079058417105,-44,0
21,1,10,83,15,68,1,6.15101043730465,-35,0
21,1,10,35,79,-44,0,5.28709659872402,-29,0
21,1,10,45,92,-47,0,6.27350814760939,-42,0
21,1,10,49,96,-47,0,4.70829451001191,-46,0
21,1,10,51,1,50,1,5.38150575437248,-49,0
21,1,10,51,1,50,1,6.13121671225235,-49,0
21,1,10,51,3,48,1,8.89206582894622,-47,0
21,1,10,49,96,-47,0,5.96325320491087,-46,0
21,1,10,85,43,42,1,5.68286212413295,-7,0
21,1,10,5,73,-68,0,6.6937397676993,-23,0
21,1,10,36,71,-35,0,1.03104331716895,-21,0
21,1,10,51,0,51,1,5.88922582032319,-50,0
21,1,10,96,31,65,1,4.04206525539121,-19,0
21,1,10,93,13,80,1,5.31886798769119,-37,0
21,1,10,0,65,-65,0,5.49590636101493,-15,0
21,1,1.5,77,40,37,1,1.15127034880788,-10,0
21,1,1.5,9,83,-74,0,0.840299366525869,-33,0
21,1,1.5,49,97,-48,0,0.90873548413947,-47,0
21,1,1.5,80,21,59,0,0.910459473219817,29,0
21,1,1.5,49,96,-47,0,1.39224091450887,-46,0
21,1,1.5,74,21,53,1,0.798539044175413,-29,0
21,1,1.5,14,55,-41,0,0.71628958105066,-5,0
21,1,1.5,51,2,49,1,1.2853593272921,-48,0
21,1,1.5,51,3,48,NaN,NaN,0,0
21,1,1.5,97,20,77,1,1.05226700829735,-30,0
21,1,1.5,51,3,48,1,0.647350847113557,-47,0
21,1,1.5,25,74,-49,0,0.66052150784526,-24,0
21,1,1.5,49,99,-50,0,0.929030316161516,-49,0
21,1,1.5,49,97,-48,0,0.426768089902907,-47,0
21,1,1.5,15,70,-55,0,0.608612561998598,-20,0
21,1,1.5,51,0,51,1,1.29447222910676,-50,0
21,1,1.5,49,58,-9,1,1.38485985043735,8,0
21,1,1.5,42,73,-31,0,0.703050093583443,-23,0
21,1,1.5,20,89,-69,0,0.936906147890113,-39,0
21,1,1.5,16,75,-59,0,0.488562125283352,-25,0
21,1,10,31,53,-22,0,1.30335148225276,-3,0
21,1,10,32,86,-54,0,0.876249866818398,-36,0
21,1,10,51,4,47,1,7.29108854962033,-46,0
21,1,10,49,96,-47,0,7.87557065557121,-46,0
21,1,10,49,97,-48,0,2.43659612569172,-47,0
21,1,10,23,98,-75,0,1.60042157625139,-48,0
21,1,10,10,51,-41,0,8.88977160429204,-1,0
21,1,10,51,0,51,1,7.24967356845082,-50,0
21,1,10,15,99,-84,0,6.73143236937176,-49,0
21,1,10,66,1,65,1,6.13007080741227,-49,0
21,1,10,23,87,-64,0,5.78276745718176,-37,0
21,1,10,4,64,-60,0,6.74699747614432,-14,0
21,1,10,49,97,-48,0,5.59290708489789,-47,0
21,1,10,92,36,56,1,7.72519479516268,-14,0
21,1,10,51,3,48,1,4.84348773504462,-47,0
21,1,10,51,1,50,1,5.64472788422063,-49,0
21,1,10,49,99,-50,0,9.62230636632376,-49,0
21,1,10,16,78,-62,0,4.43129073118325,-28,0
21,1,10,31,97,-66,0,8.30657124542995,-47,0
21,1,10,62,43,19,1,3.56866920519678,-7,0
21,1,1.5,96,48,48,1,0.95617340876197,-2,0
21,1,1.5,56,35,21,1,0.755234044514509,-15,0
21,1,1.5,51,0,51,1,0.745694598037517,-50,0
21,1,1.5,49,97,-48,0,0.672810703315918,-47,0
21,1,1.5,49,99,-50,0,1.03452027499952,-49,0
21,1,1.5,10,55,-45,NaN,NaN,0,0
21,1,1.5,50,22,28,0,1.07153094857858,28,0
21,1,1.5,56,10,46,1,1.07328572856568,-40,0
21,1,1.5,49,96,-47,0,0.80286758197326,-46,0
21,1,1.5,86,50,36,0,0.910642105576699,0,0
21,1,1.5,37,85,-48,0,0.949080330257857,-35,0
21,1,1.5,98,3,95,1,1.12286090457565,-47,0
21,1,1.5,51,3,48,0,0.866420925412967,47,0
21,1,1.5,33,78,-45,0,1.23557435047769,-28,0
21,1,1.5,51,0,51,1,0.829827740348264,-50,0
21,1,1.5,49,98,-49,0,0.728970002201095,-48,0
21,1,1.5,45,71,-26,0,0.640073928767379,-21,0
21,1,1.5,49,100,-51,0,0.842475861227285,-50,0
21,1,1.5,61,31,30,NaN,NaN,0,0
21,1,1.5,9,81,-72,0,0.902162228645466,-31,0
21,1,10,24,64,-40,0,1.04967815690179,-14,0
21,1,10,49,98,-49,0,3.00651382943761,-48,0
21,1,10,51,1,50,1,3.41687847229696,-49,0
21,1,10,51,3,48,1,4.80250835469269,-47,0
21,1,10,14,96,-82,0,4.62044291253915,-46,0
21,1,10,26,71,-45,0,5.67821148927032,-21,0
21,1,10,18,63,-45,0,3.1492121878,-13,0
21,1,10,51,2,49,1,2.36957276746762,-48,0
21,1,10,4,97,-93,0,2.17409456350651,-47,0
21,1,10,10,89,-79,0,5.91475601262209,-39,0
21,1,10,45,82,-37,0,4.03024969655962,-32,0
21,1,10,51,3,48,1,1.567721931915,-47,0
21,1,10,63,35,28,1,1.71243588738434,-15,0
21,1,10,19,55,-36,0,3.69979984136808,-5,0
21,1,10,49,97,-48,0,7.38593300420325,-47,0
21,1,10,84,34,50,0,4.89163958615609,16,0
21,1,10,49,100,-51,0,8.20210010345181,-50,0
21,1,10,51,0,51,1,3.76230206767286,-50,0
21,1,10,91,36,55,1,2.20643407494208,-14,0
21,1,10,22,78,-56,0,4.07757290994778,-28,0
21,1,1.5,49,96,-47,0,0.867630223303422,-46,0
21,1,1.5,17,60,-43,0,0.540011924324062,-10,0
21,1,1.5,69,31,38,1,0.849814361397875,-19,0
21,1,1.5,53,45,8,1,0.834315364514623,-5,0
21,1,1.5,39,86,-47,0,0.699345826385979,-36,0
21,1,1.5,51,4,47,1,0.841788197576534,-46,0
21,1,1.5,49,99,-50,0,0.603532967495994,-49,0
21,1,1.5,51,3,48,1,0.670063973040669,-47,0
21,1,1.5,78,22,56,1,0.766494763221999,-28,0
21,1,1.5,85,13,72,1,0.746164914093242,-37,0
21,1,1.5,26,85,-59,0,0.941369320455124,-35,0
21,1,1.5,48,69,-21,NaN,NaN,0,0
21,1,1.5,22,66,-44,0,0.762237769005878,-16,0
21,1,1.5,33,70,-37,0,1.06265199730478,-20,0
21,1,1.5,58,19,39,1,0.879029199233628,-31,0
21,1,1.5,49,100,-51,0,0.622761286922469,-50,0
21,1,1.5,51,1,50,1,0.656565177807352,-49,0
21,1,1.5,51,4,47,1,0.681027046288364,-46,0
21,1,1.5,86,47,39,1,0.680831735317042,-3,0
21,1,1.5,49,96,-47,0,0.567941694487672,-46,0
22,1,10,50,100,-50,0,1.58258548920548,-50,0
22,1,10,50,100,-50,0,1.36678951098156,-50,0
22,1,10,5,83,-78,0,1.37225550121411,-33,0
22,1,10,100,0,100,1,0.997895695546958,-50,0
22,1,10,3,100,-97,0,0.978815293236948,-50,0
22,1,10,85,15,70,0,2.3450924850813,35,0
22,1,10,50,43,7,0,2.76373535460107,7,0
22,1,10,48,60,-12,0,1.99753254393454,-10,0
22,1,10,28,85,-57,0,1.73436233601115,-35,0
22,1,10,48,100,-52,0,3.59768088367082,-50,0
22,1,10,48,80,-32,0,4.2379132524029,-30,0
22,1,10,53,23,30,0,3.41136931468009,27,0
22,1,10,0,68,-68,0,3.53100980967747,-18,0
22,1,10,53,0,53,0,3.90929515447215,50,0
22,1,10,48,80,-32,0,3.92876527310182,-30,0
22,1,10,53,40,13,0,3.00362733284464,10,0
22,1,10,30,100,-70,0,4.29140823197531,-50,0
22,1,10,80,45,35,0,2.99073982773552,5,0
22,1,10,5,83,-78,0,4.15856175726276,-33,0
22,1,10,85,15,70,1,5.08795186178895,-35,0
22,1,1.5,53,0,53,1,1.2229473608827,-50,0
22,1,1.5,3,100,-97,0,1.01394560821564,-50,0
22,1,1.5,98,38,60,1,1.16639985503662,-12,0
22,1,1.5,100,15,85,1,1.21607102623238,-35,0
22,1,1.5,48,100,-52,0,0.6944844853615,-50,0
22,1,1.5,98,38,60,1,1.49761374741229,-12,0
22,1,1.5,50,43,7,NaN,NaN,0,0
22,1,1.5,53,40,13,1,1.26570868967337,-10,0
22,1,1.5,28,85,-57,0,0.741987916132985,-35,0
22,1,1.5,80,45,35,0,1.08781088772184,5,0
22,1,1.5,100,0,100,1,1.08419718202367,-50,0
22,1,1.5,25,55,-30,0,0.784552726469883,-5,0
22,1,1.5,30,100,-70,0,0.937043499762694,-50,0
22,1,1.5,75,0,75,0,1.27476302838386,50,0
22,1,1.5,53,23,30,0,1.01574204649205,27,0
22,1,1.5,48,60,-12,0,0.894159007332746,-10,0
22,1,1.5,100,15,85,1,1.21055401968852,-35,0
22,1,1.5,75,0,75,0,1.33822460283818,50,0
22,1,1.5,0,68,-68,NaN,NaN,0,0
22,1,1.5,25,55,-30,0,1.27312990267819,-5,0
22,1,10,16,73,-57,0,3.66691062189329,-23,0
22,1,10,98,41,57,1,3.0778071626255,-9,0
22,1,10,71,10,61,0,2.27354286311538,40,0
22,1,10,3,92,-89,0,2.27027057426994,-42,0
22,1,10,29,90,-61,0,2.41026325690063,-40,0
22,1,10,15,96,-81,0,4.91743814262736,-46,0
22,1,10,95,23,72,1,6.35784746853005,-27,0
22,1,10,53,23,30,0,4.02923208744414,27,0
22,1,10,53,0,53,0,3.23346728652541,50,0
22,1,10,85,15,70,1,2.58846987356537,-35,0
22,1,10,48,74,-26,0,8.95227473647674,-24,0
22,1,10,50,43,7,0,3.35818616853794,7,0
22,1,10,95,17,78,0,4.09379126727072,33,0
22,1,10,66,41,25,0,2.38337162339485,9,0
22,1,10,75,0,75,0,6.16392360177133,50,0
22,1,10,54,7,47,0,4.77795109503495,43,0
22,1,10,8,55,-47,0,2.9598683182021,-5,0
22,1,10,53,48,5,0,4.39964552483843,2,0
22,1,10,20,82,-62,0,4.15695368690513,-32,0
22,1,10,89,30,59,1,2.03645466889338,-20,0
22,1,1.5,9,67,-58,1,1.13959033062338,17,0
22,1,1.5,10,73,-63,NaN,NaN,0,0
22,1,1.5,54,7,47,0,1.08781028397834,43,0
22,1,1.5,62,49,13,0,0.882807727125055,1,0
22,1,1.5,60,1,59,0,1.06999895014633,49,0
22,1,1.5,53,49,4,0,0.969682769764859,1,0
22,1,1.5,50,4,46,0,0.648751531903599,46,0
22,1,1.5,55,48,7,0,0.716560058328923,2,0
22,1,1.5,43,96,-53,0,0.677711288184128,-46,0
22,1,1.5,49,83,-34,0,0.704834155385925,-33,0
22,1,1.5,82,36,46,1,0.761314645721541,-14,0
22,1,1.5,63,47,16,0,0.777132419079862,3,0
22,1,1.5,60,1,59,0,0.888236587143183,49,0
22,1,1.5,42,85,-43,0,0.810683643381253,-35,0
22,1,1.5,6,55,-49,0,0.872467415122628,-5,0
22,1,1.5,79,34,45,1,0.9475730852987,-16,0
22,1,1.5,43,69,-26,0,0.579959205722844,-19,0
22,1,1.5,60,48,12,0,0.731146497167174,2,0
22,1,1.5,62,12,50,0,0.852316274017539,38,0
22,1,1.5,58,49,9,0,0.936049738242673,1,0
22,1,10,71,10,61,0,1.19345540485665,40,0
22,1,10,43,86,-43,0,2.66760160613376,-36,0
22,1,10,56,1,55,0,4.16620061973799,49,0
22,1,10,19,89,-70,0,2.22023232713036,-39,0
22,1,10,58,28,30,0,2.41617692281216,22,0
22,1,10,84,6,78,1,5.53744118549366,-44,0
22,1,10,54,47,7,0,3.75168010967127,3,0
22,1,10,58,24,34,0,7.58181088651418,26,0
22,1,10,80,21,59,1,8.22613391817504,-29,0
22,1,10,58,47,11,0,5.46028852355948,3,0
22,1,10,60,47,13,0,7.58062211589868,3,0
22,1,10,55,49,6,0,8.8489790827648,1,0
22,1,10,74,27,47,0,8.68217114015852,23,0
22,1,10,61,44,17,0,7.67414769318248,6,0
22,1,10,93,43,50,1,5.97849379991385,-7,0
22,1,10,54,24,30,0,6.24734010074826,26,0
22,1,10,57,33,24,NaN,NaN,0,0
22,1,10,40,70,-30,0,4.93197567825609,-20,0
22,1,10,61,14,47,0,5.88306612927045,36,0
22,1,10,67,11,56,1,4.69126804277448,-39,0
22,1,1.5,83,13,70,0,1.27871573596167,37,0
22,1,1.5,62,42,20,0,0.656920179150347,8,0
22,1,1.5,53,3,50,0,0.867459364205843,47,0
22,1,1.5,9,67,-58,0,1.18986645263521,-17,0
22,1,1.5,43,89,-46,0,1.26688266857718,-39,0
22,1,1.5,56,47,9,0,0.756462058711804,3,0
22,1,1.5,37,56,-19,0,0.794981486870256,-6,0
22,1,1.5,39,77,-38,0,1.0800953498433,-27,0
22,1,1.5,43,97,-54,0,1.45769454034462,-47,0
22,1,1.5,37,60,-23,0,1.25254678322108,-10,0
22,1,1.5,9,97,-88,NaN,NaN,0,0
22,1,1.5,61,41,20,0,1.09408800711708,9,0
22,1,1.5,83,7,76,0,1.34236477271952,43,0
22,1,1.5,60,47,13,0,0.771998789550707,3,0
22,1,1.5,12,67,-55,0,1.42445877193359,-17,0
22,1,1.5,61,45,16,0,0.498697466688554,5,0
22,1,1.5,8,60,-52,0,1.16186393140333,-10,0
22,1,1.5,87,30,57,0,0.567571298218809,20,0
22,1,1.5,45,76,-31,0,0.948095927022223,-26,0
22,1,1.5,11,50,-39,0,1.00982898432403,0,0
22,1,10,2,74,-72,0,3.33850021166791,-24,0
22,1,10,39,75,-36,0,3.4481360759537,-25,0
22,1,10,19,81,-62,0,4.42576647998476,-31,0
22,1,10,68,8,60,1,5.47561998166611,-42,0
22,1,10,84,23,61,1,4.55535515569181,-27,0
22,1,10,93,7,86,1,4.54390727655118,-43,0
22,1,10,41,73,-32,0,1.34062901064726,-23,0
22,1,10,54,49,5,0,2.6066663956417,1,0
22,1,10,58,43,15,0,3.08933020780978,7,0
22,1,10,62,48,14,0,5.68824600553899,2,0
22,1,10,19,79,-60,0,4.92376778769312,-29,0
22,1,10,64,47,17,0,5.23293689801039,3,0
22,1,10,18,68,-50,0,6.77725980892274,-18,0
22,1,10,33,65,-32,0,6.1485224113103,-15,0
22,1,10,48,88,-40,0,5.00795194631337,-38,0
22,1,10,33,68,-35,0,4.76174934091887,-18,0
22,1,10,73,36,37,1,4.38896530534157,-14,0
22,1,10,64,44,20,0,5.87888430109933,6,0
22,1,10,58,49,9,0,8.22103590950155,1,0
22,1,10,59,44,15,0,7.81183618939667,6,0
22,1,1.5,54,24,30,NaN,NaN,0,0
22,1,1.5,78,37,41,1,1.23439614563767,-13,0
22,1,1.5,11,94,-83,0,1.38730410557082,-44,0
22,1,1.5,88,23,65,1,1.08623058955664,-27,0
22,1,1.5,51,14,37,NaN,NaN,0,0
22,1,1.5,92,43,49,NaN,NaN,0,0
22,1,1.5,90,10,80,1,0.993477803734095,-40,0
22,1,1.5,55,49,6,0,0.859980493712555,1,0
22,1,1.5,77,25,52,1,0.731729713223558,-25,0
22,1,1.5,60,46,14,1,0.953410075807369,-4,0
22,1,1.5,58,20,38,0,0.78708150540524,30,0
22,1,1.5,50,71,-21,1,0.741521222539177,21,0
22,1,1.5,24,62,-38,0,1.17795640797658,-12,0
22,1,1.5,83,7,76,1,1.08492408899201,-43,0
22,1,1.5,27,97,-70,0,1.45926215989948,-47,0
22,1,1.5,56,45,11,0,1.26688266857718,5,0
22,1,1.5,35,99,-64,NaN,NaN,0,0
22,1,1.5,93,23,70,1,1.47220520939482,-27,0
22,1,1.5,64,47,17,1,1.19120676282637,-3,0
22,1,1.5,88,29,59,1,0.809546190948822,-21,0
23,1,10,0,68,-68,1,1.31529292107916,18,0
23,1,10,50,43,7,1,3.78744526001174,-7,0
23,1,10,53,0,53,0,1.81092996990992,50,0
23,1,10,48,60,-12,1,3.33913051895433,10,0
23,1,10,53,0,53,0,2.94948000785553,50,0
23,1,10,28,85,-57,1,3.75126503538377,35,0
23,1,10,50,100,-50,1,3.7848114297376,50,0
23,1,10,48,80,-32,1,4.24900945030276,30,0
23,1,10,30,100,-70,1,4.039075517936,50,0
23,1,10,80,45,35,0,6.14920373490713,5,0
23,1,10,75,0,75,0,6.51060630311076,50,0
23,1,10,53,40,13,1,5.17737047432456,-10,0
23,1,10,85,15,70,0,4.69845711571907,35,0
23,1,10,98,38,60,0,6.27834382932087,12,0
23,1,10,53,23,30,1,6.97846270638365,-27,0
23,1,10,48,100,-52,1,3.90628911568638,50,0
23,1,10,48,60,-12,1,3.82187885518761,10,0
23,1,10,53,23,30,0,6.13272486260212,27,0
23,1,10,80,45,35,0,5.72686535246976,5,0
23,1,10,3,100,-97,1,6.13708449318437,50,0
23,1,1.5,100,15,85,0,1.04229256426697,35,0
23,1,1.5,50,43,7,1,1.46539981383648,-7,0
23,1,1.5,3,100,-97,1,1.29497997676299,50,0
23,1,1.5,50,100,-50,1,1.08394270346071,50,0
23,1,1.5,28,85,-57,1,0.993002958855868,35,0
23,1,1.5,30,100,-70,1,0.834044887018536,50,0
23,1,1.5,100,0,100,0,0.800548905232063,50,0
23,1,1.5,5,83,-78,1,0.736357103221962,33,0
23,1,1.5,5,83,-78,1,0.794810324887294,33,0
23,1,1.5,100,15,85,0,0.9152625527895,35,0
23,1,1.5,53,40,13,1,1.23036193196094,-10,0
23,1,1.5,25,55,-30,1,1.1733589017731,5,0
23,1,1.5,85,15,70,0,0.830376844420243,35,0
23,1,1.5,48,100,-52,1,1.10150650252763,50,0
23,1,1.5,48,80,-32,1,1.42519956424803,30,0
23,1,1.5,25,55,-30,NaN,NaN,0,0
23,1,1.5,98,38,60,0,1.02936883455732,12,0
23,1,1.5,100,0,100,0,0.995737010522134,50,0
23,1,1.5,75,0,75,0,0.68358903061926,50,0
23,1,1.5,0,68,-68,1,0.703291590429217,18,0
23,1,10,6,80,-74,1,3.25163694127332,30,0
23,1,10,21,97,-76,1,3.96065952308527,47,0
23,1,10,55,34,21,1,2.76143448802213,-16,0
23,1,10,28,80,-52,1,1.71463079577006,30,0
23,1,10,32,57,-25,1,5.16267596543184,7,0
23,1,10,89,46,43,0,5.19445399557299,4,0
23,1,10,21,74,-53,1,1.29756550756974,24,0
23,1,10,75,30,45,0,1.96099671373486,20,0
23,1,10,97,22,75,0,3.40174353215843,28,0
23,1,10,33,92,-59,1,4.08809675943849,42,0
23,1,10,72,47,25,1,4.94484627780366,-3,0
23,1,10,53,42,11,1,3.32134152362414,-8,0
23,1,10,64,42,22,1,4.76299033458235,-8,0
23,1,10,94,30,64,0,5.28295974894536,20,0
23,1,10,97,26,71,0,5.56528280837847,24,0
23,1,10,63,27,36,1,2.93296098661995,-23,0
23,1,10,67,12,55,0,3.83002939013568,38,0
23,1,10,71,31,40,1,4.38754439466538,-19,0
23,1,10,32,64,-32,1,2.84228658720895,14,0
23,1,10,94,28,66,0,3.55940536706839,22,0
23,1,1.5,66,46,20,0,1.19011459039393,4,0
23,1,1.5,25,83,-58,1,0.949828669628914,33,0
23,1,1.5,43,72,-29,1,1.08616870511469,22,0
23,1,1.5,99,27,72,NaN,NaN,0,0
23,1,1.5,13,86,-73,1,0.781120444893531,36,0
23,1,1.5,95,48,47,1,0.956274535283228,-2,0
23,1,1.5,26,76,-50,1,0.660692970464879,26,0
23,1,1.5,16,93,-77,1,0.712428943847044,43,0
23,1,1.5,87,34,53,0,1.48233119176439,16,0
23,1,1.5,89,37,52,NaN,NaN,0,0
23,1,1.5,19,69,-50,1,1.36639466209272,19,0
23,1,1.5,47,93,-46,1,1.18930104625724,43,0
23,1,1.5,25,99,-74,1,0.627675757141333,49,0
23,1,1.5,63,48,15,1,1.21749133166486,-2,0
23,1,1.5,36,79,-43,1,0.783166832907227,29,0
23,1,1.5,55,45,10,1,0.958291641747564,-5,0
23,1,1.5,36,52,-16,1,0.742025951212781,2,0
23,1,1.5,52,18,34,0,1.22244746065553,32,0
23,1,1.5,93,33,60,0,0.915467523649568,17,0
23,1,1.5,97,20,77,NaN,NaN,0,0
23,1,10,14,88,-74,1,2.89168516828977,38,0
23,1,10,42,99,-57,1,2.70942864137396,49,0
23,1,10,22,50,-28,1,2.61465361726732,0,0
23,1,10,13,71,-58,1,2.67585447482452,21,0
23,1,10,95,8,87,0,2.77437844313317,42,0
23,1,10,4,86,-82,1,2.63623774316511,36,0
23,1,10,56,43,13,1,2.92741952847064,-7,0
23,1,10,36,57,-21,1,2.50322976711323,7,0
23,1,10,2,90,-88,1,1.23980538324759,40,0
23,1,10,19,52,-33,1,1.39196470145362,2,0
23,1,10,61,23,38,1,2.16354294085249,-27,0
23,1,10,94,4,90,0,2.98271185193516,46,0
23,1,10,37,100,-63,1,1.61988354385903,50,0
23,1,10,53,40,13,1,3.35646912175798,-10,0
23,1,10,20,81,-61,1,3.4748523212711,31,0
23,1,10,24,85,-61,1,3.6451589564731,35,0
23,1,10,55,43,12,1,3.15268703204492,-7,0
23,1,10,35,74,-39,1,4.36708443884709,24,0
23,1,10,18,86,-68,1,3.27705030923789,36,0
23,1,10,45,93,-48,1,2.99941018493882,43,0
23,1,1.5,9,91,-82,1,0.585653712054409,41,0
23,1,1.5,31,94,-63,1,0.791434494061832,44,0
23,1,1.5,95,20,75,1,1.42994649617685,-30,0
23,1,1.5,60,49,11,1,0.970831692569845,-1,0
23,1,1.5,32,60,-28,1,0.624570101454083,10,0
23,1,1.5,50,88,-38,1,0.732383868371471,38,0
23,1,1.5,43,93,-50,1,0.682895027661289,43,0
23,1,1.5,72,11,61,0,1.15595207597107,39,0
23,1,1.5,40,99,-59,1,1.00228189008521,49,0
23,1,1.5,18,59,-41,1,1.08604946580817,9,0
23,1,1.5,67,49,18,1,1.15634269790644,-1,0
23,1,1.5,53,48,5,1,1.46670178632485,-2,0
23,1,1.5,100,14,86,0,0.891530609998881,36,0
23,1,1.5,4,68,-64,1,0.668658156211677,18,0
23,1,1.5,77,21,56,1,1.22245712054973,-29,0
23,1,1.5,34,99,-65,1,0.666099190108071,49,0
23,1,1.5,38,68,-30,1,0.947222007802338,18,0
23,1,1.5,26,96,-70,1,0.857592989967088,46,0
23,1,1.5,22,99,-77,1,1.01936178887445,49,0
23,1,1.5,53,49,4,1,0.862381882054251,-1,0
23,1,10,26,94,-68,1,1.05562744318195,44,0
23,1,10,51,39,12,1,2.86989395843193,-11,0
23,1,10,94,24,70,0,3.58228331491955,26,0
23,1,10,31,86,-55,1,3.73050230228546,36,0
23,1,10,14,97,-83,1,2.78470909524367,47,0
23,1,10,60,45,15,1,2.33184786504353,-5,0
23,1,10,56,40,16,1,2.5457287694262,-10,0
23,1,10,83,44,39,1,3.04769214273438,-6,0
23,1,10,58,36,22,1,2.43342224652224,-14,0
23,1,10,94,26,68,1,4.77134010482769,-24,0
23,1,10,76,22,54,0,4.29256741841891,28,0
23,1,10,26,82,-56,1,1.49117361656863,32,0
23,1,10,50,32,18,1,2.76790993710165,-18,0
23,1,10,11,99,-88,1,3.29173183764942,49,0
23,1,10,8,86,-78,1,3.80276796383987,36,0
23,1,10,5,88,-83,1,2.4128804834836,38,0
23,1,10,53,43,10,1,3.11150902013651,-7,0
23,1,10,36,99,-63,1,2.78182350399948,49,0
23,1,10,39,97,-58,1,3.06496976746166,47,0
23,1,10,60,20,40,1,4.20136776231084,-30,0
23,1,1.5,82,36,46,1,1.48598776323888,-14,0
23,1,1.5,1,53,-52,1,0.741505826334105,3,0
23,1,1.5,22,86,-64,1,0.827309224565397,36,0
23,1,1.5,63,47,16,NaN,NaN,0,0
23,1,1.5,9,89,-80,1,0.628946636847104,39,0
23,1,1.5,31,82,-51,1,0.718816850145231,32,0
23,1,1.5,41,95,-54,1,0.781149424572504,45,0
23,1,1.5,33,90,-57,1,0.792926947571686,40,0
23,1,1.5,65,36,29,1,1.34001681416157,-14,0
23,1,1.5,43,82,-39,1,0.672949563795555,32,0
23,1,1.5,92,22,70,0,0.710036309033967,28,0
23,1,1.5,31,80,-49,1,1.03654583338539,30,0
23,1,1.5,40,66,-26,1,0.838197735509311,16,0
23,1,1.5,66,37,29,0,1.11929066790981,13,0
23,1,1.5,21,59,-38,1,0.908954642485696,9,0
23,1,1.5,55,50,5,1,1.17931120725734,0,0
23,1,1.5,60,16,44,0,1.00698565436505,34,0
23,1,1.5,55,49,6,1,0.905313466466396,-1,0
23,1,1.5,35,98,-63,1,0.751735049565468,48,0
23,1,1.5,0,68,-68,1,0.8341028463783,18,0
24,1,10,53,0,53,0,6.23659256412429,50,0
24,1,10,28,85,-57,0,8.32863927212748,-35,0
24,1,10,3,100,-97,0,8.16941827007031,-50,0
24,1,10,53,23,30,1,6.19296758050405,-27,0
24,1,10,28,85,-57,0,7.41574645407309,-35,0
24,1,10,53,0,53,1,8.18144302596193,-50,0
24,1,10,0,68,-68,0,8.17294322549787,-18,0
24,1,10,80,45,35,1,9.41243643127382,-5,0
24,1,10,85,15,70,1,8.78554407327101,-35,0
24,1,10,100,0,100,1,7.51286973785682,-50,0
24,1,10,75,0,75,1,8.38721927988809,-50,0
24,1,10,53,40,13,NaN,NaN,0,0
24,1,10,30,100,-70,0,2.2973321617792,-50,0
24,1,10,50,100,-50,1,4.25395018484414,50,0
24,1,10,98,38,60,1,3.38730742641565,-12,0
24,1,10,100,15,85,1,4.15563209301399,-35,0
24,1,10,5,83,-78,0,4.89307740141521,-33,0
24,1,10,48,100,-52,0,3.6888823512636,-50,0
24,1,10,80,45,35,1,3.8851734956188,-5,0
24,1,10,85,15,70,1,2.93738853933246,-35,0
24,1,1.5,50,100,-50,0,0.642475318378274,-50,0
24,1,1.5,100,15,85,1,0.497704309167602,-35,0
24,1,1.5,48,100,-52,0,0.63888636615593,-50,0
24,1,1.5,48,60,-12,0,0.470089994898444,-10,0
24,1,1.5,5,83,-78,1,0.547312691058323,33,0
24,1,1.5,50,43,7,1,0.734578778250579,-7,0
24,1,1.5,48,60,-12,0,0.737696810676425,-10,0
24,1,1.5,48,80,-32,0,0.860847771262343,-30,0
24,1,1.5,48,80,-32,0,0.658616094417084,-30,0
24,1,1.5,0,68,-68,0,0.681115193332516,-18,0
24,1,1.5,25,55,-30,0,0.670986795237695,-5,0
24,1,1.5,30,100,-70,0,0.468086774526455,-50,0
24,1,1.5,53,40,13,1,0.744705968856579,-10,0
24,1,1.5,98,38,60,1,0.507881912340963,-12,0
24,1,1.5,75,0,75,1,0.983762064461189,-50,0
24,1,1.5,53,23,30,1,0.456874355288164,-27,0
24,1,1.5,50,43,7,1,0.646097778353578,-7,0
24,1,1.5,100,0,100,1,0.628594051748223,-50,0
24,1,1.5,25,55,-30,0,0.531783808881301,-5,0
24,1,1.5,3,100,-97,0,0.606255548562331,-50,0
24,1,10,49,96,-47,0,3.12786714477988,-46,0
24,1,10,95,42,53,1,3.37033016399073,-8,0
24,1,10,51,1,50,1,3.14667163639024,-49,0
24,1,10,49,97,-48,0,4.94038038939834,-47,0
24,1,10,18,67,-49,0,3.85353583579854,-17,0
24,1,10,49,67,-18,0,4.12174247057555,-17,0
24,1,10,49,100,-51,0,4.60315864715449,-50,0
24,1,10,59,47,12,1,4.05715883914309,-3,0
24,1,10,20,68,-48,0,4.36520559061319,-18,0
24,1,10,61,28,33,1,4.54123571257514,-22,0
24,1,10,49,98,-49,0,4.21252131758229,-48,0
24,1,10,51,0,51,1,4.64258187907399,-50,0
24,1,10,49,97,-48,0,4.41447738559509,-47,0
24,1,10,13,85,-72,0,4.73248590200092,-35,0
24,1,10,40,61,-21,0,4.46108516313689,-11,0
24,1,10,100,5,95,1,4.44900939093714,-45,0
24,1,10,91,4,87,1,4.41371063156839,-46,0
24,1,10,49,99,-50,0,4.79571986521842,-49,0
24,1,10,10,81,-71,0,4.62622949100114,-31,0
24,1,10,36,71,-35,0,4.98346985269382,-21,0
24,1,1.5,82,30,52,0,0.674650913504593,20,0
24,1,1.5,49,96,-47,0,0.575164276455325,-46,0
24,1,1.5,78,3,75,1,0.383678325262736,-47,0
24,1,1.5,49,100,-51,0,0.471576410971466,-50,0
24,1,1.5,8,91,-83,0,0.483535358842346,-41,0
24,1,1.5,41,58,-17,0,0.534687512423261,-8,0
24,1,1.5,51,3,48,1,0.679943327530054,-47,0
24,1,1.5,68,46,22,1,0.483725839865656,-4,0
24,1,1.5,49,99,-50,0,0.455629738415155,-49,0
24,1,1.5,58,27,31,1,1.00414474113495,-23,0
24,1,1.5,51,4,47,1,0.729912144186528,-46,0
24,1,1.5,51,0,51,1,0.315745125841204,-50,0
24,1,1.5,5,81,-76,0,0.557658134875965,-31,0
24,1,1.5,87,14,73,1,0.5021499731738,-36,0
24,1,1.5,99,25,74,1,0.432744545640162,-25,0
24,1,1.5,51,2,49,1,0.549974595396634,-48,0
24,1,1.5,69,5,64,1,0.430520958958368,-45,0
24,1,1.5,55,36,19,1,0.372453831154417,-14,0
24,1,1.5,82,24,58,1,0.34069481892584,-26,0
24,1,1.5,51,1,50,1,0.4129085585555,-49,0
24,1,10,3,66,-63,0,3.39240000139762,-16,0
24,1,10,70,15,55,1,4.49467834760071,-35,0
24,1,10,94,11,83,1,4.40873578653191,-39,0
24,1,10,49,97,-48,1,4.8139918552115,47,0
24,1,10,8,64,-56,0,4.61046877138506,-14,0
24,1,10,0,97,-97,0,4.97511313939685,-47,0
24,1,10,49,100,-51,0,4.35695423053039,-50,0
24,1,10,51,3,48,1,4.7882992559571,-47,0
24,1,10,73,18,55,1,5.20942622740404,-32,0
24,1,10,49,98,-49,0,4.98985262716815,-48,0
24,1,10,53,30,23,1,4.63372013449043,-20,0
24,1,10,51,3,48,1,4.82093822408933,-47,0
24,1,10,2,96,-94,0,4.35275972374802,-46,0
24,1,10,51,4,47,1,4.31148571665108,-46,0
24,1,10,49,99,-50,0,4.41612952921423,-49,0
24,1,10,0,51,-51,0,4.5161248200202,-1,0
24,1,10,29,55,-26,0,4.6920586449196,-5,0
24,1,10,14,78,-64,0,4.81329000359256,-28,0
24,1,10,98,40,58,1,4.72190922448135,-10,0
24,1,10,49,96,-47,0,4.57772716689215,-46,0
24,1,1.5,0,51,-51,1,1.00428541332803,1,0
24,1,1.5,51,0,51,1,0.521441685650643,-50,0
24,1,1.5,49,98,-49,0,0.658013860447682,-48,0
24,1,1.5,96,8,88,1,0.461154291748244,-42,0
24,1,1.5,49,99,-50,0,0.352348574542702,-49,0
24,1,1.5,51,2,49,1,0.391610606995528,-48,0
24,1,1.5,56,4,52,1,0.493457578588277,-46,0
24,1,1.5,23,88,-65,0,0.527375576959457,-38,0
24,1,1.5,0,77,-77,0,0.559184398014622,-27,0
24,1,1.5,33,53,-20,1,0.533129552764876,3,0
24,1,1.5,93,17,76,1,0.602243070396071,-33,0
24,1,1.5,49,100,-51,0,0.64674257623119,-50,0
24,1,1.5,51,3,48,1,0.673221853045106,-47,0
24,1,1.5,86,8,78,1,0.514383020512469,-42,0
24,1,1.5,17,85,-68,0,0.498882816144032,-35,0
24,1,1.5,74,5,69,1,0.643482664123439,-45,0
24,1,1.5,49,96,-47,0,0.646593149758701,-46,0
24,1,1.5,94,33,61,1,0.882394163199933,-17,0
24,1,1.5,49,99,-50,0,0.491543410360464,-49,0
24,1,1.5,100,42,58,1,0.628050079008972,-8,0
24,1,10,49,97,-48,0,0.70454013264316,-47,0
24,1,10,20,69,-49,0,5.68476542549979,-19,0
24,1,10,24,80,-56,0,4.60365945224839,-30,0
24,1,10,24,74,-50,0,5.1662163173205,-24,0
24,1,10,76,1,75,1,4.38593632531411,-49,0
24,1,10,49,98,-49,0,5.39731054776712,-48,0
24,1,10,32,85,-53,0,4.48034034914235,-35,0
24,1,10,26,82,-56,0,4.50422202027767,-32,0
24,1,10,49,99,-50,0,4.56616789710824,-49,0
24,1,10,51,3,48,1,4.33819411405784,-47,0
24,1,10,80,32,48,1,4.08476711598269,-18,0
24,1,10,51,4,47,1,3.54815310177219,-46,0
24,1,10,14,52,-38,0,4.24176513509883,-2,0
24,1,10,49,97,-48,0,3.72307565659503,-47,0
24,1,10,15,93,-78,0,3.89727643626975,-43,0
24,1,10,1,67,-66,0,5.02469586219377,-17,0
24,1,10,97,38,59,1,4.69787299505333,-12,0
24,1,10,3,70,-67,0,3.66436614588747,-20,0
24,1,10,49,98,-49,0,3.92064371809101,-48,0
24,1,10,51,0,51,1,3.83007225691836,-50,0
24,1,1.5,88,4,84,1,0.43619674999718,-46,0
24,1,1.5,41,50,-9,0,0.790749246389169,0,0
24,1,1.5,82,43,39,1,0.330496084734477,-7,0
24,1,1.5,49,98,-49,0,0.361744631976762,-48,0
24,1,1.5,49,100,-51,0,0.479649063032412,-50,0
24,1,1.5,51,2,49,1,0.472804424902279,-48,0
24,1,1.5,7,54,-47,0,0.642053603663953,-4,0
24,1,1.5,51,0,51,1,0.460633261256589,-50,0
24,1,1.5,38,75,-37,0,0.445039778544015,-25,0
24,1,1.5,81,47,34,1,0.646940302172879,-3,0
24,1,1.5,51,1,50,1,0.470011508263269,-49,0
24,1,1.5,49,100,-51,0,0.525949837090593,-50,0
24,1,1.5,74,13,61,1,0.691750132078596,-37,0
24,1,1.5,51,2,49,1,0.66686805824429,-48,0
24,1,1.5,38,79,-41,0,0.578711570386076,-29,0
24,1,1.5,75,1,74,1,0.67052070538557,-49,0
24,1,1.5,23,61,-38,0,0.694303060747188,-11,0
24,1,1.5,5,72,-67,0,0.773434189573891,-22,0
24,1,1.5,51,4,47,1,0.761204462822207,-46,0
24,1,1.5,32,69,-37,0,0.701618920542387,-19,0
25,1,10,53,0,53,0,2.63629306920211,50,0
25,1,10,48,60,-12,1,1.68218951240897,10,0
25,1,10,48,80,-32,0,8.25951629514475,-30,0
25,1,10,100,15,85,1,4.87169044443499,-35,0
25,1,10,48,100,-52,1,4.06020969247493,50,0
25,1,10,50,43,7,0,2.46569740255791,7,0
25,1,10,50,43,7,0,4.43897126733509,7,0
25,1,10,75,0,75,0,5.98896455070872,50,0
25,1,10,48,100,-52,1,5.1644704485102,50,0
25,1,10,53,23,30,1,4.14958912148586,-27,0
25,1,10,5,83,-78,0,4.23898877584361,-33,0
25,1,10,25,55,-30,0,3.60509713238343,-5,0
25,1,10,28,85,-57,0,4.93259107609947,-35,0
25,1,10,98,38,60,1,3.1105617493472,-12,0
25,1,10,98,38,60,1,3.51419989676606,-12,0
25,1,10,0,68,-68,0,3.1498861623968,-18,0
25,1,10,53,0,53,0,2.79960157365804,50,0
25,1,10,100,15,85,1,6.85545915099374,-35,0
25,1,10,48,60,-12,0,3.73139868626322,-10,0
25,1,10,100,0,100,1,4.11826670078381,-50,0
25,1,1.5,3,100,-97,1,1.46129189945214,50,0
25,1,1.5,48,80,-32,NaN,NaN,0,0
25,1,1.5,100,0,100,0,1.22476431977748,50,0
25,1,1.5,85,15,70,1,1.13646981458123,-35,0
25,1,1.5,50,100,-50,1,1.29150524667148,50,0
25,1,1.5,30,100,-70,NaN,NaN,0,0
25,1,1.5,5,83,-78,0,0.820987009899454,-33,0
25,1,1.5,50,100,-50,1,1.24347216162732,50,0
25,1,1.5,30,100,-70,0,1.15310138876248,-50,0
25,1,1.5,75,0,75,NaN,NaN,0,0
25,1,1.5,80,45,35,1,1.35068400703904,-5,0
25,1,1.5,28,85,-57,1,1.23962874203426,35,0
25,1,1.5,85,15,70,1,1.27728743176385,-35,0
25,1,1.5,53,23,30,0,0.906283031996281,27,0
25,1,1.5,0,68,-68,0,0.814040659894999,-18,0
25,1,1.5,53,40,13,1,1.14983122190324,-10,0
25,1,1.5,3,100,-97,0,1.15149936018997,-50,0
25,1,1.5,53,40,13,1,0.953234211934159,-10,0
25,1,1.5,25,55,-30,0,1.4509132779458,-5,0
25,1,1.5,80,45,35,1,1.17655494215978,-5,0
25,1,10,36,94,-58,0,1.71615058616317,-44,0
25,1,10,99,5,94,1,2.52156463976053,-45,0
25,1,10,100,0,100,0,2.61941396092834,50,0
25,1,10,48,60,-12,0,3.34596576573858,-10,0
25,1,10,9,70,-61,0,2.8276767696857,-20,0
25,1,10,48,100,-52,1,3.63344461591259,50,0
25,1,10,11,59,-48,0,3.23772665384286,-9,0
25,1,10,15,64,-49,0,3.21943871433723,-14,0
25,1,10,40,79,-39,1,5.12102338533577,29,0
25,1,10,48,71,-23,1,2.89019844778568,21,0
25,1,10,74,12,62,1,2.9386813203887,-38,0
25,1,10,40,79,-39,1,4.13977801716692,29,0
25,1,10,58,22,36,0,3.29988155886667,28,0
25,1,10,92,44,48,1,3.26152192503605,-6,0
25,1,10,94,31,63,1,3.04860004166358,-19,0
25,1,10,79,13,66,0,3.51766477031924,37,0
25,1,10,6,65,-59,0,2.50333103700768,-15,0
25,1,10,50,100,-50,1,2.59379146551282,50,0
25,1,10,43,86,-43,1,3.19248617598123,36,0
25,1,10,53,0,53,0,1.95148698348567,50,0
25,1,1.5,49,96,-47,0,0.842947510099748,-46,0
25,1,1.5,61,22,39,0,1.36075894647638,28,0
25,1,1.5,38,90,-52,1,0.977077782462402,40,0
25,1,1.5,55,31,24,1,1.36142366607601,-19,0
25,1,1.5,40,79,-39,1,1.47368520697592,29,0
25,1,1.5,48,100,-52,1,1.19730131782262,50,0
25,1,1.5,25,81,-56,0,1.14020335318719,-31,0
25,1,1.5,20,92,-72,0,1.3012653348178,-42,0
25,1,1.5,73,10,63,NaN,NaN,0,0
25,1,1.5,7,62,-55,0,0.995476810438049,-12,0
25,1,1.5,61,44,17,1,0.848512197248056,-6,0
25,1,1.5,18,96,-78,NaN,NaN,0,0
25,1,1.5,75,0,75,1,0.905453490915079,-50,0
25,1,1.5,38,90,-52,0,0.907215812906088,-40,0
25,1,1.5,100,0,100,0,1.07704412386329,50,0
25,1,1.5,55,15,40,0,1.2560224419899,35,0
25,1,1.5,84,13,71,0,0.955662762878092,37,0
25,1,1.5,59,8,51,0,0.931385102075637,42,0
25,1,1.5,28,65,-37,0,0.820515487640023,-15,0
25,1,1.5,68,41,27,1,0.914277175701955,-9,0
25,1,10,53,23,30,0,6.43559242697165,27,0
25,1,10,26,68,-42,0,2.34237410643027,-18,0
25,1,10,75,0,75,0,2.15765058239003,50,0
25,1,10,38,63,-25,1,2.77299558303139,13,0
25,1,10,48,60,-12,1,4.56352347967095,10,0
25,1,10,3,51,-48,0,1.4181316135805,-1,0
25,1,10,65,26,39,0,3.55103629031464,24,0
25,1,10,61,45,16,1,2.53326273872881,-5,0
25,1,10,0,83,-83,0,1.22124148702142,-33,0
25,1,10,23,89,-66,0,3.02618311274682,-39,0
25,1,10,89,3,86,0,2.61258171810368,47,0
25,1,10,53,23,30,0,1.8091292212539,27,0
25,1,10,36,94,-58,1,4.44586871426191,44,0
25,1,10,69,24,45,1,2.34451014452588,-26,0
25,1,10,58,16,42,0,1.7918751893917,34,0
25,1,10,58,22,36,0,0.689908953645499,28,0
25,1,10,6,79,-73,0,5.38415061635033,-29,0
25,1,10,65,32,33,1,3.01985922042422,-18,0
25,1,10,38,63,-25,0,1.59164516380815,-13,0
25,1,10,56,2,54,0,9.04160599606575,48,0
25,1,1.5,96,22,74,0,1.35627737191771,28,0
25,1,1.5,49,99,-50,1,0.954527426632012,49,0
25,1,1.5,59,8,51,0,0.776927148911,42,0
25,1,1.5,3,85,-82,0,1.47067676213874,-35,0
25,1,1.5,42,53,-11,1,1.0082054964696,3,0
25,1,1.5,43,86,-43,1,0.771926356499989,36,0
25,1,1.5,30,53,-23,1,0.568444276308128,3,0
25,1,1.5,59,38,21,1,0.924919632327146,-12,0
25,1,1.5,95,16,79,0,0.74797260311334,34,0
25,1,1.5,75,0,75,1,0.76171466957021,-50,0
25,1,1.5,62,5,57,0,1.14147513505486,45,0
25,1,1.5,99,31,68,1,1.10046024527583,-19,0
25,1,1.5,53,25,28,0,0.916118587853816,25,0
25,1,1.5,46,70,-24,1,0.851219374982065,20,0
25,1,1.5,71,14,57,0,1.12498151584987,36,0
25,1,1.5,53,23,30,0,1.13199639053573,27,0
25,1,1.5,79,13,66,0,1.14632589765597,37,0
25,1,1.5,59,8,51,0,0.840591710028548,42,0
25,1,1.5,13,88,-75,0,0.79508890640318,-38,0
25,1,1.5,19,82,-63,0,0.887518740298674,-32,0
25,1,10,80,37,43,1,4.08144479703515,-13,0
25,1,10,73,50,23,1,1.68955184043671,0,0
25,1,10,33,80,-47,0,7.03815198986285,-30,0
25,1,10,5,92,-87,0,3.02269076894618,-42,0
25,1,10,14,83,-69,0,2.25713755288916,-33,0
25,1,10,46,70,-24,1,2.28244187643486,20,0
25,1,10,51,32,19,0,4.42632378456028,18,0
25,1,10,58,16,42,0,2.58032259217043,34,0
25,1,10,17,51,-34,0,1.58556125880705,-1,0
25,1,10,53,0,53,0,8.64156614911462,50,0
25,1,10,4,71,-67,0,6.56686337869496,-21,0
25,1,10,11,95,-84,0,8.61745512101788,-45,0
25,1,10,97,33,64,1,4.21754236169181,-17,0
25,1,10,100,0,100,0,2.49888930940051,50,0
25,1,10,81,36,45,1,2.46541968138081,-14,0
25,1,10,90,27,63,0,5.66530889478099,23,0
25,1,10,30,98,-68,0,6.42488265314842,-48,0
25,1,10,42,53,-11,0,3.40154924434773,-3,0
25,1,10,89,5,84,0,3.49986133352013,45,0
25,1,10,75,0,75,0,5.41748560997303,50,0
25,1,1.5,53,25,28,0,0.935516808325247,25,0
25,1,1.5,81,46,35,1,0.693267266791736,-4,0
25,1,1.5,56,20,36,1,0.804359661909984,-30,0
25,1,1.5,53,23,30,0,0.966791533433934,27,0
25,1,1.5,90,20,70,1,0.770474961479067,-30,0
25,1,1.5,97,4,93,0,0.806260844489316,46,0
25,1,1.5,1,73,-72,0,0.817354899897509,-23,0
25,1,1.5,62,5,57,0,0.779104241441928,45,0
25,1,1.5,45,94,-49,1,0.990849734132553,44,0
25,1,1.5,87,47,40,1,0.897859929820697,-3,0
25,1,1.5,38,90,-52,0,0.709599686965703,-40,0
25,1,1.5,74,34,40,1,0.780063888856603,-16,0
25,1,1.5,5,98,-93,0,0.799804732736902,-48,0
25,1,1.5,62,22,40,0,1.16224928283555,28,0
25,1,1.5,77,41,36,NaN,NaN,0,0
25,1,1.5,95,16,79,1,0.685701175942995,-34,0
25,1,1.5,30,53,-23,0,0.700855696081817,-3,0
25,1,1.5,13,69,-56,0,0.667296110550524,-19,0
25,1,1.5,66,7,59,0,0.987081782250243,43,0
25,1,1.5,7,75,-68,0,1.12610719222994,-25,0
26,1,10,48,80,-32,0,1.77176908187539,-30,0
26,1,10,75,0,75,1,6.63650679384591,-50,0
26,1,10,0,68,-68,1,7.9444627508874,18,0
26,1,10,50,100,-50,0,7.88135091528602,-50,0
26,1,10,80,45,35,1,8.32495374381688,-5,0
26,1,10,5,83,-78,0,7.3984387672499,-33,0
26,1,10,0,68,-68,0,7.37275891637364,-18,0
26,1,10,50,43,7,0,7.78793064315141,7,0
26,1,10,100,0,100,1,8.09017248697819,-50,0
26,1,10,98,38,60,1,9.70033195025098,-12,0
26,1,10,100,15,85,0,8.81402224585872,35,0
26,1,10,48,80,-32,0,7.87598063296173,-30,0
26,1,10,30,100,-70,0,9.55092550379959,-50,0
26,1,10,53,23,30,1,7.33465738211453,-27,0
26,1,10,3,100,-97,0,6.39179217499441,-50,0
26,1,10,75,0,75,0,7.62315957445207,50,0
26,1,10,98,38,60,1,7.16412601396041,-12,0
26,1,10,85,15,70,0,6.65265688402724,35,0
26,1,10,48,100,-52,0,6.74520505129476,-50,0
26,1,10,5,83,-78,0,7.05787019351374,-33,0
26,1,1.5,100,15,85,1,0.934943253805613,-35,0
26,1,1.5,30,100,-70,0,0.841322539426983,-50,0
26,1,1.5,100,0,100,1,1.00785653385719,-50,0
26,1,1.5,85,15,70,1,0.887489157041273,-35,0
26,1,1.5,3,100,-97,0,0.684645835555784,-50,0
26,1,1.5,25,55,-30,0,0.777781745355242,-5,0
26,1,1.5,25,55,-30,0,0.683607701721485,-5,0
26,1,1.5,53,0,53,1,0.984037414867998,-50,0
26,1,1.5,53,40,13,0,0.984605837669733,10,0
26,1,1.5,53,23,30,0,1.12824232479761,27,0
26,1,1.5,53,0,53,0,0.898597400379003,50,0
26,1,1.5,48,60,-12,0,0.909721039130091,-10,0
26,1,1.5,50,100,-50,0,0.896864963600819,-50,0
26,1,1.5,48,100,-52,0,1.18921631107696,-50,0
26,1,1.5,50,43,7,0,0.908916855200005,7,0
26,1,1.5,53,40,13,0,0.864666513709381,10,0
26,1,1.5,48,60,-12,0,1.0064736635195,-10,0
26,1,1.5,28,85,-57,1,1.24619352737682,35,0
26,1,1.5,28,85,-57,NaN,NaN,0,0
26,1,1.5,80,45,35,1,1.18438456633885,-5,0
26,1,10,63,23,40,1,1.86594523860549,-27,0
26,1,10,53,23,30,0,6.36194922330105,27,0
26,1,10,75,0,75,1,7.20857589208026,-50,0
26,1,10,69,45,24,1,9.14171602807437,-5,0
26,1,10,63,15,48,1,8.60488008733046,-35,0
26,1,10,42,100,-58,0,8.49756651144344,-50,0
26,1,10,53,0,53,0,9.99427476081837,50,0
26,1,10,38,55,-17,NaN,NaN,0,0
26,1,10,16,97,-81,0,4.22849272665917,-47,0
26,1,10,86,30,56,1,4.68120722476306,-20,0
26,1,10,61,3,58,0,3.9930805597578,47,0
26,1,10,4,67,-63,0,3.71120443246036,-17,0
26,1,10,66,30,36,0,4.3607507960478,20,0
26,1,10,53,40,13,0,4.92014856371316,10,0
26,1,10,50,43,7,0,4.84867158513589,7,0
26,1,10,82,47,35,1,5.14845318158041,-3,0
26,1,10,45,87,-42,0,4.25962527060256,-37,0
26,1,10,30,79,-49,0,4.7196214972173,-29,0
26,1,10,75,0,75,1,4.64880954011096,-50,0
26,1,10,15,70,-55,0,4.81347555775574,-20,0
26,1,1.5,17,54,-37,0,0.921869529396645,-4,0
26,1,1.5,53,0,53,0,1.03626741026164,50,0
26,1,1.5,66,30,36,1,0.800796076673578,-20,0
26,1,1.5,69,27,42,1,0.783112482597062,-23,0
26,1,1.5,20,60,-40,0,0.685575295883609,-10,0
26,1,1.5,92,11,81,1,0.672086197195313,-39,0
26,1,1.5,90,20,70,0,0.715221427788492,30,0
26,1,1.5,26,61,-35,0,1.14834269685161,-11,0
26,1,1.5,85,15,70,1,0.652020238412661,-35,0
26,1,1.5,59,26,33,0,0.959791148630757,24,0
26,1,1.5,6,52,-46,0,0.845582540783653,-2,0
26,1,1.5,53,23,30,1,0.946008329610777,-27,0
26,1,1.5,53,40,13,1,0.947091744070349,-10,0
26,1,1.5,40,80,-40,0,0.652185059894691,-30,0
26,1,1.5,50,43,7,1,0.816001311115542,-7,0
26,1,1.5,50,86,-36,0,0.861821079128276,-36,0
26,1,1.5,42,61,-19,1,1.00222905757255,11,0
26,1,1.5,14,72,-58,0,1.42465172203447,-22,0
26,1,1.5,71,12,59,1,0.981515585830493,-38,0
26,1,1.5,81,48,33,1,1.30795509468953,-2,0
26,1,10,7,65,-58,0,0.890322214912885,-15,0
26,1,10,75,0,75,1,0.960584163338353,-50,0
26,1,10,85,15,70,1,3.86807252244762,-35,0
26,1,10,34,57,-23,0,3.42233093898176,-7,0
26,1,10,57,7,50,1,4.01057488081278,-43,0
26,1,10,91,14,77,1,3.15137800819139,-36,0
26,1,10,53,23,30,0,3.78979077129407,27,0
26,1,10,93,43,50,1,3.4186284930729,-7,0
26,1,10,91,27,64,0,4.15022546530963,23,0
26,1,10,78,50,28,1,3.42034070450609,0,0
26,1,10,1,52,-51,0,3.62189443374155,-2,0
26,1,10,16,70,-54,0,4.17745391361677,-20,0
26,1,10,14,89,-75,0,4.23081079287658,-39,0
26,1,10,71,21,50,1,4.13022652185828,-29,0
26,1,10,61,3,58,1,4.52961945959032,-47,0
26,1,10,22,77,-55,0,4.36824232479557,-27,0
26,1,10,53,0,53,0,3.90154335794796,50,0
26,1,10,53,29,24,0,3.80636257504375,21,0
26,1,10,82,47,35,1,3.81855453471508,-3,0
26,1,10,59,26,33,0,4.59804693889237,24,0
26,1,1.5,15,66,-51,0,0.750559938205697,-16,0
26,1,1.5,11,63,-52,0,0.916343783585035,-13,0
26,1,1.5,64,17,47,1,1.21212166702026,-33,0
26,1,1.5,28,85,-57,0,1.07974888671015,-35,0
26,1,1.5,70,33,37,1,1.46543749184275,-17,0
26,1,1.5,53,40,13,NaN,NaN,0,0
26,1,1.5,85,15,70,1,1.13283619530557,-35,0
26,1,1.5,36,62,-26,0,1.01991084041947,-12,0
26,1,1.5,24,100,-76,0,1.03953274718879,-50,0
26,1,1.5,28,98,-70,0,0.72921797136587,-48,0
26,1,1.5,66,12,54,1,0.934991855006956,-38,0
26,1,1.5,49,98,-49,0,0.812711220776691,-48,0
26,1,1.5,49,100,-51,0,0.808508876751148,-50,0
26,1,1.5,36,83,-47,0,1.26825726740208,-33,0
26,1,1.5,9,81,-72,0,0.82120164015214,-31,0
26,1,1.5,51,3,48,1,0.72830420831815,-47,0
26,1,1.5,49,99,-50,0,0.887417009907949,-49,0
26,1,1.5,54,31,23,1,1.07182568265489,-19,0
26,1,1.5,10,53,-43,0,0.792846911725064,-3,0
26,1,1.5,70,16,54,1,0.701330840875016,-34,0
26,1,10,49,97,-48,0,3.81952776631806,-47,0
26,1,10,84,41,43,1,4.77366815135611,-9,0
26,1,10,80,38,42,0,4.97759126485107,12,0
26,1,10,92,36,56,1,5.57265295970865,-14,0
26,1,10,49,100,-51,0,3.86495691345772,-50,0
26,1,10,51,0,51,1,4.26577739841377,-50,0
26,1,10,71,22,49,0,4.72911442966506,28,0
26,1,10,87,6,81,1,4.18298448936184,-44,0
26,1,10,80,14,66,0,4.33700744663656,36,0
26,1,10,51,4,47,1,3.97372128062489,-46,0
26,1,10,49,96,-47,0,4.62315987632246,-46,0
26,1,10,56,13,43,1,3.82430547617696,-37,0
26,1,10,51,1,50,1,4.12986337122857,-49,0
26,1,10,60,16,44,1,5.03922997073096,-34,0
26,1,10,49,97,-48,0,4.47164939008144,-47,0
26,1,10,45,74,-29,1,4.47895768322996,24,0
26,1,10,98,28,70,1,3.60620318723886,-22,0
26,1,10,51,3,48,1,4.11245538523508,-47,0
26,1,10,21,89,-68,0,3.90252715503084,-39,0
26,1,10,42,71,-29,0,3.12467058896073,-21,0
26,1,1.5,35,61,-26,0,0.707207360606844,-11,0
26,1,1.5,72,31,41,1,0.906249826286512,-19,0
26,1,1.5,49,97,-48,0,0.808708413380373,-47,0
26,1,1.5,51,4,47,1,0.747782726433798,-46,0
26,1,1.5,97,17,80,1,0.728257418337307,-33,0
26,1,1.5,49,96,-47,0,1.05393591079337,-46,0
26,1,1.5,71,45,26,1,1.1182983973049,-5,0
26,1,1.5,49,99,-50,0,1.12394489145299,-49,0
26,1,1.5,91,47,44,1,0.793621814180369,-3,0
26,1,1.5,3,86,-83,0,0.788704338123352,-36,0
26,1,1.5,21,65,-44,0,0.909751829956804,-15,0
26,1,1.5,37,56,-19,0,1.13216513642328,-6,0
26,1,1.5,51,0,51,1,0.793160253659153,-50,0
26,1,1.5,27,95,-68,0,1.25224060413166,-45,0
26,1,1.5,1,65,-64,0,1.04453474708498,-15,0
26,1,1.5,51,1,50,1,1.3095495764901,-49,0
26,1,1.5,49,99,-50,0,1.15578985058892,-49,0
26,1,1.5,51,3,48,1,1.35215049568433,-47,0
26,1,1.5,56,3,53,1,0.820493149280082,-47,0
26,1,1.5,25,53,-28,0,1.07808376713365,-3,0
27,1,10,80,45,35,1,2.31404262203796,-5,0
27,1,10,48,60,-12,0,2.37784513813676,-10,0
27,1,10,98,38,60,0,2.92248685517552,12,0
27,1,10,53,0,53,0,3.07765269546871,50,0
27,1,10,50,43,7,0,3.21076083315347,7,0
27,1,10,30,100,-70,0,2.33043300141799,-50,0
27,1,10,28,85,-57,0,2.09376957986024,-35,0
27,1,10,100,15,85,0,1.66650671827665,35,0
27,1,10,85,15,70,0,2.94845408709443,35,0
27,1,10,98,38,60,0,3.10302312872955,12,0
27,1,10,100,15,85,0,3.75476831955166,35,0
27,1,10,0,68,-68,0,3.21229312955984,-18,0
27,1,10,48,100,-52,0,3.44469654975546,-50,0
27,1,10,30,100,-70,0,4.37902183068582,-50,0
27,1,10,53,40,13,0,3.50699816401175,10,0
27,1,10,48,80,-32,0,3.94261982928219,-30,0
27,1,10,50,43,7,0,3.00011505595103,7,0
27,1,10,50,100,-50,0,3.79997589348932,-50,0
27,1,10,48,100,-52,0,3.84741640606808,-50,0
27,1,10,25,55,-30,0,2.79761586722816,-5,0
27,1,1.5,100,0,100,0,0.883577816406614,50,0
27,1,1.5,100,0,100,0,0.784681305281993,50,0
27,1,1.5,50,100,-50,0,1.40916846444816,-50,0
27,1,1.5,28,85,-57,0,0.912764802753372,-35,0
27,1,1.5,5,83,-78,0,1.02856245873045,-33,0
27,1,1.5,25,55,-30,0,0.923675622561859,-5,0
27,1,1.5,80,45,35,1,1.43136140520073,-5,0
27,1,1.5,3,100,-97,0,1.23028040570352,-50,0
27,1,1.5,53,40,13,NaN,NaN,0,0
27,1,1.5,53,23,30,NaN,NaN,0,0
27,1,1.5,53,0,53,0,0.734369397228875,50,0
27,1,1.5,0,68,-68,0,0.664883860616101,-18,0
27,1,1.5,5,83,-78,0,0.566717876932671,-33,0
27,1,1.5,85,15,70,0,0.760603181104671,35,0
27,1,1.5,48,80,-32,0,0.898295227561903,-30,0
27,1,1.5,75,0,75,0,0.670206145474367,50,0
27,1,1.5,53,23,30,0,1.14731120408032,27,0
27,1,1.5,3,100,-97,0,0.589727076447161,-50,0
27,1,1.5,48,60,-12,0,0.973536837438587,-10,0
27,1,1.5,75,0,75,0,0.709964950674475,50,0
27,1,10,95,18,77,0,1.0614847949073,32,0
27,1,10,15,87,-72,0,0.967079820075014,-37,0
27,1,10,66,9,57,0,2.22728071512392,41,0
27,1,10,79,37,42,1,2.73806007017629,-13,0
27,1,10,91,16,75,0,2.47516346848715,34,0
27,1,10,95,30,65,0,2.75984095722015,20,0
27,1,10,67,42,25,1,2.86500823140523,-8,0
27,1,10,97,35,62,1,3.19747157296297,-15,0
27,1,10,83,27,56,0,3.29252828694734,23,0
27,1,10,17,96,-79,0,2.30346536951765,-46,0
27,1,10,65,19,46,0,2.74344333294357,31,0
27,1,10,18,51,-33,0,2.66468402211831,-1,0
27,1,10,28,84,-56,0,2.90120556437614,-34,0
27,1,10,92,18,74,0,2.1517085566702,32,0
27,1,10,85,20,65,0,1.93295241548185,30,0
27,1,10,74,32,42,1,3.06169218017749,-18,0
27,1,10,42,79,-37,0,2.93815515948882,-29,0
27,1,10,85,44,41,1,3.234528332232,-6,0
27,1,10,33,89,-56,0,2.73497676137049,-39,0
27,1,10,36,77,-41,0,2.63946603363365,-27,0
27,1,1.5,10,79,-69,0,0.805808641947806,-29,0
27,1,1.5,89,13,76,0,0.764246460326831,37,0
27,1,1.5,28,96,-68,0,0.796709952821402,-46,0
27,1,1.5,64,43,21,1,0.835228672589437,-7,0
27,1,1.5,49,61,-12,0,1.05625126007726,-11,0
27,1,1.5,89,21,68,0,0.87667886012423,29,0
27,1,1.5,93,12,81,0,0.791803042244283,38,0
27,1,1.5,39,71,-32,0,1.01490008617475,-21,0
27,1,1.5,9,64,-55,0,0.669311400291917,-14,0
27,1,1.5,23,64,-41,0,0.947761595376505,-14,0
27,1,1.5,11,86,-75,0,0.826152925645147,-36,0
27,1,1.5,23,93,-70,0,1.16717883371166,-43,0
27,1,1.5,95,8,87,0,1.07817553577479,42,0
27,1,1.5,97,12,85,0,0.977253169407049,38,0
27,1,1.5,9,78,-69,0,0.632310789005714,-28,0
27,1,1.5,48,76,-28,NaN,NaN,0,0
27,1,1.5,19,59,-40,0,0.576016102684662,-9,0
27,1,1.5,53,40,13,1,1.01594335181289,-10,0
27,1,1.5,28,73,-45,0,1.11689258468323,-23,0
27,1,1.5,72,18,54,0,0.941271975960262,32,0
27,1,10,46,69,-23,0,3.48517924123735,-19,0
27,1,10,79,26,53,0,2.27885263208009,24,0
27,1,10,95,9,86,0,2.68143543902261,41,0
27,1,10,38,78,-40,0,2.96328862413793,-28,0
27,1,10,32,87,-55,0,2.74641827012238,-37,0
27,1,10,70,31,39,1,2.78626280663229,-19,0
27,1,10,2,93,-91,0,2.77609006104467,-43,0
27,1,10,27,84,-57,0,2.41460183777963,-34,0
27,1,10,85,15,70,0,1.91585988452425,35,0
27,1,10,68,39,29,1,2.10515765747186,-11,0
27,1,10,73,0,73,0,1.68858283501322,50,0
27,1,10,50,80,-30,1,1.51063631143188,30,0
27,1,10,93,16,77,0,1.71598968898616,34,0
27,1,10,9,88,-79,0,2.57661320321859,-38,0
27,1,10,89,20,69,0,3.75049684710029,30,0
27,1,10,89,19,70,0,3.7326792223721,31,0
27,1,10,32,69,-37,0,3.57954768970012,-19,0
27,1,10,23,58,-35,0,2.68922763113369,-8,0
27,1,10,3,50,-47,0,3.23437739680958,0,0
27,1,10,11,98,-87,0,2.59736471068391,-48,0
27,1,1.5,94,12,82,0,0.806325746707444,38,0
27,1,1.5,36,72,-36,0,0.978841613792611,-22,0
27,1,1.5,8,87,-79,0,0.792439084114449,-37,0
27,1,1.5,88,19,69,NaN,NaN,0,0
27,1,1.5,0,53,-53,0,0.67146766373844,-3,0
27,1,1.5,20,73,-53,0,0.737269772303989,-23,0
27,1,1.5,98,27,71,0,0.86438034004459,23,0
27,1,1.5,19,94,-75,0,0.68217773942888,-44,0
27,1,1.5,32,59,-27,0,1.01933215391546,-9,0
27,1,1.5,77,25,52,0,0.886359858108335,25,0
27,1,1.5,95,9,86,NaN,NaN,0,0
27,1,1.5,44,58,-14,0,0.997922568007198,-8,0
27,1,1.5,59,3,56,0,0.985598690775078,47,0
27,1,1.5,56,11,45,0,0.806058289137582,39,0
27,1,1.5,87,45,42,1,1.00170017975688,-5,0
27,1,1.5,91,17,74,0,0.765439453905856,33,0
27,1,1.5,97,4,93,0,0.634547953832225,46,0
27,1,1.5,27,73,-46,0,0.957035973333404,-23,0
27,1,1.5,91,44,47,0,1.02682428640765,6,0
27,1,1.5,91,45,46,1,0.837801215926447,-5,0
27,1,10,16,91,-75,0,1.06172025416527,-41,0
27,1,10,92,12,80,0,2.79524527548347,38,0
27,1,10,36,95,-59,0,2.92705657601982,-45,0
27,1,10,70,38,32,1,2.6295317660115,-12,0
27,1,10,98,12,86,0,2.32004592752492,38,0
27,1,10,89,37,52,1,2.01114511473861,-13,0
27,1,10,2,59,-57,0,2.39053729779334,-9,0
27,1,10,9,90,-81,0,2.65046198101845,-40,0
27,1,10,91,24,67,0,3.25896628644841,26,0
27,1,10,38,97,-59,0,2.77197254272687,-47,0
27,1,10,89,6,83,0,3.81308252181771,44,0
27,1,10,100,11,89,0,2.23134389669212,39,0
27,1,10,5,66,-61,0,2.63329579357014,-16,0
27,1,10,66,4,62,0,3.24254541811752,46,0
27,1,10,83,20,63,0,2.37147777640712,30,0
27,1,10,12,79,-67,0,2.46343638991675,-29,0
27,1,10,56,29,27,0,2.99999611883686,21,0
27,1,10,44,98,-54,1,3.13839152436049,48,0
27,1,10,94,18,76,0,2.80739286014068,32,0
27,1,10,71,11,60,0,3.28184779459843,39,0
27,1,1.5,100,0,100,0,0.611391743219428,50,0
27,1,1.5,84,24,60,0,0.702538324152556,26,0
27,1,1.5,9,54,-45,0,0.965015929112269,-4,0
27,1,1.5,46,87,-41,0,1.39271499406459,-37,0
27,1,1.5,70,41,29,1,1.21963553411479,-9,0
27,1,1.5,95,44,51,1,1.25322379737554,-6,0
27,1,1.5,92,15,77,0,0.997535871454602,35,0
27,1,1.5,60,11,49,0,1.36852004587126,39,0
27,1,1.5,33,100,-67,0,0.940152638868312,-50,0
27,1,1.5,34,90,-56,0,1.26514165831759,-40,0
27,1,1.5,89,22,67,0,0.0130873517518921,28,0
27,1,1.5,100,25,75,0,1.33739746367064,25,0
27,1,1.5,81,25,56,0,1.40630793632226,25,0
27,1,1.5,20,96,-76,NaN,NaN,0,0
27,1,1.5,39,72,-33,0,0.977080499284057,-22,0
27,1,1.5,62,31,31,0,1.06079652938206,19,0
27,1,1.5,40,67,-27,0,1.02910975056875,-17,0
27,1,1.5,76,43,33,1,1.21485148496868,-7,0
27,1,1.5,38,77,-39,0,1.15181511707488,-27,0
27,1,1.5,36,99,-63,0,1.06807705040774,-49,0
28,1,10,85,15,70,0,2.36379044261912,35,0
28,1,10,100,0,100,0,1.1891137075836,50,0
28,1,10,3,100,-97,1,1.31397586622552,50,0
28,1,10,3,100,-97,1,3.16274446329999,50,0
28,1,10,100,0,100,1,3.66048330656486,-50,0
28,1,10,50,43,7,1,1.90611306007304,-7,0
28,1,10,48,80,-32,1,2.28554968021672,30,0
28,1,10,85,15,70,1,2.77821227868299,-35,0
28,1,10,98,38,60,1,2.32269598298899,-12,0
28,1,10,25,55,-30,0,2.45401846007326,-5,0
28,1,10,53,0,53,0,2.15600280207991,50,0
28,1,10,30,100,-70,1,2.12602289152392,50,0
28,1,10,5,83,-78,1,2.53394818475272,33,0
28,1,10,80,45,35,1,2.01722051520392,-5,0
28,1,10,100,15,85,1,3.05313277368896,-35,0
28,1,10,98,38,60,1,2.93888556938191,-12,0
28,1,10,75,0,75,0,2.30937687779169,50,0
28,1,10,30,100,-70,1,2.41735092301496,50,0
28,1,10,50,100,-50,1,2.24000233719971,50,0
28,1,10,53,0,53,0,2.00604166783387,50,0
28,1,1.5,48,60,-12,1,1.42231517406799,10,0
28,1,1.5,48,100,-52,1,0.980524602372043,50,0
28,1,1.5,53,40,13,1,1.15765855866357,-10,0
28,1,1.5,50,43,7,0,1.21530484860705,7,0
28,1,1.5,53,40,13,0,1.26232803372704,10,0
28,1,1.5,0,68,-68,NaN,NaN,0,0
28,1,1.5,48,100,-52,1,0.961252622089432,50,0
28,1,1.5,5,83,-78,1,0.929578315598064,33,0
28,1,1.5,100,15,85,1,0.828023232636497,-35,0
28,1,1.5,48,80,-32,1,0.7458448788243,30,0
28,1,1.5,28,85,-57,1,1.00361282235053,35,0
28,1,1.5,50,100,-50,1,0.762036880176311,50,0
28,1,1.5,53,23,30,1,1.06711206843056,-27,0
28,1,1.5,75,0,75,0,0.734928658295757,50,0
28,1,1.5,0,68,-68,0,0.839300791475125,-18,0
28,1,1.5,53,23,30,0,0.741110350790223,27,0
28,1,1.5,80,45,35,1,0.998952856190044,-5,0
28,1,1.5,28,85,-57,0,0.916687261966217,-35,0
28,1,1.5,25,55,-30,0,1.0304158537283,-5,0
28,1,1.5,48,60,-12,0,0.892782483818337,-10,0
28,1,10,42,83,-41,0,1.55756769581421,-33,0
28,1,10,29,86,-57,0,1.389710806312,-36,0
28,1,10,46,71,-25,1,1.57587580539894,21,0
28,1,10,15,93,-78,1,1.70725050598185,43,0
28,1,10,2,95,-93,1,3.34589015931397,45,0
28,1,10,97,32,65,1,2.0742552166621,-18,0
28,1,10,16,98,-82,1,2.72561959329278,48,0
28,1,10,2,86,-84,0,1.73480368414357,-36,0
28,1,10,83,45,38,1,3.59613580597261,-5,0
28,1,10,60,1,59,0,2.21839267615451,49,0
28,1,10,43,95,-52,1,2.94171771309584,45,0
28,1,10,15,50,-35,0,2.28619175756467,0,0
28,1,10,49,57,-8,0,3.00085101433069,-7,0
28,1,10,46,91,-45,1,2.01394945260654,41,0
28,1,10,16,100,-84,1,2.30869797231207,50,0
28,1,10,26,69,-43,0,1.91668243204776,-19,0
28,1,10,93,33,60,1,2.83748021390738,-17,0
28,1,10,42,88,-46,1,4.03389460283961,38,0
28,1,10,38,57,-19,0,2.20602687620658,-7,0
28,1,10,21,58,-37,0,2.40402215797985,-8,0
28,1,1.5,95,44,51,1,1.02443792343911,-6,0
28,1,1.5,8,99,-91,1,0.96483129014905,49,0
28,1,1.5,71,6,65,0,0.867814519764579,44,0
28,1,1.5,42,79,-37,1,0.935592470279516,29,0
28,1,1.5,23,96,-73,1,0.943317623742132,46,0
28,1,1.5,28,83,-55,1,0.663050408477375,33,0
28,1,1.5,3,91,-88,1,1.13094035273753,41,0
28,1,1.5,37,90,-53,0,1.12323814138927,-40,0
28,1,1.5,78,24,54,0,1.09963825187378,26,0
28,1,1.5,11,97,-86,0,1.44458683587709,-47,0
28,1,1.5,3,75,-72,0,1.09419251827694,-25,0
28,1,1.5,33,86,-53,1,1.08787347496309,36,0
28,1,1.5,31,99,-68,1,1.01754442164201,49,0
28,1,1.5,39,97,-58,1,1.01390900203523,47,0
28,1,1.5,16,52,-36,0,1.08296265488798,-2,0
28,1,1.5,50,60,-10,0,1.41268854189502,-10,0
28,1,1.5,84,36,48,NaN,NaN,0,0
28,1,1.5,76,19,57,1,0.738745199862933,-31,0
28,1,1.5,39,95,-56,1,0.699243707870664,45,0
28,1,1.5,46,100,-54,1,0.548371832035627,50,0
28,1,10,29,75,-46,1,3.08751726844184,25,0
28,1,10,43,50,-7,0,1.55392020140971,0,0
28,1,10,62,44,18,1,2.47346975109531,-6,0
28,1,10,39,95,-56,1,1.96336299479344,45,0
28,1,10,46,90,-44,1,1.87416073137274,40,0
28,1,10,71,34,37,0,2.18824552965589,16,0
28,1,10,38,95,-57,1,2.06563169827723,45,0
28,1,10,41,100,-59,1,2.00368285617469,50,0
28,1,10,84,20,64,1,2.56042398912314,-30,0
28,1,10,5,64,-59,0,1.65493222036139,-14,0
28,1,10,1,95,-94,1,1.78098435028005,45,0
28,1,10,35,88,-53,1,1.84371533737976,38,0
28,1,10,73,35,38,1,2.50319186472825,-15,0
28,1,10,40,93,-53,1,1.95987941576277,43,0
28,1,10,72,45,27,1,2.29452366959322,-5,0
28,1,10,39,50,-11,0,1.67184689833402,0,0
28,1,10,48,60,-12,1,2.01452330734946,10,0
28,1,10,73,48,25,1,2.21059658325703,-2,0
28,1,10,32,99,-67,1,2.64381887876652,49,0
28,1,10,4,97,-93,1,2.79096718897472,47,0
28,1,1.5,12,99,-87,1,0.804585447275258,49,0
28,1,1.5,19,57,-38,0,1.25767953862442,-7,0
28,1,1.5,60,39,21,NaN,NaN,0,0
28,1,1.5,18,99,-81,1,0.629824188658858,49,0
28,1,1.5,53,29,24,0,1.01767120701425,21,0
28,1,1.5,84,41,43,0,0.805342235198168,9,0
28,1,1.5,84,45,39,0,0.745830087197646,5,0
28,1,1.5,7,100,-93,1,0.872979816193492,50,0
28,1,1.5,76,6,70,0,0.896696227503526,44,0
28,1,1.5,34,62,-28,0,0.785132646903548,-12,0
28,1,1.5,72,6,66,0,0.659589771562423,44,0
28,1,1.5,43,95,-52,1,0.723967459147843,45,0
28,1,1.5,13,72,-59,0,0.787146421228499,-22,0
28,1,1.5,29,93,-64,1,0.790873307425045,43,0
28,1,1.5,48,76,-28,0,0.689936152217342,-26,0
28,1,1.5,29,94,-65,1,0.786452120382364,44,0
28,1,1.5,7,90,-83,0,0.966206307695302,-40,0
28,1,1.5,98,38,60,0,0.826520825978605,12,0
28,1,1.5,88,19,69,1,0.812279810005293,-31,0
28,1,1.5,22,74,-52,0,0.911376162360284,-24,0
28,1,10,92,50,42,1,2.16976897664836,0,0
28,1,10,73,2,71,0,2.05826637377459,48,0
28,1,10,4,60,-56,0,1.77831038641079,-10,0
28,1,10,49,97,-48,1,1.79848978771224,47,0
28,1,10,28,56,-28,0,2.61727485179154,-6,0
28,1,10,97,17,80,1,2.85905938608948,-33,0
28,1,10,26,86,-60,1,4.52347329806707,36,0
28,1,10,84,13,71,0,3.56809691908757,37,0
28,1,10,48,99,-51,1,2.89900100444447,49,0
28,1,10,20,98,-78,0,3.11282694925967,-48,0
28,1,10,48,97,-49,1,1.74848986317966,47,0
28,1,10,44,85,-41,1,3.92055331020219,35,0
28,1,10,15,51,-36,0,1.60604800710234,-1,0
28,1,10,29,98,-69,1,1.72024178043102,48,0
28,1,10,36,96,-60,1,2.21376682129676,46,0
28,1,10,70,15,55,1,1.62364249616485,-35,0
28,1,10,79,11,68,0,2.50973398992255,39,0
28,1,10,8,63,-55,0,2.002325045215,-13,0
28,1,10,76,2,74,1,1.64426625000806,-48,0
28,1,10,20,98,-78,1,1.79367375479615,48,0
28,1,1.5,42,88,-46,1,0.758878113194442,38,0
28,1,1.5,95,4,91,0,1.01859372153058,46,0
28,1,1.5,50,100,-50,1,0.771633023486629,50,0
28,1,1.5,21,100,-79,1,0.638775537791389,50,0
28,1,1.5,34,55,-21,0,0.983242639250875,-5,0
28,1,1.5,33,84,-51,0,1.06630064204955,-34,0
28,1,1.5,89,32,57,1,0.912482213795556,-18,0
28,1,1.5,15,85,-70,0,0.926924878884165,-35,0
28,1,1.5,48,70,-22,1,0.868664283626913,20,0
28,1,1.5,88,1,87,0,0.780380006673568,49,0
28,1,1.5,65,23,42,0,0.781441985098809,27,0
28,1,1.5,62,27,35,0,1.12057776166694,23,0
28,1,1.5,2,98,-96,1,0.829576655313758,48,0
28,1,1.5,86,48,38,1,1.08599312714841,-2,0
28,1,1.5,75,35,40,0,0.74823810365524,15,0
28,1,1.5,48,91,-43,1,0.632772854167342,41,0
28,1,1.5,38,90,-52,0,0.77525184024671,-40,0
28,1,1.5,30,94,-64,1,0.962317619214446,44,0
28,1,1.5,11,63,-52,0,0.845345435019681,-13,0
28,1,1.5,16,92,-76,0,0.837677636844091,-42,0
29,1,10,48,80,-32,0,3.0021285340672,-30,0
29,1,10,25,55,-30,0,3.27325654994638,-5,0
29,1,10,48,60,-12,1,2.9823034682222,10,0
29,1,10,5,83,-78,0,2.60676376088668,-33,0
29,1,10,48,60,-12,1,3.03865339690492,10,0
29,1,10,50,43,7,1,2.30909073229122,-7,0
29,1,10,100,15,85,0,2.41708049886984,35,0
29,1,10,30,100,-70,0,2.3370355201132,-50,0
29,1,10,100,15,85,0,2.6037142616151,35,0
29,1,10,48,100,-52,0,2.74763662043279,-50,0
29,1,10,53,40,13,1,2.6681905534324,-10,0
29,1,10,28,85,-57,0,2.31342076768578,-35,0
29,1,10,25,55,-30,0,2.39607270305532,-5,0
29,1,10,80,45,35,1,2.76397024809103,-5,0
29,1,10,0,68,-68,0,2.54912152311772,-18,0
29,1,10,100,0,100,0,2.79838956178719,50,0
29,1,10,80,45,35,1,3.12630642655586,-5,0
29,1,10,53,23,30,1,2.73667116200431,-27,0
29,1,10,75,0,75,0,2.76323066452187,50,0
29,1,10,48,80,-32,0,2.74105674163366,-30,0
29,1,1.5,85,15,70,0,0.766584147733738,35,0
29,1,1.5,3,100,-97,0,0.551642144669131,-50,0
29,1,1.5,53,23,30,1,1.09021897457296,-27,0
29,1,1.5,100,0,100,0,0.542523833938503,50,0
29,1,1.5,53,40,13,1,0.945140148549399,-10,0
29,1,1.5,0,68,-68,0,0.659000397441559,-18,0
29,1,1.5,85,15,70,0,0.848773315097787,35,0
29,1,1.5,98,38,60,1,0.781847341376306,-12,0
29,1,1.5,5,83,-78,0,0.646293446110576,-33,0
29,1,1.5,53,0,53,0,0.676150585733012,50,0
29,1,1.5,48,100,-52,0,0.568730147568203,-50,0
29,1,1.5,50,100,-50,0,0.745860110513604,-50,0
29,1,1.5,28,85,-57,0,0.83494491358033,-35,0
29,1,1.5,3,100,-97,0,0.51282427089609,-50,0
29,1,1.5,75,0,75,0,0.644036055934521,50,0
29,1,1.5,50,43,7,1,0.825855884320845,-7,0
29,1,1.5,98,38,60,0,0.672287242664424,12,0
29,1,1.5,50,100,-50,0,0.564817599551134,-50,0
29,1,1.5,30,100,-70,0,0.469341285092014,-50,0
29,1,1.5,53,0,53,0,0.82580999995298,50,0
29,1,10,59,27,32,1,2.04422502708348,-23,0
29,1,10,82,46,36,1,1.95296886703181,-4,0
29,1,10,94,40,54,1,2.30886161232047,-10,0
29,1,10,50,75,-25,0,2.07157995927537,-25,0
29,1,10,94,10,84,0,1.87436894400889,40,0
29,1,10,98,34,64,0,1.84708132901415,16,0
29,1,10,45,83,-38,0,1.99653124486758,-33,0
29,1,10,17,92,-75,0,2.24395243771141,-42,0
29,1,10,98,8,90,0,1.96131680336748,42,0
29,1,10,88,24,64,0,1.8494419590188,26,0
29,1,10,98,39,59,0,2.90263552615124,11,0
29,1,10,98,4,94,0,3.08116013239851,46,0
29,1,10,96,35,61,0,2.58019912656528,15,0
29,1,10,23,63,-40,0,2.65950059743045,-13,0
29,1,10,92,23,69,0,2.92728992176853,27,0
29,1,10,82,36,46,0,3.41640913811079,14,0
29,1,10,100,31,69,0,3.18943033699179,19,0
29,1,10,8,55,-47,0,3.11514686517512,-5,0
29,1,10,39,60,-21,0,3.0368916786565,-10,0
29,1,10,21,66,-45,0,3.21726765879339,-16,0
29,1,1.5,96,32,64,0,0.86471330317454,18,0
29,1,1.5,83,21,62,0,0.645130337746195,29,0
29,1,1.5,87,48,39,0,0.554307362355758,2,0
29,1,1.5,24,71,-47,0,0.562842760486092,-21,0
29,1,1.5,9,52,-43,0,0.762696654996944,-2,0
29,1,1.5,41,91,-50,0,0.650441151514315,-41,0
29,1,1.5,17,83,-66,0,0.574327436766907,-33,0
29,1,1.5,25,82,-57,0,0.445516732426768,-32,0
29,1,1.5,99,29,70,0,0.658076068915761,21,0
29,1,1.5,40,62,-22,0,0.541903187482603,-12,0
29,1,1.5,27,85,-58,0,0.716460305219698,-35,0
29,1,1.5,74,18,56,0,0.605591898267448,32,0
29,1,1.5,97,27,70,0,0.42740538736598,23,0
29,1,1.5,93,13,80,0,0.52865528359871,37,0
29,1,1.5,20,94,-74,0,0.450507563100473,-44,0
29,1,1.5,36,99,-63,0,0.495138563726869,-49,0
29,1,1.5,53,42,11,1,0.865630688671445,-8,0
29,1,1.5,82,22,60,0,0.684760545961581,28,0
29,1,1.5,40,72,-32,0,0.703163800129914,-22,0
29,1,1.5,25,52,-27,0,0.513054296480732,-2,0
29,1,10,12,53,-41,0,3.11280464929132,-3,0
29,1,10,61,47,14,1,3.34442652587222,-3,0
29,1,10,96,5,91,0,3.11952127558379,45,0
29,1,10,100,7,93,0,3.31252813559786,43,0
29,1,10,34,50,-16,0,4.08214453322216,0,0
29,1,10,60,10,50,0,3.85160244865347,40,0
29,1,10,7,88,-81,0,3.95043345380782,-38,0
29,1,10,94,40,54,0,3.75716849422042,10,0
29,1,10,97,35,62,0,4.13145906000227,15,0
29,1,10,25,72,-47,0,3.97078498240717,-22,0
29,1,10,51,29,22,1,4.12691167759931,-21,0
29,1,10,3,79,-76,0,3.53507517084927,-29,0
29,1,10,78,20,58,0,3.71860298447427,30,0
29,1,10,87,9,78,0,3.76678972177797,41,0
29,1,10,64,15,49,0,3.6530146004643,35,0
29,1,10,99,13,86,0,3.96778559369523,37,0
29,1,10,49,63,-14,0,3.78200552169801,-13,0
29,1,10,97,0,97,0,4.05223607555581,50,0
29,1,10,63,20,43,0,4.29491729239726,30,0
29,1,10,95,29,66,0,4.13559921863634,21,0
29,1,1.5,49,58,-9,0,0.725500129530701,-8,0
29,1,1.5,69,36,33,0,0.925203390491333,14,0
29,1,1.5,40,93,-53,0,0.757675939110413,-43,0
29,1,1.5,91,19,72,0,0.700107659698915,31,0
29,1,1.5,17,57,-40,0,0.837258753603237,-7,0
29,1,1.5,94,31,63,0,0.68101372503952,19,0
29,1,1.5,32,95,-63,0,0.675475300653488,-45,0
29,1,1.5,73,12,61,0,0.581975334614981,38,0
29,1,1.5,74,6,68,0,0.651853303325879,44,0
29,1,1.5,46,75,-29,0,0.622301958867865,-25,0
29,1,1.5,96,20,76,0,0.671533471166185,30,0
29,1,1.5,57,25,32,0,0.8886546798567,25,0
29,1,1.5,39,79,-40,0,0.737666732050457,-29,0
29,1,1.5,98,34,64,0,0.920117772372578,16,0
29,1,1.5,50,42,8,1,0.799190727008863,-8,0
29,1,1.5,98,23,75,0,0.754292570684811,27,0
29,1,1.5,67,13,54,0,0.808053655005097,37,0
29,1,1.5,13,57,-44,0,0.779819674913597,-7,0
29,1,1.5,67,39,28,0,1.10492370715292,11,0
29,1,1.5,88,23,65,0,1.12862720960948,27,0
29,1,10,81,26,55,0,3.32400737820444,24,0
29,1,10,72,47,25,1,3.05762960193624,-3,0
29,1,10,84,49,35,0,2.7700447950956,1,0
29,1,10,34,99,-65,0,4.17449406947344,-49,0
29,1,10,27,90,-63,0,3.80186379333736,-40,0
29,1,10,68,15,53,0,3.25271605019952,35,0
29,1,10,100,32,68,0,4.06975545189107,18,0
29,1,10,85,17,68,0,4.06973613215723,33,0
29,1,10,66,5,61,0,4.14985597488158,45,0
29,1,10,78,12,66,0,3.47390738348713,38,0
29,1,10,100,20,80,0,4.24748311910935,30,0
29,1,10,24,80,-56,0,3.8242019339632,-30,0
29,1,10,38,80,-42,0,3.15367554667864,-30,0
29,1,10,16,72,-56,0,3.43805629637427,-22,0
29,1,10,95,22,73,0,3.98300229922734,28,0
29,1,10,85,17,68,0,3.82569257219347,33,0
29,1,10,37,67,-30,0,2.81919359478161,-17,0
29,1,10,49,72,-23,0,2.88499147715811,-22,0
29,1,10,33,91,-58,0,3.91613851089915,-41,0
29,1,10,100,37,63,0,4.05756952963748,13,0
29,1,1.5,95,29,66,0,0.726836511759757,21,0
29,1,1.5,37,67,-30,0,0.533302585250567,-17,0
29,1,1.5,20,90,-70,0,0.4991935947819,-40,0
29,1,1.5,32,54,-22,0,0.554393093675571,-4,0
29,1,1.5,81,21,60,0,0.775517411636429,29,0
29,1,1.5,70,48,22,1,0.915861091592888,-2,0
29,1,1.5,40,59,-19,0,0.601631654657467,-9,0
29,1,1.5,77,24,53,0,1.09212166650559,26,0
29,1,1.5,59,18,41,0,0.7151631662,32,0
29,1,1.5,10,64,-54,0,0.488912175686892,-14,0
29,1,1.5,2,74,-72,0,0.573414579333985,-24,0
29,1,1.5,97,31,66,0,0.513216401123827,19,0
29,1,1.5,98,18,80,0,0.511753233140553,32,0
29,1,1.5,8,50,-42,0,0.486833794921949,0,0
29,1,1.5,91,21,70,0,0.582155249637253,29,0
29,1,1.5,48,100,-52,0,0.473321452177515,-50,0
29,1,1.5,62,14,48,0,0.481151981884977,36,0
29,1,1.5,93,27,66,0,0.513006902758207,23,0
29,1,1.5,1,58,-57,0,0.423510951601202,-8,0
29,1,1.5,11,71,-60,0,0.441368725152643,-21,0
30,1,10,53,23,30,0,3.91722283162744,27,0
30,1,10,3,100,-97,0,3.20737233316322,-50,0
30,1,10,48,60,-12,1,3.91838141192602,10,0
30,1,10,5,83,-78,0,3.30524489838535,-33,0
30,1,10,98,38,60,0,5.36491299139198,12,0
30,1,10,30,100,-70,0,5.80595625703063,-50,0
30,1,10,28,85,-57,0,4.59688956621358,-35,0
30,1,10,48,100,-52,1,6.19680866482668,50,0
30,1,10,100,15,85,0,4.68430532537968,35,0
30,1,10,53,40,13,0,5.30425747885238,10,0
30,1,10,28,85,-57,0,5.37924430973726,-35,0
30,1,10,48,60,-12,1,3.97970949270893,10,0
30,1,10,48,80,-32,1,3.2124461783169,30,0
30,1,10,98,38,60,0,8.14814346223466,12,0
30,1,10,100,0,100,0,3.52498755349006,50,0
30,1,10,50,100,-50,1,3.56795856634199,50,0
30,1,10,30,100,-70,1,3.66489835065477,50,0
30,1,10,75,0,75,0,3.49448139155174,50,0
30,1,10,100,15,85,0,3.5387752024435,35,0
30,1,10,25,55,-30,0,3.94104828990203,-5,0
30,1,1.5,80,45,35,1,1.00141310081926,-5,0
30,1,1.5,50,43,7,1,1.03386210351346,-7,0
30,1,1.5,25,55,-30,0,0.680885732454044,-5,0
30,1,1.5,5,83,-78,0,0.918788937566205,-33,0
30,1,1.5,50,100,-50,1,0.762540286554213,50,0
30,1,1.5,80,45,35,1,0.661026253332238,-5,0
30,1,1.5,85,15,70,1,0.547545154218824,-35,0
30,1,1.5,75,0,75,0,0.597442593600135,50,0
30,1,1.5,48,100,-52,1,0.605313272129933,50,0
30,1,1.5,53,0,53,0,0.524441167261102,50,0
30,1,1.5,48,80,-32,1,0.7590120201221,30,0
30,1,1.5,85,15,70,0,0.648069051070706,35,0
30,1,1.5,53,23,30,0,0.741373102931902,27,0
30,1,1.5,53,0,53,0,0.511791269520472,50,0
30,1,1.5,0,68,-68,0,0.475712873661905,-18,0
30,1,1.5,0,68,-68,0,0.416928960359655,-18,0
30,1,1.5,3,100,-97,0,0.496197225431388,-50,0
30,1,1.5,100,0,100,0,0.772768878250645,50,0
30,1,1.5,50,43,7,1,0.829861409210935,-7,0
30,1,1.5,53,40,13,0,1.08499449651936,10,0
30,1,10,35,96,-61,0,3.22378776781807,-46,0
30,1,10,88,10,78,0,2.69344929513318,40,0
30,1,10,95,41,54,1,2.08133944433393,-9,0
30,1,10,87,19,68,0,2.41335360207631,31,0
30,1,10,24,87,-63,0,2.87671689608942,-37,0
30,1,10,16,76,-60,0,2.0092107266064,-26,0
30,1,10,46,71,-25,1,2.67271861675363,21,0
30,1,10,99,7,92,0,2.7164403823972,43,0
30,1,10,79,20,59,0,2.77434464405815,30,0
30,1,10,47,66,-19,1,3.02221290762282,16,0
30,1,10,31,65,-34,0,3.4092394043364,-15,0
30,1,10,64,22,42,0,2.80693371482448,28,0
30,1,10,88,6,82,0,3.3406960066277,44,0
30,1,10,12,85,-73,0,3.01303995826856,-35,0
30,1,10,24,78,-54,0,2.56348665165024,-28,0
30,1,10,44,70,-26,1,2.83605579893992,20,0
30,1,10,100,25,75,0,3.4485620061605,25,0
30,1,10,48,72,-24,1,3.34948708936463,22,0
30,1,10,45,57,-12,1,5.70981854355159,7,0
30,1,10,85,23,62,0,3.12676708211802,27,0
30,1,1.5,90,25,65,1,0.978677094419254,-25,0
30,1,1.5,18,70,-52,0,0.643096936390066,-20,0
30,1,1.5,46,89,-43,1,0.960972671256968,39,0
30,1,1.5,10,84,-74,0,0.737352787024065,-34,0
30,1,1.5,46,78,-32,1,0.979160087770651,28,0
30,1,1.5,7,71,-64,0,0.682216681008867,-21,0
30,1,1.5,76,6,70,0,0.717357466022804,44,0
30,1,1.5,100,12,88,0,0.671208055047828,38,0
30,1,1.5,93,22,71,0,0.898370393641017,28,0
30,1,1.5,7,79,-72,0,0.604775036414139,-29,0
30,1,1.5,93,14,79,0,0.729933707278178,36,0
30,1,1.5,81,41,40,NaN,NaN,0,0
30,1,1.5,6,78,-72,0,0.606997107701318,-28,0
30,1,1.5,81,36,45,0,0.932849779635944,14,0
30,1,1.5,47,68,-21,1,0.637225246593516,18,0
30,1,1.5,64,19,45,0,0.713734714017846,31,0
30,1,1.5,94,17,77,0,0.683545818335915,33,0
30,1,1.5,87,15,72,0,0.685988557210294,35,0
30,1,1.5,41,99,-58,1,0.696483398991404,49,0
30,1,1.5,8,68,-60,0,0.506280919124038,-18,0
30,1,10,27,85,-58,0,2.02518301486089,-35,0
30,1,10,43,85,-42,1,2.84586750700146,35,0
30,1,10,35,86,-51,0,3.15305610835821,-36,0
30,1,10,45,69,-24,1,3.10407394137837,19,0
30,1,10,41,99,-58,1,2.61644868384428,49,0
30,1,10,78,6,72,0,2.23633291637634,44,0
30,1,10,49,98,-49,1,2.90366641573928,48,0
30,1,10,11,85,-74,0,2.31213660976573,-35,0
30,1,10,9,77,-68,0,4.41324794728098,-27,0
30,1,10,46,67,-21,1,3.7059065992762,17,0
30,1,10,70,36,34,0,3.8167659501014,14,0
30,1,10,70,27,43,0,3.45232120378751,23,0
30,1,10,24,85,-61,0,3.02256066283371,-35,0
30,1,10,45,93,-48,1,4.73029595229127,43,0
30,1,10,85,15,70,0,5.32021527730831,35,0
30,1,10,87,15,72,0,3.65519350487375,35,0
30,1,10,38,56,-18,0,3.24141823262289,-6,0
30,1,10,54,0,54,0,3.48449852272097,50,0
30,1,10,78,13,65,0,3.48471254915057,37,0
30,1,10,73,39,34,0,5.92565287683101,11,0
30,1,1.5,18,75,-57,0,0.680147054497866,-25,0
30,1,1.5,10,100,-90,0,0.601958883305997,-50,0
30,1,1.5,96,48,48,1,0.93447535413361,-2,0
30,1,1.5,49,97,-48,1,0.661526151450744,47,0
30,1,1.5,68,11,57,0,0.744014472822528,39,0
30,1,1.5,94,19,75,0,0.77512347083757,31,0
30,1,1.5,1,65,-64,0,0.620935692079001,-15,0
30,1,1.5,29,63,-34,0,0.480721514713878,-13,0
30,1,1.5,100,13,87,0,0.650660008528575,37,0
30,1,1.5,30,84,-54,0,0.940419191063484,-34,0
30,1,1.5,13,56,-43,0,0.440834716280733,-6,0
30,1,1.5,72,12,60,0,0.515369344639112,38,0
30,1,1.5,87,22,65,0,0.73053261903442,28,0
30,1,1.5,85,15,70,0,0.449666853452072,35,0
30,1,1.5,66,1,65,0,0.387521910164651,49,0
30,1,1.5,87,1,86,0,0.368783579358933,49,0
30,1,1.5,39,99,-60,0,0.422037520660524,-49,0
30,1,1.5,80,31,49,0,0.921263674750662,19,0
30,1,1.5,58,40,18,NaN,NaN,0,0
30,1,1.5,22,68,-46,0,0.497462668010485,-18,0
30,1,10,50,15,35,0,0.654287892339198,35,0
30,1,10,99,4,95,0,3.69994766880336,46,0
30,1,10,72,19,53,0,3.42611277706419,31,0
30,1,10,3,64,-61,0,3.85172500886983,-14,0
30,1,10,47,74,-27,1,5.10851446150264,24,0
30,1,10,84,22,62,0,3.89159158195616,28,0
30,1,10,92,16,76,0,4.37840299569143,34,0
30,1,10,52,35,17,0,4.50975967873637,15,0
30,1,10,86,48,38,1,2.92372271465138,-2,0
30,1,10,27,57,-30,0,2.76143423177746,-7,0
30,1,10,45,68,-23,1,3.84388180058522,18,0
30,1,10,47,79,-32,1,4.13273808742269,29,0
30,1,10,83,24,59,0,3.37008222773329,26,0
30,1,10,3,92,-89,0,3.2056797433379,-42,0
30,1,10,3,82,-79,0,3.24806784358771,-32,0
30,1,10,26,58,-32,0,3.81637563110053,-8,0
30,1,10,44,81,-37,1,3.39386693344568,31,0
30,1,10,36,69,-33,0,3.10883172776084,-19,0
30,1,10,87,4,83,0,2.97918544492313,46,0
30,1,10,14,95,-81,0,3.03095599289372,-45,0
30,1,1.5,94,13,81,0,0.816954015637748,37,0
30,1,1.5,8,91,-83,0,0.731487436514726,-41,0
30,1,1.5,35,70,-35,0,0.64185775657279,-20,0
30,1,1.5,93,11,82,0,1.01104429011502,39,0
30,1,1.5,99,24,75,0,0.630039814879638,26,0
30,1,1.5,69,6,63,0,0.471877302710709,44,0
30,1,1.5,37,83,-46,0,0.503702640238771,-33,0
30,1,1.5,32,78,-46,0,0.454231140620323,-28,0
30,1,1.5,31,93,-62,0,0.447419123142026,-43,0
30,1,1.5,91,23,68,0,1.00059382334621,27,0
30,1,1.5,65,2,63,0,0.480291348760147,48,0
30,1,1.5,29,59,-30,0,0.752151099566618,-9,0
30,1,1.5,0,62,-62,0,0.565249879255134,-12,0
30,1,1.5,79,25,54,0,0.665107547149091,25,0
30,1,1.5,48,54,-6,0,0.432266414229161,-4,0
30,1,1.5,99,29,70,0,0.617417689256399,21,0
30,1,1.5,47,74,-27,0,0.419227404969206,-24,0
30,1,1.5,81,48,33,1,0.66117115133784,-2,0
30,1,1.5,28,81,-53,0,0.445622689745505,-31,0
30,1,1.5,45,50,-5,0,0.918781692667835,0,0
31,1,10,75,0,75,0,3.62777940564411,50,0
31,1,10,98,38,60,0,3.02599504708269,12,0
31,1,10,100,15,85,0,3.936494869733,35,0
31,1,10,53,0,53,0,3.22594523839507,50,0
31,1,10,53,40,13,0,3.23307059780927,10,0
31,1,10,0,68,-68,0,3.12736478603983,-18,0
31,1,10,98,38,60,0,3.49856057192301,12,0
31,1,10,25,55,-30,0,3.03876056135778,-5,0
31,1,10,48,100,-52,1,3.50925978026498,50,0
31,1,10,85,15,70,0,3.46481292085446,35,0
31,1,10,30,100,-70,0,3.8784505399999,-50,0
31,1,10,0,68,-68,0,3.45127069289447,-18,0
31,1,10,100,15,85,0,3.7002471243286,35,0
31,1,10,25,55,-30,0,3.74379893668811,-5,0
31,1,10,80,45,35,1,3.89002426817751,-5,0
31,1,10,75,0,75,0,3.63887587601857,50,0
31,1,10,28,85,-57,0,4.04443241265471,-35,0
31,1,10,100,0,100,0,4.40254511613603,50,0
31,1,10,48,60,-12,1,4.12994427240483,10,0
31,1,10,80,45,35,1,4.38873965679886,-5,0
31,1,1.5,50,43,7,0,1.39782687483239,7,0
31,1,1.5,50,100,-50,NaN,NaN,0,0
31,1,1.5,85,15,70,0,0.852040161680634,35,0
31,1,1.5,53,0,53,0,1.3144332428019,50,0
31,1,1.5,5,83,-78,0,0.974108882579458,-33,0
31,1,1.5,48,80,-32,1,0.84786740099662,30,0
31,1,1.5,50,43,7,0,1.1189812289449,7,0
31,1,1.5,30,100,-70,0,0.91465089167832,-50,0
31,1,1.5,3,100,-97,0,0.982463158201426,-50,0
31,1,1.5,53,23,30,0,1.0388248598465,27,0
31,1,1.5,50,100,-50,1,0.669272458842897,50,0
31,1,1.5,53,40,13,0,0.986490417140885,10,0
31,1,1.5,48,80,-32,1,0.842827063501318,30,0
31,1,1.5,28,85,-57,0,1.00122986486531,-35,0
31,1,1.5,5,83,-78,0,0.82501758928629,-33,0
31,1,1.5,100,0,100,0,0.784128277777199,50,0
31,1,1.5,53,23,30,0,0.840575107005861,27,0
31,1,1.5,48,60,-12,1,0.871024215350189,10,0
31,1,1.5,48,100,-52,1,0.748142556269158,50,0
31,1,1.5,3,100,-97,0,0.821960543242312,-50,0
31,1,10,41,79,-38,1,1.94004788957318,29,0
31,1,10,7,64,-57,0,2.99015844977112,-14,0
31,1,10,1,98,-97,0,2.58994774391977,-48,0
31,1,10,65,17,48,0,4.23786611804462,33,0
31,1,10,14,76,-62,0,3.79521750325512,-26,0
31,1,10,98,40,58,0,5.47478462046274,10,0
31,1,10,49,53,-4,1,3.89303663733881,3,0
31,1,10,80,16,64,0,3.28057933319724,34,0
31,1,10,9,84,-75,0,3.16490121807874,-34,0
31,1,10,13,97,-84,0,3.54996917675089,-47,0
31,1,10,86,28,58,0,3.50027067025803,22,0
31,1,10,49,95,-46,1,4.22120163993895,45,0
31,1,10,2,82,-80,0,3.3865873176801,-32,0
31,1,10,96,39,57,0,4.17753964472649,11,0
31,1,10,0,52,-52,0,3.56030312137227,-2,0
31,1,10,72,19,53,0,4.54389191290829,31,0
31,1,10,84,24,60,0,4.52852729066217,26,0
31,1,10,83,19,64,0,4.62579520858344,31,0
31,1,10,43,69,-26,1,3.79838110970377,19,0
31,1,10,86,11,75,0,5.12524082277741,39,0
31,1,1.5,66,14,52,0,0.681921149098343,36,0
31,1,1.5,48,72,-24,1,0.65375841052446,22,0
31,1,1.5,96,3,93,0,0.650931390067853,47,0
31,1,1.5,40,72,-32,1,0.968020147640345,22,0
31,1,1.5,36,95,-59,0,0.951808475805592,-45,0
31,1,1.5,51,50,1,1,1.00816353629489,0,0
31,1,1.5,22,65,-43,0,1.16726456491961,-15,0
31,1,1.5,37,97,-60,1,0.638952551213151,47,0
31,1,1.5,90,45,45,1,1.33217268297813,-5,0
31,1,1.5,81,22,59,0,1.16512188566412,28,0
31,1,1.5,96,7,89,0,0.898763127257553,43,0
31,1,1.5,57,31,26,0,1.12513667733583,19,0
31,1,1.5,57,44,13,1,0.902876419386303,-6,0
31,1,1.5,22,65,-43,0,0.977310222886445,-15,0
31,1,1.5,21,77,-56,0,0.905016381802852,-27,0
31,1,1.5,86,16,70,0,0.978838293096487,34,0
31,1,1.5,8,80,-72,0,0.993812596345379,-30,0
31,1,1.5,82,36,46,0,0.77622741216328,14,0
31,1,1.5,64,27,37,0,0.792038803261676,23,0
31,1,1.5,50,38,12,0,1.36646702214784,12,0
31,1,10,45,75,-30,1,2.81119220647815,25,0
31,1,10,89,49,40,1,2.98439030166992,-1,0
31,1,10,74,48,26,1,2.61484725866467,-2,0
31,1,10,40,67,-27,1,2.49201420079044,17,0
31,1,10,10,65,-55,0,2.40669523650649,-15,0
31,1,10,49,62,-13,1,2.84389357319742,12,0
31,1,10,72,43,29,1,2.99974013225074,-7,0
31,1,10,87,35,52,0,2.59686511432665,15,0
31,1,10,36,57,-21,0,2.72274827521323,-7,0
31,1,10,29,93,-64,0,2.86724781108569,-43,0
31,1,10,15,74,-59,0,3.60370762075763,-24,0
31,1,10,36,78,-42,0,2.70458712146501,-28,0
31,1,10,47,77,-30,1,2.40180674005023,27,0
31,1,10,34,86,-52,0,2.83107009972446,-36,0
31,1,10,83,20,63,0,3.2195561419685,30,0
31,1,10,84,22,62,0,3.99190175389595,28,0
31,1,10,89,38,51,0,3.94135227349034,12,0
31,1,10,90,21,69,0,3.78881331328739,29,0
31,1,10,6,100,-94,0,2.58636906505853,-50,0
31,1,10,79,35,44,0,3.94355955311039,15,0
31,1,1.5,40,78,-38,1,0.924326154115988,28,0
31,1,1.5,95,24,71,0,0.789412526912201,26,0
31,1,1.5,40,84,-44,1,0.826561960526305,34,0
31,1,1.5,74,5,69,0,0.678342168364907,45,0
31,1,1.5,64,45,19,1,0.832126345805591,-5,0
31,1,1.5,0,56,-56,0,0.859215933523956,-6,0
31,1,1.5,70,13,57,0,0.733641888382408,37,0
31,1,1.5,49,82,-33,1,0.773452917233953,32,0
31,1,1.5,18,57,-39,0,1.07585565822228,-7,0
31,1,1.5,18,56,-38,0,0.868854971464316,-6,0
31,1,1.5,83,27,56,0,1.02859596627968,23,0
31,1,1.5,86,45,41,1,1.07166025722108,-5,0
31,1,1.5,40,95,-55,1,1.04065178219753,45,0
31,1,1.5,92,37,55,0,1.18044364224988,13,0
31,1,1.5,0,64,-64,0,1.04135604688054,-14,0
31,1,1.5,13,99,-86,0,0.963682263605733,-49,0
31,1,1.5,87,24,63,0,1.11345669061848,26,0
31,1,1.5,91,48,43,1,1.09711038438763,-2,0
31,1,1.5,73,31,42,0,0.953426805404888,19,0
31,1,1.5,44,89,-45,1,1.11915903086992,39,0
31,1,10,25,99,-74,0,4.27378331487125,-49,0
31,1,10,64,29,35,0,4.17714570327735,21,0
31,1,10,79,24,55,0,3.86919034997118,26,0
31,1,10,91,20,71,0,4.50868833875575,30,0
31,1,10,67,3,64,0,3.00322734424481,47,0
31,1,10,9,74,-65,0,3.24631216240596,-24,0
31,1,10,71,37,34,0,3.48735754113659,13,0
31,1,10,92,30,62,0,3.76689688623082,20,0
31,1,10,96,22,74,0,3.14709959250104,28,0
31,1,10,21,95,-74,0,3.56010086790775,-45,0
31,1,10,39,88,-49,0,2.93836858206487,-38,0
31,1,10,60,28,32,0,2.92745957348598,22,0
31,1,10,93,30,63,0,2.76592969204648,20,0
31,1,10,69,34,35,0,3.45039949364218,16,0
31,1,10,29,94,-65,0,4.0912743153458,-44,0
31,1,10,29,69,-40,0,5.10668784067093,-19,0
31,1,10,23,71,-48,0,3.69714147708146,-21,0
31,1,10,82,36,46,0,4.63132186000803,14,0
31,1,10,19,63,-44,0,3.91190598009052,-13,0
31,1,10,29,59,-30,0,4.5259420687471,-9,0
31,1,1.5,42,79,-37,1,1.01313504723294,29,0
31,1,1.5,76,40,36,1,1.05552405309936,-10,0
31,1,1.5,22,75,-53,0,1.12857347690078,-25,0
31,1,1.5,44,100,-56,1,0.75093878590269,50,0
31,1,1.5,96,28,68,0,1.10731724138168,22,0
31,1,1.5,11,68,-57,0,0.953676754463231,-18,0
31,1,1.5,3,72,-69,0,0.686124700609071,-22,0
31,1,1.5,94,15,79,0,0.757162155234255,35,0
31,1,1.5,31,76,-45,0,0.76160086413438,-26,0
31,1,1.5,13,81,-68,0,0.69403099990086,-31,0
31,1,1.5,12,82,-70,0,0.946450268314948,-32,0
31,1,1.5,69,32,37,0,1.0241663135057,18,0
31,1,1.5,64,46,18,1,0.801831795328326,-4,0
31,1,1.5,64,44,20,1,0.836314803775167,-6,0
31,1,1.5,40,100,-60,1,0.781383969933813,50,0
31,1,1.5,87,20,67,0,0.721129945613939,30,0
31,1,1.5,39,89,-50,0,0.862918379436451,-39,0
31,1,1.5,14,56,-42,0,1.05532270524418,-6,0
31,1,1.5,87,38,49,0,1.13571060928007,12,0
31,1,1.5,87,15,72,0,0.844657004563487,35,0
32,1,10,30,100,-70,0,7.18069812031081,-50,0
32,1,10,53,0,53,1,6.34781864979323,-50,0
32,1,10,53,40,13,1,5.47656716873917,-10,0
32,1,10,53,0,53,0,6.20017663842737,50,0
32,1,10,53,23,30,1,5.99107704368907,-27,0
32,1,10,48,100,-52,1,6.90249727054561,50,0
32,1,10,3,100,-97,0,5.42519418467054,-50,0
32,1,10,98,38,60,1,4.86210664967257,-12,0
32,1,10,48,100,-52,1,7.17055103374241,50,0
32,1,10,100,15,85,0,7.44905828241644,35,0
32,1,10,48,80,-32,1,7.06151709591268,30,0
32,1,10,48,60,-12,1,6.28927049761933,10,0
32,1,10,53,40,13,1,4.90806829698158,-10,0
32,1,10,50,100,-50,1,7.21471926636423,50,0
32,1,10,75,0,75,0,7.71637457514043,50,0
32,1,10,48,80,-32,1,8.42922234922025,30,0
32,1,10,5,83,-78,0,6.41754175876031,-33,0
32,1,10,80,45,35,1,5.57482582677221,-5,0
32,1,10,50,100,-50,1,6.02977779157391,50,0
32,1,10,30,100,-70,0,7.61855815789386,-50,0
32,1,1.5,3,100,-97,1,1.16013347089756,50,0
32,1,1.5,85,15,70,NaN,NaN,0,0
32,1,1.5,25,55,-30,1,0.757025106810943,5,0
32,1,1.5,28,85,-57,0,0.869416452173027,-35,0
32,1,1.5,0,68,-68,0,0.681231375158859,-18,0
32,1,1.5,100,0,100,1,0.693592986242948,-50,0
32,1,1.5,50,43,7,1,0.608922440535935,-7,0
32,1,1.5,80,45,35,1,0.839342569283872,-5,0
32,1,1.5,53,23,30,1,0.669095563465817,-27,0
32,1,1.5,50,43,7,1,0.624953593607643,-7,0
32,1,1.5,100,15,85,1,0.902715825036466,-35,0
32,1,1.5,98,38,60,1,0.817337392199079,-12,0
32,1,1.5,75,0,75,1,0.607703787936771,-50,0
32,1,1.5,25,55,-30,1,0.982171551903775,5,0
32,1,1.5,0,68,-68,0,0.685346478511747,-18,0
32,1,1.5,100,0,100,0,1.06451889959135,50,0
32,1,1.5,28,85,-57,0,0.971503738127467,-35,0
32,1,1.5,5,83,-78,0,0.683179951460261,-33,0
32,1,1.5,48,60,-12,1,0.61431083511161,10,0
32,1,1.5,85,15,70,1,0.541472419027741,-35,0
32,1,10,7,92,-85,0,4.57894696754192,-42,0
32,1,10,47,80,-33,1,3.35284630870865,30,0
32,1,10,13,95,-82,0,0.984569312021449,-45,0
32,1,10,43,73,-30,0,9.09999808182238,-23,0
32,1,10,26,66,-40,1,3.31595497466697,16,0
32,1,10,70,43,27,1,6.00493985848334,-7,0
32,1,10,79,47,32,1,4.70510483090038,-3,0
32,1,10,56,24,32,1,6.05841325988877,-26,0
32,1,10,81,20,61,0,6.47653456668741,30,0
32,1,10,45,56,-11,1,4.19723128459736,6,0
32,1,10,45,66,-21,1,3.99177768591926,16,0
32,1,10,46,74,-28,1,4.01401319045817,24,0
32,1,10,59,24,35,1,3.85879452276549,-26,0
32,1,10,48,78,-30,1,4.05416080530176,28,0
32,1,10,25,53,-28,0,6.00034327113372,-3,0
32,1,10,47,61,-14,0,6.41992019914505,-11,0
32,1,10,34,69,-35,0,5.66259779353641,-19,0
32,1,10,30,83,-53,0,5.64743150043432,-33,0
32,1,10,25,70,-45,0,5.07383584133731,-20,0
32,1,10,80,41,39,1,5.47471307801243,-9,0
32,1,1.5,81,20,61,0,0.893194214857431,30,0
32,1,1.5,99,25,74,0,0.854291515377554,25,0
32,1,1.5,83,22,61,0,0.825297424498785,28,0
32,1,1.5,45,66,-21,1,0.893700452264056,16,0
32,1,1.5,2,81,-79,0,0.663500387361637,-31,0
32,1,1.5,77,6,71,1,0.722605793113871,-44,0
32,1,1.5,68,28,40,1,0.7544742981745,-22,0
32,1,1.5,39,56,-17,1,0.930322215642263,6,0
32,1,1.5,70,13,57,0,0.761992391557214,37,0
32,1,1.5,75,0,75,0,0.801205414265496,50,0
32,1,1.5,46,74,-28,0,1.13966149583121,-24,0
32,1,1.5,68,29,39,1,0.818571138341213,-21,0
32,1,1.5,26,66,-40,0,1.17427129003136,-16,0
32,1,1.5,17,84,-67,1,0.565317800780576,34,0
32,1,1.5,0,56,-56,0,0.683259947233637,-6,0
32,1,1.5,80,17,63,0,1.13298199965357,33,0
32,1,1.5,81,20,61,0,1.03659916704873,30,0
32,1,1.5,62,3,59,0,0.944275893561098,47,0
32,1,1.5,9,82,-73,0,0.790654122635715,-32,0
32,1,1.5,60,18,42,0,1.04381388023376,32,0
32,1,10,96,1,95,0,2.35807712670339,49,0
32,1,10,53,0,53,0,4.89133831290565,50,0
32,1,10,47,65,-18,1,5.88244519782438,15,0
32,1,10,71,1,70,0,5.26726713176049,49,0
32,1,10,11,62,-51,0,5.81901398286936,-12,0
32,1,10,48,60,-12,1,4.65323194871326,10,0
32,1,10,4,64,-60,0,5.41382874737246,-14,0
32,1,10,5,81,-76,0,5.16875369473382,-31,0
32,1,10,91,40,51,1,4.45252768403316,-10,0
32,1,10,45,66,-21,1,5.86124058221867,16,0
32,1,10,61,32,29,1,5.55533764878965,-18,0
32,1,10,87,23,64,0,5.21556873092049,27,0
32,1,10,53,0,53,0,6.24265952612404,50,0
32,1,10,54,30,24,1,7.37336869620594,-20,0
32,1,10,48,80,-32,1,8.26575355134537,30,0
32,1,10,82,2,80,0,3.698637248056,48,0
32,1,10,2,55,-53,0,5.8587253943424,-5,0
32,1,10,75,0,75,0,6.85961712081735,50,0
32,1,10,29,86,-57,0,5.5568497198492,-36,0
32,1,10,12,95,-83,0,5.36178621377076,-45,0
32,1,1.5,4,90,-86,0,1.0961000236066,-40,0
32,1,1.5,87,23,64,0,1.07978752690906,27,0
32,1,1.5,18,87,-69,0,0.777455423699394,-37,0
32,1,1.5,3,100,-97,0,0.59927645956941,-50,0
32,1,1.5,65,10,55,0,0.723793353015935,40,0
32,1,1.5,71,20,51,0,0.747567493250244,30,0
32,1,1.5,39,58,-19,1,0.825393721298497,8,0
32,1,1.5,59,32,27,1,1.06909918591555,-18,0
32,1,1.5,55,38,17,1,0.894772093762185,-12,0
32,1,1.5,48,78,-30,1,0.871880020135904,28,0
32,1,1.5,6,62,-56,0,0.630264105504466,-12,0
32,1,1.5,100,29,71,0,1.20209291454921,21,0
32,1,1.5,53,9,44,0,0.917022691844068,41,0
32,1,1.5,87,23,64,1,0.87546232144814,-27,0
32,1,1.5,48,59,-11,0,0.492522854098752,-9,0
32,1,1.5,81,20,61,0,0.692415689949485,30,0
32,1,1.5,89,23,66,0,0.916164171161654,27,0
32,1,1.5,96,45,51,1,1.4979052112576,-5,0
32,1,1.5,80,12,68,0,0.786130286159278,38,0
32,1,1.5,96,1,95,0,0.789166201243461,49,0
32,1,10,90,46,44,NaN,NaN,0,0
32,1,10,45,91,-46,0,2.33795713304335,-41,0
32,1,10,96,1,95,1,2.12788370295948,-49,0
32,1,10,98,36,62,1,9.12302539358734,-14,0
32,1,10,25,55,-30,0,4.77556208976239,-5,0
32,1,10,90,34,56,1,6.14743497194922,-16,0
32,1,10,47,80,-33,0,5.98418382295313,-30,0
32,1,10,54,4,50,0,6.73898590888075,46,0
32,1,10,74,30,44,1,5.62363471988738,-20,0
32,1,10,15,83,-68,0,6.54513290488831,-33,0
32,1,10,29,70,-41,1,6.36312953902871,20,0
32,1,10,100,1,99,0,6.1351500360588,49,0
32,1,10,100,2,98,0,6.1399271421742,48,0
32,1,10,48,80,-32,1,4.5761401724294,30,0
32,1,10,32,70,-38,0,4.49126344893557,-20,0
32,1,10,35,74,-39,0,4.38585467807843,-24,0
32,1,10,14,95,-81,0,4.85251621293992,-45,0
32,1,10,31,98,-67,0,6.29231667631211,-48,0
32,1,10,5,96,-91,0,6.95435083299799,-46,0
32,1,10,59,8,51,0,6.90886644349484,42,0
32,1,1.5,39,56,-17,1,0.942171250033425,6,0
32,1,1.5,90,34,56,1,1.29039828709574,-16,0
32,1,1.5,99,24,75,1,0.721351519754535,-26,0
32,1,1.5,72,5,67,0,0.735169657664301,45,0
32,1,1.5,98,3,95,0,0.556918546402812,47,0
32,1,1.5,46,70,-24,0,1.11409454465138,-20,0
32,1,1.5,48,66,-18,1,1.03246021589894,16,0
32,1,1.5,0,80,-80,0,0.713362507853162,-30,0
32,1,1.5,100,2,98,0,0.75255832392304,48,0
32,1,1.5,50,45,5,1,1.02970322947567,-5,0
32,1,1.5,17,100,-83,0,0.676637202775055,-50,0
32,1,1.5,63,11,52,0,0.652430783491582,39,0
32,1,1.5,26,66,-40,0,0.964956763251394,-16,0
32,1,1.5,60,18,42,0,0.712625037380349,32,0
32,1,1.5,81,50,31,1,0.751067987564056,0,0
32,1,1.5,92,9,83,0,0.659554029811261,41,0
32,1,1.5,37,91,-54,0,0.980034004453046,-41,0
32,1,1.5,95,3,92,0,0.639730171447809,47,0
32,1,1.5,17,84,-67,0,0.680885733041578,-34,0
32,1,1.5,24,68,-44,0,0.720697969376488,-18,0
33,1,10,85,15,70,1,1.92948542852173,-35,0
33,1,10,30,100,-70,1,3.99625835372717,50,0
33,1,10,98,38,60,1,3.25971673705499,-12,0
33,1,10,50,100,-50,1,4.392761481864,50,0
33,1,10,48,80,-32,1,4.73610002247005,30,0
33,1,10,48,60,-12,1,3.04936075586374,10,0
33,1,10,3,100,-97,0,2.72712781722657,-50,0
33,1,10,100,15,85,0,3.99434751128138,35,0
33,1,10,28,85,-57,0,3.8577675570159,-35,0
33,1,10,25,55,-30,1,3.6633053776568,5,0
33,1,10,53,40,13,1,3.62890327059722,-10,0
33,1,10,75,0,75,0,3.10712766629149,50,0
33,1,10,5,83,-78,0,2.43821568428029,-33,0
33,1,10,48,100,-52,0,4.66880969063641,-50,0
33,1,10,100,0,100,0,2.33680338153499,50,0
33,1,10,75,0,75,0,4.22682790854378,50,0
33,1,10,53,0,53,0,4.3367553840726,50,0
33,1,10,53,23,30,1,4.31409031731891,-27,0
33,1,10,80,45,35,1,3.54083909285691,-5,0
33,1,10,48,80,-32,1,4.11912310804109,30,0
33,1,1.5,50,43,7,0,0.898855197665398,7,0
33,1,1.5,100,15,85,0,0.750571408887481,35,0
33,1,1.5,100,0,100,0,0.688340130538563,50,0
33,1,1.5,0,68,-68,0,0.748887573314278,-18,0
33,1,1.5,50,100,-50,1,1.12602296993646,50,0
33,1,1.5,25,55,-30,1,1.09638861099302,5,0
33,1,1.5,28,85,-57,1,0.772752576671337,35,0
33,1,1.5,48,60,-12,0,1.42186545372897,-10,0
33,1,1.5,30,100,-70,0,0.748835651531408,-50,0
33,1,1.5,50,43,7,1,0.637927095755003,-7,0
33,1,1.5,53,0,53,0,0.724518747516413,50,0
33,1,1.5,98,38,60,1,0.854981892858632,-12,0
33,1,1.5,48,100,-52,0,0.852076687853696,-50,0
33,1,1.5,53,23,30,1,0.889222197147319,-27,0
33,1,1.5,53,40,13,1,0.932957245106081,-10,0
33,1,1.5,80,45,35,1,1.08671274481458,-5,0
33,1,1.5,0,68,-68,1,1.00237516265042,18,0
33,1,1.5,3,100,-97,1,1.44211223314414,50,0
33,1,1.5,5,83,-78,0,1.3597980912491,-33,0
33,1,1.5,85,15,70,1,1.08069253456415,-35,0
33,1,10,14,54,-40,1,1.50168433122235,4,0
33,1,10,28,85,-57,1,3.87638332825372,35,0
33,1,10,18,78,-60,1,3.86322538188324,28,0
33,1,10,100,15,85,1,3.5794272429157,-35,0
33,1,10,18,83,-65,0,2.75500921217099,-33,0
33,1,10,98,3,95,0,2.57154630077639,47,0
33,1,10,0,68,-68,1,3.3314119682509,18,0
33,1,10,97,46,51,1,3.53312176471445,-4,0
33,1,10,42,89,-47,1,3.91731822226211,39,0
33,1,10,17,58,-41,0,3.0861781315507,-8,0
33,1,10,93,47,46,0,3.97454870819638,3,0
33,1,10,80,15,65,0,3.49336205390864,35,0
33,1,10,63,45,18,1,3.92030493239872,-5,0
33,1,10,19,94,-75,0,5.43310863333681,-44,0
33,1,10,50,43,7,0,5.42874992021098,7,0
33,1,10,68,10,58,0,5.70510392414872,40,0
33,1,10,61,36,25,0,4.25804527819128,14,0
33,1,10,28,85,-57,1,3.52546813132358,35,0
33,1,10,87,34,53,1,3.7503594955524,-16,0
33,1,10,100,15,85,0,2.81390059149271,35,0
33,1,1.5,75,0,75,0,0.788764410008298,50,0
33,1,1.5,9,50,-41,0,0.723870630816236,0,0
33,1,1.5,61,0,61,0,0.789697492789855,50,0
33,1,1.5,45,82,-37,1,0.79682677652454,32,0
33,1,1.5,3,95,-92,0,0.587221548124944,-45,0
33,1,1.5,92,46,46,1,1.04249319415248,-4,0
33,1,1.5,30,100,-70,0,1.1748732193555,-50,0
33,1,1.5,46,81,-35,1,0.98252262656024,31,0
33,1,1.5,98,49,49,0,1.33356823169743,1,0
33,1,1.5,98,3,95,0,0.926540980304708,47,0
33,1,1.5,34,90,-56,0,1.22960300721388,-40,0
33,1,1.5,79,17,62,0,1.49857415591032,33,0
33,1,1.5,98,49,49,0,1.14007868020053,1,0
33,1,1.5,11,92,-81,0,0.844535048541729,-42,0
33,1,1.5,13,83,-70,0,0.912939585661661,-33,0
33,1,1.5,75,0,75,0,1.2186728676752,50,0
33,1,1.5,42,65,-23,1,1.09565415923134,15,0
33,1,1.5,68,10,58,NaN,NaN,0,0
33,1,1.5,56,40,16,1,1.29589203345677,-10,0
33,1,1.5,61,36,25,0,0.546148397272191,14,0
33,1,10,46,59,-13,1,2.14360966347158,9,0
33,1,10,14,54,-40,1,3.81637774364208,4,0
33,1,10,18,78,-60,1,3.87659765655553,28,0
33,1,10,1,100,-99,0,2.26205683984153,-50,0
33,1,10,17,75,-58,0,3.64871445038807,-25,0
33,1,10,65,48,17,1,3.06028123553551,-2,0
33,1,10,88,13,75,0,2.93472017083695,37,0
33,1,10,14,60,-46,0,4.1817404791982,-10,0
33,1,10,79,47,32,1,3.54718713484544,-3,0
33,1,10,100,15,85,0,2.30605934537016,35,0
33,1,10,49,58,-9,1,2.50476069699653,8,0
33,1,10,47,54,-7,1,2.62526844376043,4,0
33,1,10,78,19,59,0,4.39711928937322,31,0
33,1,10,100,15,85,0,2.51315542331577,35,0
33,1,10,65,27,38,0,3.15375795752334,23,0
33,1,10,5,54,-49,0,3.31140185557888,-4,0
33,1,10,1,100,-99,0,2.32784626983994,-50,0
33,1,10,73,17,56,1,3.6077378982045,-33,0
33,1,10,29,94,-65,0,4.17996366740772,-44,0
33,1,10,3,90,-87,0,3.12136148035279,-40,0
33,1,1.5,12,89,-77,0,0.722654091310687,-39,0
33,1,1.5,26,62,-36,1,0.754443204335985,12,0
33,1,1.5,47,59,-12,1,0.792355767451227,9,0
33,1,1.5,22,63,-41,0,0.900637141265179,-13,0
33,1,1.5,46,57,-11,1,0.8690801669145,7,0
33,1,1.5,7,84,-77,0,0.798883120722166,-34,0
33,1,1.5,21,99,-78,0,0.723272322797129,-49,0
33,1,1.5,0,97,-97,0,0.555073812534829,-47,0
33,1,1.5,46,58,-12,0,0.969587158993818,-8,0
33,1,1.5,20,73,-53,0,0.991250316415972,-23,0
33,1,1.5,48,60,-12,1,1.20233803253359,10,0
33,1,1.5,81,44,37,1,1.17397424798037,-6,0
33,1,1.5,3,99,-96,0,1.02694986436109,-49,0
33,1,1.5,61,0,61,0,1.02198801329359,50,0
33,1,1.5,82,44,38,1,1.22568804423281,-6,0
33,1,1.5,100,19,81,0,0.980666422732611,31,0
33,1,1.5,66,3,63,NaN,NaN,0,0
33,1,1.5,11,68,-57,0,0.930900599039887,-18,0
33,1,1.5,49,54,-5,1,0.953962324085296,4,0
33,1,1.5,36,56,-20,0,0.775655366713181,-6,0
33,1,10,41,90,-49,0,1.43749119425411,-40,0
33,1,10,80,48,32,1,2.34025738773926,-2,0
33,1,10,100,15,85,0,3.18614688791786,35,0
33,1,10,87,13,74,0,2.6218820566246,37,0
33,1,10,38,80,-42,0,3.20850193330989,-30,0
33,1,10,53,0,53,0,2.41143189172726,50,0
33,1,10,49,86,-37,1,2.71937245336085,36,0
33,1,10,99,4,95,0,2.34186515185866,46,0
33,1,10,2,97,-95,0,2.23586984595022,-47,0
33,1,10,27,68,-41,0,3.88512248920597,-18,0
33,1,10,4,98,-94,0,2.56991619821565,-48,0
33,1,10,1,56,-55,0,3.05445814694394,-6,0
33,1,10,87,13,74,0,3.07884025506064,37,0
33,1,10,100,3,97,0,2.77456470735342,47,0
33,1,10,93,47,46,0,2.33838307166297,3,0
33,1,10,56,36,20,1,3.28765669494533,-14,0
33,1,10,86,30,56,0,1.59064748033779,20,0
33,1,10,30,86,-56,0,3.8306640832343,-36,0
33,1,10,60,23,37,0,4.04014101653229,27,0
33,1,10,84,41,43,0,4.55285294873102,9,0
33,1,1.5,30,92,-62,0,0.868026033924252,-42,0
33,1,1.5,9,85,-76,0,0.612451309571043,-35,0
33,1,1.5,33,67,-34,0,0.527574586074479,-17,0
33,1,1.5,98,4,94,0,0.662161890897551,46,0
33,1,1.5,61,39,22,1,0.831256957575533,-11,0
33,1,1.5,55,50,5,1,0.96101131017349,0,0
33,1,1.5,4,98,-94,0,0.717322146581864,-48,0
33,1,1.5,56,43,13,0,0.835163770043437,7,0
33,1,1.5,65,27,38,0,0.892923435570992,23,0
33,1,1.5,42,89,-47,1,0.963994699730392,39,0
33,1,1.5,91,46,45,0,0.894288797400804,4,0
33,1,1.5,87,40,47,0,0.917387652556499,10,0
33,1,1.5,98,5,93,0,0.755814301715873,45,0
33,1,1.5,11,75,-64,0,0.728233268258919,-25,0
33,1,1.5,98,4,94,0,0.758012223330297,46,0
33,1,1.5,56,43,13,1,0.874398225583718,-7,0
33,1,1.5,5,97,-92,0,0.866184018032072,-47,0
33,1,1.5,0,75,-75,0,1.20191209277618,-25,0
33,1,1.5,34,80,-46,0,0.9402000322807,-30,0
33,1,1.5,69,19,50,0,1.01722479323871,31,0
34,1,10,5,83,-78,0,1.21164108899939,-33,0
34,1,10,80,45,35,1,4.00766363875118,-5,0
34,1,10,53,0,53,0,2.29450644705594,50,0
34,1,10,48,60,-12,0,2.92316666878014,-10,0
34,1,10,28,85,-57,0,2.23027346313756,-35,0
34,1,10,100,15,85,1,2.26901285049098,-35,0
34,1,10,25,55,-30,0,2.09764077203454,-5,0
34,1,10,48,80,-32,0,2.80637857456622,-30,0
34,1,10,100,0,100,0,2.91757934131874,50,0
34,1,10,0,68,-68,0,2.68868456594737,-18,0
34,1,10,75,0,75,0,2.49322832589951,50,0
34,1,10,53,40,13,1,2.88186258673159,-10,0
34,1,10,53,23,30,1,2.60636861282819,-27,0
34,1,10,53,0,53,0,2.15759624608472,50,0
34,1,10,0,68,-68,1,1.58357193038864,18,0
34,1,10,3,100,-97,0,2.36052711011507,-50,0
34,1,10,100,0,100,0,2.21854608269769,50,0
34,1,10,53,23,30,1,2.33718917325132,-27,0
34,1,10,50,100,-50,0,1.44315278272097,-50,0
34,1,10,50,43,7,1,2.03064234931026,-7,0
34,1,1.5,48,100,-52,0,0.65563695336914,-50,0
34,1,1.5,25,55,-30,0,0.990134602549006,-5,0
34,1,1.5,5,83,-78,0,0.847174909854402,-33,0
34,1,1.5,30,100,-70,0,0.814339512478909,-50,0
34,1,1.5,50,100,-50,0,0.726078514946494,-50,0
34,1,1.5,3,100,-97,0,0.60195827978896,-50,0
34,1,1.5,53,40,13,1,0.762474177062359,-10,0
34,1,1.5,80,45,35,1,0.581014178723308,-5,0
34,1,1.5,75,0,75,1,0.806161227558732,-50,0
34,1,1.5,50,43,7,1,0.878692640992995,-7,0
34,1,1.5,98,38,60,1,1.41777329333581,-12,0
34,1,1.5,98,38,60,1,0.85600402831551,-12,0
34,1,1.5,48,80,-32,NaN,NaN,0,0
34,1,1.5,28,85,-57,1,0.841675426808251,35,0
34,1,1.5,85,15,70,0,0.567359051069616,35,0
34,1,1.5,85,15,70,0,0.495969313168644,35,0
34,1,1.5,48,100,-52,1,0.731802288030849,50,0
34,1,1.5,48,60,-12,0,0.661677992709883,-10,0
34,1,1.5,30,100,-70,0,0.706833342993377,-50,0
34,1,1.5,100,15,85,1,0.75068944116174,-35,0
34,1,10,15,79,-64,0,1.78344937082602,-29,0
34,1,10,17,68,-51,0,3.5474515744836,-18,0
34,1,10,0,68,-68,0,3.20502649505397,-18,0
34,1,10,85,15,70,1,1.50744251835749,-35,0
34,1,10,28,85,-57,0,2.39420623650039,-35,0
34,1,10,90,24,66,1,3.52943290377152,-26,0
34,1,10,83,2,81,1,1.93175489430723,-48,0
34,1,10,78,28,50,1,1.37316281992662,-22,0
34,1,10,54,46,8,1,2.88126910865049,-4,0
34,1,10,91,8,83,1,4.34041647445065,-42,0
34,1,10,49,96,-47,0,3.81110134392929,-46,0
34,1,10,49,100,-51,0,2.36865649195988,-50,0
34,1,10,52,48,4,1,2.54394111843158,-2,0
34,1,10,30,74,-44,0,1.78450320194406,-24,0
34,1,10,51,4,47,1,3.36377433478992,-46,0
34,1,10,81,21,60,1,2.73946678877383,-29,0
34,1,10,29,73,-44,0,2.5320374454177,-23,0
34,1,10,18,53,-35,0,3.70124661927275,-3,0
34,1,10,82,23,59,1,2.60748915740351,-27,0
34,1,10,49,99,-50,0,2.83007845457269,-49,0
34,1,1.5,49,97,-48,0,0.883180554837963,-47,0
34,1,1.5,51,0,51,1,0.702974829858249,-50,0
34,1,1.5,0,70,-70,0,0.538187158264009,-20,0
34,1,1.5,45,71,-26,0,1.02001679745263,-21,0
34,1,1.5,49,99,-50,0,0.721052969126504,-49,0
34,1,1.5,49,96,-47,0,0.499505730112105,-46,0
34,1,1.5,9,94,-85,0,0.646093306617331,-44,0
34,1,1.5,30,69,-39,0,0.819212915393109,-19,0
34,1,1.5,86,38,48,1,0.91300811111887,-12,0
34,1,1.5,38,89,-51,0,0.6987721839605,-39,0
34,1,1.5,16,81,-65,0,0.755256445169834,-31,0
34,1,1.5,2,67,-65,0,0.603069768239038,-17,0
34,1,1.5,13,80,-67,0,0.440931315176385,-30,0
34,1,1.5,49,96,-47,0,0.924763867418733,-46,0
34,1,1.5,51,3,48,1,0.957819328638834,-47,0
34,1,1.5,49,97,-48,0,0.917605302211086,-47,0
34,1,1.5,85,4,81,1,0.582663601017885,-46,0
34,1,1.5,73,13,60,1,0.885886223219131,-37,0
34,1,1.5,49,100,-51,0,0.824340493558338,-50,0
34,1,1.5,97,38,59,1,0.788751732210585,-12,0
34,1,10,69,16,53,1,1.99471579448618,-34,0
34,1,10,0,50,-50,0,3.94802060102484,0,0
34,1,10,51,0,51,1,3.84272925792629,-50,0
34,1,10,49,100,-51,0,4.62897209792663,-50,0
34,1,10,39,76,-37,0,3.72086822416895,-26,0
34,1,10,12,76,-64,0,4.64901451078094,-26,0
34,1,10,48,92,-44,0,3.59699491936226,-42,0
34,1,10,51,4,47,1,3.64187435969507,-46,0
34,1,10,48,60,-12,0,4.01274110635677,-10,0
34,1,10,49,99,-50,0,3.5129160405113,-49,0
34,1,10,38,72,-34,0,3.59979869576728,-22,0
34,1,10,49,98,-49,0,4.94072619393773,-48,0
34,1,10,11,51,-40,0,3.88320108205517,-1,0
34,1,10,7,76,-69,0,5.34000894880955,-26,0
34,1,10,49,96,-47,0,6.77032885643712,-46,0
34,1,10,49,100,-51,0,6.28696148716517,-50,0
34,1,10,88,13,75,1,4.10301829925811,-37,0
34,1,10,51,4,47,1,3.72709883839889,-46,0
34,1,10,82,8,74,1,4.83859121238856,-42,0
34,1,10,40,99,-59,0,4.56046975465506,-49,0
34,1,1.5,7,60,-53,0,0.670968067950525,-10,0
34,1,1.5,51,0,51,1,0.656787986898053,-50,0
34,1,1.5,28,96,-68,0,0.587256867787801,-46,0
34,1,1.5,64,26,38,1,0.92045405737008,-24,0
34,1,1.5,49,100,-51,0,0.968157801322377,-50,0
34,1,1.5,49,98,-49,0,0.957906267442013,-48,0
34,1,1.5,14,67,-53,0,0.956239638508123,-17,0
34,1,1.5,15,73,-58,0,0.634659646508226,-23,0
34,1,1.5,42,88,-46,0,0.901784854986545,-38,0
34,1,1.5,49,97,-48,0,0.982220152745867,-47,0
34,1,1.5,42,72,-30,0,0.784558746179755,-22,0
34,1,1.5,49,99,-50,0,0.517700089654682,-49,0
34,1,1.5,84,43,41,1,0.644902426134649,-7,0
34,1,1.5,94,18,76,1,0.687374446481044,-32,0
34,1,1.5,51,3,48,1,0.52790815413573,-47,0
34,1,1.5,88,11,77,1,0.766993183604427,-39,0
34,1,1.5,49,97,-48,0,0.84411031703894,-47,0
34,1,1.5,49,100,-51,0,0.55055329741117,-50,0
34,1,1.5,75,17,58,1,1.02841152376823,-33,0
34,1,1.5,23,93,-70,0,0.535450699057037,-43,0
34,1,10,99,40,59,1,4.55978541344848,-10,0
34,1,10,50,37,13,1,3.0269607324899,-13,0
34,1,10,89,9,80,1,2.91673772540162,-41,0
34,1,10,63,32,31,1,3.62780959330303,-18,0
34,1,10,100,0,100,1,4.37338831744819,-50,0
34,1,10,51,4,47,1,4.30543839781967,-46,0
34,1,10,49,99,-50,0,4.21477239526757,-49,0
34,1,10,49,98,-49,0,4.02537258997472,-48,0
34,1,10,49,97,-48,0,4.21075268310415,-47,0
34,1,10,60,49,11,1,3.51684156897318,-1,0
34,1,10,16,78,-62,0,4.95241282181087,-28,0
34,1,10,86,10,76,1,4.08415559766581,-40,0
34,1,10,16,87,-71,0,3.85896175885136,-37,0
34,1,10,20,66,-46,0,5.41905896126082,-16,0
34,1,10,49,97,-48,0,5.59607089270685,-47,0
34,1,10,49,99,-50,0,3.8863281621343,-49,0
34,1,10,51,2,49,1,3.55716487264726,-48,0
34,1,10,15,56,-41,0,3.67335797942724,-6,0
34,1,10,100,50,50,1,3.76885663232861,0,0
34,1,10,51,3,48,0,3.23637789535678,47,0
34,1,1.5,49,100,-51,0,0.701267750231636,-50,0
34,1,1.5,51,3,48,1,0.556503775498641,-47,0
34,1,1.5,69,19,50,0,0.569600140219336,31,0
34,1,1.5,51,0,51,1,0.950062153546241,-50,0
34,1,1.5,67,28,39,1,0.634449846271309,-22,0
34,1,1.5,49,96,-47,0,0.956239638509942,-46,0
34,1,1.5,15,76,-61,0,0.59198688205106,-26,0
34,1,1.5,52,27,25,1,1.01979069618938,-23,0
34,1,1.5,70,38,32,1,0.621458230734788,-12,0
34,1,1.5,67,33,34,1,0.791932243428164,-17,0
34,1,1.5,49,97,-48,NaN,NaN,0,0
34,1,1.5,51,1,50,1,0.608867801549422,-49,0
34,1,1.5,49,96,-47,0,1.18735920200379,-46,0
34,1,1.5,90,5,85,1,0.582381049905962,-45,0
34,1,1.5,30,57,-27,0,0.585509337468466,-7,0
34,1,1.5,21,60,-39,0,0.692666544257008,-10,0
34,1,1.5,8,96,-88,0,0.619771074583696,-46,0
34,1,1.5,14,97,-83,0,0.725587672952315,-47,0
34,1,1.5,96,10,86,1,0.779372906939898,-40,0
34,1,1.5,51,3,48,1,0.599123712558139,-47,0
35,1,10,30,100,-70,0,1.32090173073448,-50,0
35,1,10,53,0,53,1,2.41980669424811,-50,0
35,1,10,25,55,-30,0,3.91437981114359,-5,0
35,1,10,53,23,30,1,3.93319149656236,-27,0
35,1,10,100,15,85,0,2.57476424365814,35,0
35,1,10,85,15,70,0,3.92728177103709,35,0
35,1,10,53,40,13,1,2.78476552661232,-10,0
35,1,10,48,60,-12,0,2.93602606379136,-10,0
35,1,10,0,68,-68,0,6.09711430818425,-18,0
35,1,10,5,83,-78,0,2.34785909902712,-33,0
35,1,10,48,80,-32,0,4.68168206687187,-30,0
35,1,10,80,45,35,1,9.20557257831751,-5,0
35,1,10,0,68,-68,0,6.30674670496592,-18,0
35,1,10,50,43,7,0,4.98818270457195,7,0
35,1,10,100,0,100,1,8.1780546358641,-50,0
35,1,10,75,0,75,0,5.87224226368926,50,0
35,1,10,50,100,-50,0,2.73904356475396,-50,0
35,1,10,100,15,85,1,4.90889632725157,-35,0
35,1,10,80,45,35,1,5.02217517289682,-5,0
35,1,10,28,85,-57,0,5.49053261816152,-35,0
35,1,1.5,25,55,-30,0,0.870431944233133,-5,0
35,1,1.5,98,38,60,1,0.642248074706004,-12,0
35,1,1.5,85,15,70,1,0.446030214512575,-35,0
35,1,1.5,48,100,-52,0,0.554607723628578,-50,0
35,1,1.5,3,100,-97,0,0.554466749945277,-50,0
35,1,1.5,53,0,53,1,0.602298789006454,-50,0
35,1,1.5,48,80,-32,0,0.775443754930166,-30,0
35,1,1.5,48,100,-52,0,0.661248429401894,-50,0
35,1,1.5,3,100,-97,0,0.848441558820923,-50,0
35,1,1.5,98,38,60,1,0.603509894834133,-12,0
35,1,1.5,28,85,-57,0,0.769909858609026,-35,0
35,1,1.5,53,40,13,1,0.873080559023947,-10,0
35,1,1.5,100,0,100,1,0.916254730957007,-50,0
35,1,1.5,5,83,-78,0,0.508672339081386,-33,0
35,1,1.5,53,23,30,1,0.461864245924517,-27,0
35,1,1.5,50,100,-50,1,0.825078566675074,50,0
35,1,1.5,75,0,75,1,1.12487072859949,-50,0
35,1,1.5,30,100,-70,0,0.78914084263306,-50,0
35,1,1.5,48,60,-12,NaN,NaN,0,0
35,1,1.5,50,43,7,NaN,NaN,0,0
35,1,10,68,8,60,0,0.835371456865687,42,0
35,1,10,51,0,51,0,5.01818655342504,50,0
35,1,10,77,29,48,1,6.66138336567019,-21,0
35,1,10,68,49,19,1,4.23932022938243,-1,0
35,1,10,49,97,-48,0,4.44204551936491,-47,0
35,1,10,51,1,50,0,3.69469481336637,49,0
35,1,10,75,16,59,1,3.28882523666471,-34,0
35,1,10,49,96,-47,0,4.62726562094758,-46,0
35,1,10,43,54,-11,0,7.51847227417966,-4,0
35,1,10,54,0,54,0,4.55818096881194,50,0
35,1,10,65,45,20,1,3.49012871496961,-5,0
35,1,10,51,4,47,0,5.09037262661514,46,0
35,1,10,49,97,-48,0,4.818818670974,-47,0
35,1,10,65,43,22,1,8.38188326378804,-7,0
35,1,10,51,0,51,0,3.52207812141933,50,0
35,1,10,35,62,-27,0,3.46572124970771,-12,0
35,1,10,51,1,50,0,2.77065397024126,49,0
35,1,10,72,47,25,1,3.94446335389512,-3,0
35,1,10,60,0,60,1,3.09525810436389,-50,0
35,1,10,51,38,13,0,3.96832714977427,12,0
35,1,1.5,94,30,64,1,0.735305799957132,-20,0
35,1,1.5,88,50,38,1,0.503761806052353,0,0
35,1,1.5,5,99,-94,0,0.560988367669779,-49,0
35,1,1.5,17,98,-81,0,0.671511736247339,-48,0
35,1,1.5,51,1,50,1,0.640631254460459,-49,0
35,1,1.5,51,4,47,1,0.41913654097516,-46,0
35,1,1.5,44,74,-30,0,0.695017211426602,-24,0
35,1,1.5,49,97,-48,0,0.70413069222559,-47,0
35,1,1.5,51,0,51,1,0.849274420481379,-50,0
35,1,1.5,95,6,89,1,0.45226686616661,-44,0
35,1,1.5,47,63,-16,0,0.542787668840901,-13,0
35,1,1.5,49,98,-49,0,0.567398293183942,-48,0
35,1,1.5,71,31,40,1,0.446545508046256,-19,0
35,1,1.5,49,97,-48,1,0.491114625150658,47,0
35,1,1.5,49,96,-47,0,0.43823168311792,-46,0
35,1,1.5,47,99,-52,0,0.555569182270119,-49,0
35,1,1.5,42,84,-42,0,0.668178176507354,-34,0
35,1,1.5,77,43,34,1,0.759831900464633,-7,0
35,1,1.5,51,1,50,0,0.736384988227655,49,0
35,1,1.5,23,94,-71,0,0.857562586388667,-44,0
35,1,10,91,2,89,1,4.99137136630452,-48,0
35,1,10,49,98,-49,0,5.43714555181577,-48,0
35,1,10,89,15,74,1,6.93691356407362,-35,0
35,1,10,96,25,71,1,5.02334975235135,-25,0
35,1,10,49,99,-50,0,9.42714698570489,-49,0
35,1,10,17,77,-60,0,4.69364249160208,-27,0
35,1,10,85,31,54,1,5.51878169179327,-19,0
35,1,10,51,0,51,0,5.41445512791688,50,0
35,1,10,41,56,-15,0,7.00276065139769,-6,0
35,1,10,49,97,-48,0,6.8785637410474,-47,0
35,1,10,14,80,-66,0,6.19848344340426,-30,0
35,1,10,11,83,-72,0,5.57929532503476,-33,0
35,1,10,51,4,47,0,3.11294320779416,46,0
35,1,10,41,60,-19,0,3.62597180251032,-10,0
35,1,10,65,31,34,1,3.65420970691775,-19,0
35,1,10,51,3,48,0,7.23243636664483,47,0
35,1,10,49,96,-47,0,3.61955131151262,-46,0
35,1,10,5,100,-95,0,4.43181149399243,-50,0
35,1,10,20,65,-45,0,2.43510852735926,-15,0
35,1,10,49,99,-50,0,3.79904341381916,-49,0
35,1,1.5,51,0,51,NaN,NaN,0,0
35,1,1.5,49,100,-51,1,0.569005755431135,50,0
35,1,1.5,51,3,48,0,0.567482515147276,47,0
35,1,1.5,13,77,-64,0,0.685950822484301,-27,0
35,1,1.5,45,99,-54,0,0.735765247383824,-49,0
35,1,1.5,19,81,-62,0,0.783550194591953,-31,0
35,1,1.5,3,61,-58,0,1.069357887769,-11,0
35,1,1.5,49,96,-47,0,0.511653011799353,-46,0
35,1,1.5,25,64,-39,0,0.65690843226912,-14,0
35,1,1.5,82,42,40,1,0.923390957723313,-8,0
35,1,1.5,36,82,-46,0,0.889793940204981,-32,0
35,1,1.5,41,54,-13,0,0.986848737313267,-4,0
35,1,1.5,73,41,32,1,0.823966776359157,-9,0
35,1,1.5,49,99,-50,0,0.604344869589113,-49,0
35,1,1.5,93,9,84,1,0.560900221382326,-41,0
35,1,1.5,51,3,48,0,1.05535198619327,47,0
35,1,1.5,49,97,-48,0,1.04975016893513,-47,0
35,1,1.5,51,1,50,1,0.73215909827195,-49,0
35,1,1.5,20,58,-38,0,0.762566548444738,-8,0
35,1,1.5,95,18,77,1,0.537004729070759,-32,0
35,1,10,7,81,-74,0,6.2779563769036,-31,0
35,1,10,18,67,-49,0,5.20601844154953,-17,0
35,1,10,55,47,8,1,6.96904288554651,-3,0
35,1,10,49,99,-50,0,8.5561825838231,-49,0
35,1,10,51,0,51,0,3.05625065569984,50,0
35,1,10,41,63,-22,0,5.75394723021964,-13,0
35,1,10,49,97,-48,0,2.1342459314219,-47,0
35,1,10,5,66,-61,0,2.14827054899069,-16,0
35,1,10,51,3,48,1,3.93024221840824,-47,0
35,1,10,79,26,53,1,7.38371652542628,-24,0
35,1,10,12,95,-83,0,5.75934377530575,-45,0
35,1,10,49,99,-50,0,4.38761488551609,-49,0
35,1,10,50,33,17,0,2.71090135339909,17,0
35,1,10,81,9,72,1,2.92609239990998,-41,0
35,1,10,14,80,-66,0,8.6837957665266,-30,0
35,1,10,51,4,47,0,1.98651637751027,46,0
35,1,10,49,100,-51,0,6.30251598507675,-50,0
35,1,10,9,50,-41,0,4.41196016538379,0,0
35,1,10,51,2,49,0,7.73390421362637,48,0
35,1,10,92,50,42,1,3.54611941734765,0,0
35,1,1.5,100,13,87,1,1.14528082014294,-37,0
35,1,1.5,51,3,48,1,0.959659834083141,-47,0
35,1,1.5,51,0,51,1,0.549342492355208,-50,0
35,1,1.5,51,2,49,1,0.594548556942755,-48,0
35,1,1.5,64,47,17,1,0.717740237381804,-3,0
35,1,1.5,54,49,5,1,0.843513517284009,-1,0
35,1,1.5,51,4,47,1,0.668550383263209,-46,0
35,1,1.5,67,50,17,1,0.604343360239,0,0
35,1,1.5,41,81,-40,0,1.07085788399854,-31,0
35,1,1.5,89,31,58,1,1.36721143512841,-19,0
35,1,1.5,0,64,-64,0,0.616737875243416,-14,0
35,1,1.5,64,11,53,1,0.499244610735332,-39,0
35,1,1.5,27,70,-43,0,0.770393757571583,-20,0
35,1,1.5,49,97,-48,1,0.334898274315492,47,0
35,1,1.5,49,99,-50,0,0.668712186034099,-49,0
35,1,1.5,49,96,-47,0,0.71722675507408,-46,0
35,1,1.5,29,63,-34,1,1.35570381666184,13,0
35,1,1.5,37,91,-54,0,0.975952709173725,-41,0
35,1,1.5,3,73,-70,0,0.475678459511983,-23,0
35,1,1.5,51,1,50,1,1.09146751216758,-49,0
36,1,10,53,0,53,0,3.02626967079323,50,0
36,1,10,30,100,-70,0,2.96067876794496,-50,0
36,1,10,100,15,85,0,3.29777903555259,35,0
36,1,10,75,0,75,0,3.42211624238007,50,0
36,1,10,50,43,7,1,3.08445962848509,-7,0
36,1,10,5,83,-78,0,3.9515502211616,-33,0
36,1,10,0,68,-68,0,3.52900053714438,-18,0
36,1,10,25,55,-30,0,2.54798181668048,-5,0
36,1,10,53,40,13,1,4.31790802457544,-10,0
36,1,10,98,38,60,0,5.2479155562296,12,0
36,1,10,48,80,-32,0,5.98898631907105,-30,0
36,1,10,48,100,-52,0,4.21182881692403,-50,0
36,1,10,30,100,-70,0,6.4585676405668,-50,0
36,1,10,3,100,-97,0,6.99860631010506,-50,0
36,1,10,100,15,85,0,3.70113764043072,35,0
36,1,10,98,38,60,1,4.51933828431993,-12,0
36,1,10,85,15,70,0,4.14528460882593,35,0
36,1,10,48,60,-12,0,6.68337591542513,-10,0
36,1,10,100,0,100,0,5.70202091185638,50,0
36,1,10,5,83,-78,0,3.85627946647128,-33,0
36,1,1.5,75,0,75,0,0.763456876941746,50,0
36,1,1.5,50,100,-50,0,0.933340521175523,-50,0
36,1,1.5,53,0,53,0,0.783714764424985,50,0
36,1,1.5,25,55,-30,0,0.84821108689539,-5,0
36,1,1.5,100,0,100,0,0.718603532901398,50,0
36,1,1.5,53,23,30,1,0.849828204127334,-27,0
36,1,1.5,48,100,-52,0,0.783607298728384,-50,0
36,1,1.5,80,45,35,0,0.688080558335969,5,0
36,1,1.5,50,100,-50,0,0.80390865548361,-50,0
36,1,1.5,3,100,-97,0,0.772385585828488,-50,0
36,1,1.5,28,85,-57,0,0.765482122324102,-35,0
36,1,1.5,48,60,-12,0,1.07001696339648,-10,0
36,1,1.5,0,68,-68,0,0.642358432627589,-18,0
36,1,1.5,28,85,-57,0,0.816853140093372,-35,0
36,1,1.5,48,80,-32,0,0.807980277143542,-30,0
36,1,1.5,53,40,13,1,0.991123860068001,-10,0
36,1,1.5,53,23,30,1,0.854180564825583,-27,0
36,1,1.5,50,43,7,1,0.778603804585146,-7,0
36,1,1.5,85,15,70,0,0.635087291543641,35,0
36,1,1.5,80,45,35,0,0.624939028126391,5,0
36,1,10,14,87,-73,0,2.37699725279981,-37,0
36,1,10,27,50,-23,0,2.77633193146721,0,0
36,1,10,93,11,82,0,2.23948100842335,39,0
36,1,10,49,88,-39,0,2.87682865844181,-38,0
36,1,10,98,2,96,0,3.65655809242071,48,0
36,1,10,97,37,60,0,2.7649351340051,13,0
36,1,10,87,25,62,0,3.50871487762652,25,0
36,1,10,76,32,44,0,3.32628944327371,18,0
36,1,10,69,7,62,0,2.99136324292522,43,0
36,1,10,30,64,-34,0,3.70173987094768,-14,0
36,1,10,66,4,62,0,4.97256036852013,46,0
36,1,10,43,67,-24,0,6.25902587912515,-17,0
36,1,10,4,99,-95,0,6.5644421804036,-49,0
36,1,10,53,22,31,0,4.72254112431165,28,0
36,1,10,79,23,56,0,5.11502154427217,27,0
36,1,10,84,23,61,0,6.74744358258886,27,0
36,1,10,57,27,30,0,6.34603445374069,23,0
36,1,10,91,24,67,0,5.71344759444037,26,0
36,1,10,87,28,59,0,8.37764868811519,22,0
36,1,10,25,53,-28,0,4.58308868618406,-3,0
36,1,1.5,39,87,-48,0,0.565354129472325,-37,0
36,1,1.5,90,15,75,0,0.701228503280618,35,0
36,1,1.5,77,40,37,0,0.503072324832829,10,0
36,1,1.5,23,53,-30,0,0.632937675749417,-3,0
36,1,1.5,62,5,57,0,0.326106811963655,45,0
36,1,1.5,44,87,-43,0,0.743387356295898,-37,0
36,1,1.5,93,18,75,0,0.528520262079837,32,0
36,1,1.5,7,84,-77,0,0.537703749191678,-34,0
36,1,1.5,90,18,72,0,0.426253973556413,32,0
36,1,1.5,62,27,35,0,0.863489026089155,23,0
36,1,1.5,95,39,56,0,0.401280575843884,11,0
36,1,1.5,82,30,52,0,0.767130935899331,20,0
36,1,1.5,92,48,44,0,0.566249777563826,2,0
36,1,1.5,97,44,53,0,0.749468827972123,6,0
36,1,1.5,6,63,-57,0,0.445232234393188,-13,0
36,1,1.5,89,38,51,0,0.513803197222842,12,0
36,1,1.5,20,91,-71,0,0.667691055560681,-41,0
36,1,1.5,88,42,46,0,0.638854628312401,8,0
36,1,1.5,41,87,-46,0,0.411355484868182,-37,0
36,1,1.5,12,86,-74,0,0.497160202188752,-36,0
36,1,10,93,50,43,0,1.02277220574615,0,0
36,1,10,28,87,-59,0,5.44688285918801,-37,0
36,1,10,56,13,43,0,5.70523129859612,37,0
36,1,10,80,49,31,0,3.46484381834944,1,0
36,1,10,94,33,61,0,5.38711049930498,17,0
36,1,10,92,19,73,0,7.20010630180332,31,0
36,1,10,96,12,84,0,6.92390980258915,38,0
36,1,10,85,21,64,0,6.44308895786617,29,0
36,1,10,14,74,-60,0,5.07707619178655,-24,0
36,1,10,34,87,-53,0,8.3895248550316,-37,0
36,1,10,3,93,-90,0,4.91892260942132,-43,0
36,1,10,65,30,35,1,5.47809319159205,-20,0
36,1,10,29,80,-51,0,6.66305463525441,-30,0
36,1,10,99,35,64,0,5.26431645157572,15,0
36,1,10,95,36,59,0,5.97809515374684,14,0
36,1,10,67,26,41,0,3.59095269981663,24,0
36,1,10,66,40,26,1,5.25981526900068,-10,0
36,1,10,97,38,59,0,4.38147488952018,12,0
36,1,10,98,26,72,0,4.69885097568567,24,0
36,1,10,25,86,-61,0,6.14667954978813,-36,0
36,1,1.5,47,96,-49,0,0.710630544223022,-46,0
36,1,1.5,28,59,-31,0,0.591804878637959,-9,0
36,1,1.5,85,15,70,0,0.49296904003586,35,0
36,1,1.5,26,77,-51,0,0.486075840108242,-27,0
36,1,1.5,94,11,83,0,0.391390713089095,39,0
36,1,1.5,94,40,54,0,0.244563592490522,10,0
36,1,1.5,5,58,-53,0,0.375849845183438,-8,0
36,1,1.5,37,54,-17,0,0.261798252592598,-4,0
36,1,1.5,73,34,39,0,0.328421248742416,16,0
36,1,1.5,53,30,23,0,0.264325507673675,20,0
36,1,1.5,21,56,-35,0,0.311582943862959,-6,0
36,1,1.5,80,1,79,0,0.416147368188831,49,0
36,1,1.5,94,19,75,0,0.482701839863694,31,0
36,1,1.5,87,42,45,0,0.275217276737749,8,0
36,1,1.5,95,38,57,0,0.309151381550691,12,0
36,1,1.5,100,39,61,0,0.525792867233577,11,0
36,1,1.5,12,82,-70,0,0.476959066252675,-32,0
36,1,1.5,90,36,54,0,0.342143954040694,14,0
36,1,1.5,33,60,-27,0,0.63671678544415,-10,0
36,1,1.5,30,78,-48,0,0.287220229025479,-28,0
36,1,10,85,26,59,0,4.36975780805915,24,0
36,1,10,83,29,54,0,4.97906777867229,21,0
36,1,10,100,15,85,0,4.25482445339367,35,0
36,1,10,74,17,57,0,5.55150041262277,33,0
36,1,10,86,25,61,0,5.58778185803658,25,0
36,1,10,38,82,-44,0,5.56674756108441,-32,0
36,1,10,22,91,-69,0,7.30627727791489,-41,0
36,1,10,46,94,-48,0,4.66406620140151,-44,0
36,1,10,99,15,84,0,5.74403124486344,35,0
36,1,10,43,64,-21,0,5.13222299868266,-14,0
36,1,10,100,41,59,0,3.11926372244579,9,0
36,1,10,53,4,49,0,5.35758611047822,46,0
36,1,10,1,50,-49,0,4.28929377359782,0,0
36,1,10,93,34,59,0,3.17666096969333,16,0
36,1,10,19,73,-54,0,2.62105486769542,-23,0
36,1,10,77,27,50,0,3.40757848826252,23,0
36,1,10,86,24,62,0,5.057809947034,26,0
36,1,10,86,35,51,0,7.92150993661926,15,0
36,1,10,68,13,55,0,4.70914594789065,37,0
36,1,10,53,1,52,0,5.65092942564479,49,0
36,1,1.5,0,98,-98,0,0.484774780696171,-48,0
36,1,1.5,65,25,40,0,0.50797620189951,25,0
36,1,1.5,16,64,-48,0,0.307146663322783,-14,0
36,1,1.5,97,7,90,0,0.442395562629827,43,0
36,1,1.5,79,38,41,0,0.508302221427584,12,0
36,1,1.5,49,87,-38,0,0.699498184822914,-37,0
36,1,1.5,90,44,46,0,0.665982471738062,6,0
36,1,1.5,100,1,99,0,0.506418854913136,49,0
36,1,1.5,39,89,-50,0,0.504846414431086,-39,0
36,1,1.5,86,17,69,0,0.335429461113563,33,0
36,1,1.5,86,38,48,0,0.433985768157982,12,0
36,1,1.5,14,77,-63,0,0.338516383051683,-27,0
36,1,1.5,83,35,48,0,0.319160482928055,15,0
36,1,1.5,79,19,60,0,0.452241654244062,31,0
36,1,1.5,94,14,80,0,0.509472873029154,36,0
36,1,1.5,31,95,-64,0,0.611460837474624,-45,0
36,1,1.5,93,18,75,0,0.277235880981607,32,0
36,1,1.5,82,16,66,0,0.756383762533915,34,0
36,1,1.5,76,27,49,0,0.528873449901766,23,0
36,1,1.5,12,58,-46,0,1.19864736441559,-8,0
37,1,10,30,100,-70,0,1.18379687243214,-50,0
37,1,10,85,15,70,1,5.10862371229086,-35,0
37,1,10,48,60,-12,0,4.13509015869386,-10,0
37,1,10,80,45,35,1,3.96583108335108,-5,0
37,1,10,50,43,7,1,3.46192382986919,-7,0
37,1,10,3,100,-97,0,3.42761268950926,-50,0
37,1,10,28,85,-57,0,3.4185985514323,-35,0
37,1,10,53,23,30,1,2.98557609381896,-27,0
37,1,10,53,23,30,1,4.05869472719314,-27,0
37,1,10,53,40,13,1,3.88018605522484,-10,0
37,1,10,0,68,-68,0,2.86100795649145,-18,0
37,1,10,75,0,75,1,3.00282343245817,-50,0
37,1,10,30,100,-70,0,2.85927914738386,-50,0
37,1,10,48,80,-32,0,4.52040388456771,-30,0
37,1,10,85,15,70,1,3.77908438090344,-35,0
37,1,10,28,85,-57,0,4.29194720969645,-35,0
37,1,10,50,43,7,0,4.60728869251034,7,0
37,1,10,48,100,-52,0,3.91795541753891,-50,0
37,1,10,48,100,-52,0,4.08068444248238,-50,0
37,1,10,53,0,53,1,3.21349725142863,-50,0
37,1,1.5,100,15,85,1,0.942005696993874,-35,0
37,1,1.5,75,0,75,NaN,NaN,0,0
37,1,1.5,100,0,100,1,0.7822615619516,-50,0
37,1,1.5,98,38,60,1,0.815461820955534,-12,0
37,1,1.5,25,55,-30,0,1.26324481269694,-5,0
37,1,1.5,5,83,-78,0,0.797460713090913,-33,0
37,1,1.5,100,0,100,1,0.64667577579894,-50,0
37,1,1.5,50,100,-50,0,1.0458884990112,-50,0
37,1,1.5,48,60,-12,NaN,NaN,0,0
37,1,1.5,100,15,85,1,0.873545822300002,-35,0
37,1,1.5,98,38,60,1,0.799306949604215,-12,0
37,1,1.5,5,83,-78,0,0.678386910421978,-33,0
37,1,1.5,53,0,53,1,0.818934532668209,-50,0
37,1,1.5,50,100,-50,0,1.06541706873759,-50,0
37,1,1.5,48,80,-32,0,1.02176848760246,-30,0
37,1,1.5,53,40,13,1,1.16411102847087,-10,0
37,1,1.5,80,45,35,0,0.709116364021611,5,0
37,1,1.5,25,55,-30,0,1.00903470820413,-5,0
37,1,1.5,0,68,-68,0,0.984746857111531,-18,0
37,1,1.5,3,100,-97,0,0.81713116168612,-50,0
37,1,10,49,97,-48,0,1.10901704881326,-47,0
37,1,10,51,3,48,1,3.91649859324207,-47,0
37,1,10,1,58,-57,0,3.30266449793817,-8,0
37,1,10,49,100,-51,0,4.2097380651503,-50,0
37,1,10,93,36,57,1,2.85566968859166,-14,0
37,1,10,68,31,37,1,4.932243223353,-19,0
37,1,10,50,77,-27,1,4.70935936931892,27,0
37,1,10,24,74,-50,0,3.31196541245299,-24,0
37,1,10,28,73,-45,0,3.35429270889108,-23,0
37,1,10,51,1,50,0,5.29062260442697,49,0
37,1,10,87,0,87,1,2.90775734558156,-50,0
37,1,10,43,54,-11,0,4.26215838280768,-4,0
37,1,10,26,55,-29,0,3.49015500790119,-5,0
37,1,10,49,98,-49,0,5.1651548946993,-48,0
37,1,10,49,99,-50,1,4.96422785213508,49,0
37,1,10,49,96,-47,1,4.0194139021205,46,0
37,1,10,24,62,-38,0,2.70488263820698,-12,0
37,1,10,51,2,49,1,3.57068756683839,-48,0
37,1,10,2,57,-55,0,3.20169353329766,-7,0
37,1,10,21,71,-50,0,3.28734912687105,-21,0
37,1,1.5,55,24,31,1,0.801385625964031,-26,0
37,1,1.5,80,47,33,1,0.823789808675429,-3,0
37,1,1.5,49,96,-47,0,1.05359735149977,-46,0
37,1,1.5,40,75,-35,0,1.32194402496862,-25,0
37,1,1.5,67,45,22,0,1.36353475876786,5,0
37,1,1.5,48,53,-5,0,1.25185133580453,-3,0
37,1,1.5,51,1,50,1,0.911499325275145,-49,0
37,1,1.5,1,54,-53,0,0.777164186256414,-4,0
37,1,1.5,49,98,-49,0,1.27243162037848,-48,0
37,1,1.5,51,4,47,NaN,NaN,0,0
37,1,1.5,61,24,37,1,0.773201237770991,-26,0
37,1,1.5,49,100,-51,0,0.820313776393959,-50,0
37,1,1.5,49,99,-50,0,0.905446531243797,-49,0
37,1,1.5,7,61,-54,0,0.795145370702812,-11,0
37,1,1.5,46,84,-38,0,0.873683474990685,-34,0
37,1,1.5,22,68,-46,0,0.684699010727854,-18,0
37,1,1.5,49,98,-49,0,0.75188589991194,-48,0
37,1,1.5,51,1,50,1,0.991690469316381,-49,0
37,1,1.5,32,73,-41,0,1.2547178926925,-23,0
37,1,1.5,60,10,50,1,0.922450260844926,-40,0
37,1,10,78,12,66,1,1.01161388491528,-38,0
37,1,10,21,100,-79,0,3.66985787732665,-50,0
37,1,10,1,75,-74,0,3.71207167066859,-25,0
37,1,10,51,2,49,0,4.3689647951287,48,0
37,1,10,49,97,-48,1,4.84694474190837,47,0
37,1,10,18,87,-69,0,4.2581522669243,-37,0
37,1,10,58,0,58,1,4.26754434615759,-50,0
37,1,10,50,34,16,0,4.70953566136086,16,0
37,1,10,49,96,-47,1,3.67014586124242,46,0
37,1,10,51,0,51,0,4.32027196740637,50,0
37,1,10,8,99,-91,0,6.16694045535587,-49,0
37,1,10,49,99,-50,1,4.97241697968457,49,0
37,1,10,65,21,44,1,7.20208566234032,-29,0
37,1,10,51,0,51,0,3.12599542134376,50,0
37,1,10,71,20,51,1,5.75769387742912,-30,0
37,1,10,51,2,49,0,4.74728781708836,48,0
37,1,10,4,98,-94,0,3.3545894470335,-48,0
37,1,10,59,43,16,1,4.98480421239947,-7,0
37,1,10,49,97,-48,1,5.90126201022758,47,0
37,1,10,59,2,57,0,6.09338984610622,48,0
37,1,1.5,12,66,-54,0,0.788608981038124,-16,0
37,1,1.5,51,1,50,1,0.57106158368515,-49,0
37,1,1.5,51,3,48,1,0.649611762770292,-47,0
37,1,1.5,2,64,-62,0,0.852090718661202,-14,0
37,1,1.5,74,31,43,1,0.846507030506473,-19,0
37,1,1.5,56,20,36,1,0.697612100862898,-30,0
37,1,1.5,49,96,-47,0,0.930743835393514,-46,0
37,1,1.5,45,51,-6,NaN,NaN,0,0
37,1,1.5,51,2,49,1,0.812369767229029,-48,0
37,1,1.5,6,76,-70,0,0.824084131860218,-26,0
37,1,1.5,51,0,51,1,0.825904105688096,-50,0
37,1,1.5,92,48,44,1,0.821593704909901,-2,0
37,1,1.5,6,53,-47,0,0.744717696476073,-3,0
37,1,1.5,40,71,-31,1,0.663163005945535,21,0
37,1,1.5,49,100,-51,0,0.92030909740788,-50,0
37,1,1.5,31,65,-34,0,0.919334661264656,-15,0
37,1,1.5,68,48,20,1,0.89443371233574,-2,0
37,1,1.5,49,96,-47,0,0.78281700262778,-46,0
37,1,1.5,49,97,-48,0,0.939271057270162,-47,0
37,1,1.5,59,46,13,0,1.27360378132835,4,0
37,1,10,13,99,-86,0,1.19739007552926,-49,0
37,1,10,49,99,-50,1,3.7216469849518,49,0
37,1,10,51,2,49,0,4.35981723053919,48,0
37,1,10,10,95,-85,1,3.56446723499175,45,0
37,1,10,51,0,51,1,2.58540372608513,-50,0
37,1,10,49,96,-47,1,3.10927363825795,46,0
37,1,10,58,20,38,0,4.12431793012365,30,0
37,1,10,61,19,42,1,5.05036975817166,-31,0
37,1,10,37,55,-18,0,2.79483172784421,-5,0
37,1,10,35,72,-37,0,2.71065137263213,-22,0
37,1,10,76,43,33,1,3.58775650034659,-7,0
37,1,10,49,97,-48,1,2.903370571712,47,0
37,1,10,51,4,47,0,4.34180525536067,46,0
37,1,10,50,57,-7,1,3.43446302390657,7,0
37,1,10,49,100,-51,1,2.2914273896713,50,0
37,1,10,51,2,49,0,3.2346459570872,48,0
37,1,10,79,32,47,1,5.03498918319929,-18,0
37,1,10,53,1,52,0,2.49946648786499,49,0
37,1,10,56,16,40,0,2.86599273469983,34,0
37,1,10,79,35,44,1,4.29776394144028,-15,0
37,1,1.5,81,12,69,1,0.61570603373184,-38,0
37,1,1.5,49,97,-48,0,0.866192270725151,-47,0
37,1,1.5,48,87,-39,0,1.26662545407999,-37,0
37,1,1.5,51,2,49,1,0.666924003444365,-48,0
37,1,1.5,88,33,55,1,0.987393954557774,-17,0
37,1,1.5,92,4,88,1,0.607128701445617,-46,0
37,1,1.5,43,52,-9,0,1.08219379215188,-2,0
37,1,1.5,84,34,50,1,0.753212316400095,-16,0
37,1,1.5,51,1,50,1,0.877698043233977,-49,0
37,1,1.5,49,99,-50,0,0.933438326417672,-49,0
37,1,1.5,95,29,66,1,0.60855654623083,-21,0
37,1,1.5,49,98,-49,0,0.746902932922239,-48,0
37,1,1.5,49,99,-50,0,0.712058086523029,-49,0
37,1,1.5,34,65,-31,0,1.11047568433241,-15,0
37,1,1.5,35,55,-20,0,0.92550276961083,-5,0
37,1,1.5,51,3,48,0,1.06715916012217,47,0
37,1,1.5,51,2,49,0,0.730937635891678,48,0
37,1,1.5,15,68,-53,0,0.760687219688407,-18,0
37,1,1.5,59,42,17,0,0.917017205785669,8,0
37,1,1.5,46,64,-18,0,1.08278847591828,-14,0
38,1,10,28,85,-57,0,3.64226895026513,-35,0
38,1,10,98,38,60,0,2.8465056819914,12,0
38,1,10,50,43,7,1,3.86842258046818,-7,0
38,1,10,0,68,-68,0,1.407920783593,-18,0
38,1,10,48,60,-12,0,2.34666642724551,-10,0
38,1,10,48,80,-32,0,4.94789926033081,-30,0
38,1,10,53,0,53,0,1.43646763140168,50,0
38,1,10,25,55,-30,0,1.52208644025632,-5,0
38,1,10,48,60,-12,0,3.23280837511447,-10,0
38,1,10,0,68,-68,0,2.48652687319554,-18,0
38,1,10,50,43,7,1,3.40173548733037,-7,0
38,1,10,75,0,75,0,7.64866163054648,50,0
38,1,10,3,100,-97,0,2.81241500959186,-50,0
38,1,10,100,15,85,0,7.86748980519042,35,0
38,1,10,48,80,-32,0,5.02247811531197,-30,0
38,1,10,3,100,-97,0,1.59564256298836,-50,0
38,1,10,100,0,100,0,2.75172786513758,50,0
38,1,10,48,100,-52,0,5.05681662217648,-50,0
38,1,10,25,55,-30,0,4.04460179406851,-5,0
38,1,10,98,38,60,0,3.36949859259767,12,0
38,1,1.5,48,100,-52,NaN,NaN,0,0
38,1,1.5,100,0,100,0,0.710416485731912,50,0
38,1,1.5,5,83,-78,0,0.657588501268037,-33,0
38,1,1.5,80,45,35,0,0.854811608132877,5,0
38,1,1.5,50,100,-50,0,1.06784087886263,-50,0
38,1,1.5,85,15,70,NaN,NaN,0,0
38,1,1.5,53,23,30,0,0.572164397930464,27,0
38,1,1.5,53,40,13,0,0.59597944881898,10,0
38,1,1.5,85,15,70,NaN,NaN,0,0
38,1,1.5,80,45,35,0,0.823651178330692,5,0
38,1,1.5,30,100,-70,0,0.733504636014914,-50,0
38,1,1.5,5,83,-78,0,0.647318011529933,-33,0
38,1,1.5,53,40,13,0,1.01250134413385,10,0
38,1,1.5,30,100,-70,0,1.21889674123304,-50,0
38,1,1.5,28,85,-57,0,0.39240381025229,-35,0
38,1,1.5,50,100,-50,0,1.15974007272234,-50,0
38,1,1.5,75,0,75,0,1.11215826999069,50,0
38,1,1.5,100,15,85,0,0.729860171311884,35,0
38,1,1.5,53,23,30,0,0.69896719746248,27,0
38,1,1.5,53,0,53,0,0.742175521805621,50,0
38,1,10,3,71,-68,0,3.74681947483987,-21,0
38,1,10,72,33,39,0,1.4510313023693,17,0
38,1,10,85,20,65,0,7.83442880802431,30,0
38,1,10,84,35,49,0,3.59801585724017,15,0
38,1,10,81,26,55,0,7.81283581500975,24,0
38,1,10,97,49,48,1,3.95314031029193,-1,0
38,1,10,62,44,18,1,5.93726290533959,-6,0
38,1,10,67,19,48,0,1.36080929279706,31,0
38,1,10,43,63,-20,0,5.06084868670587,-13,0
38,1,10,58,25,33,0,6.19273224374774,25,0
38,1,10,98,41,57,1,3.24350842446984,-9,0
38,1,10,59,17,42,0,2.78389050009173,33,0
38,1,10,68,37,31,0,6.19763037049961,13,0
38,1,10,99,28,71,0,1.55450264518731,22,0
38,1,10,23,74,-51,0,1.29392538105822,-24,0
38,1,10,3,60,-57,0,3.36466446207669,-10,0
38,1,10,61,14,47,0,1.50764864866869,36,0
38,1,10,60,18,42,0,4.03719966377867,32,0
38,1,10,31,98,-67,0,4.19207899918547,-48,0
38,1,10,14,85,-71,0,2.88538490268547,-35,0
38,1,1.5,72,32,40,0,1.42599519128817,18,0
38,1,1.5,95,7,88,0,1.1423149852908,43,0
38,1,1.5,64,40,24,NaN,NaN,0,0
38,1,1.5,44,78,-34,NaN,NaN,0,0
38,1,1.5,11,55,-44,0,0.828317469673493,-5,0
38,1,1.5,70,15,55,0,0.769524553332303,35,0
38,1,1.5,98,1,97,0,0.736608453300505,49,0
38,1,1.5,71,39,32,0,0.977112936809135,11,0
38,1,1.5,98,38,60,NaN,NaN,0,0
38,1,1.5,98,23,75,NaN,NaN,0,0
38,1,1.5,25,85,-60,0,0.800465524354877,-35,0
38,1,1.5,21,68,-47,0,0.606308501144667,-18,0
38,1,1.5,80,50,30,1,1.26012571039792,0,0
38,1,1.5,95,33,62,0,1.01509319155593,17,0
38,1,1.5,99,1,98,0,0.724127376714023,49,0
38,1,1.5,56,44,12,0,0.859982926349403,6,0
38,1,1.5,89,27,62,0,1.42437656959009,23,0
38,1,1.5,100,15,85,0,0.988623202620147,35,0
38,1,1.5,92,9,83,0,0.867010135314558,41,0
38,1,1.5,93,1,92,0,0.74136892777824,49,0
38,1,10,69,19,50,0,1.35214534999614,31,0
38,1,10,48,100,-52,0,2.08491942065484,-50,0
38,1,10,66,21,45,0,2.0629521100509,29,0
38,1,10,91,21,70,0,2.69768032982392,29,0
38,1,10,96,35,61,0,1.84281412572091,15,0
38,1,10,84,4,80,0,1.53432783283642,46,0
38,1,10,68,25,43,0,2.46236074863555,25,0
38,1,10,89,15,74,0,1.71294373318415,35,0
38,1,10,28,91,-63,0,2.26576130316971,-41,0
38,1,10,3,63,-60,0,2.14774560899968,-13,0
38,1,10,38,62,-24,0,1.75313759347227,-12,0
38,1,10,81,30,51,0,3.22709671134908,20,0
38,1,10,86,33,53,0,2.57475986778263,17,0
38,1,10,81,48,33,1,3.49997725121102,-2,0
38,1,10,100,38,62,0,2.67621774422514,12,0
38,1,10,46,57,-11,1,2.89340707194788,7,0
38,1,10,6,74,-68,0,1.63719785256581,-24,0
38,1,10,98,8,90,0,3.29199794735177,42,0
38,1,10,49,91,-42,0,5.46819346188022,-41,0
38,1,10,93,38,55,0,2.7891940369409,12,0
38,1,1.5,84,49,35,NaN,NaN,0,0
38,1,1.5,97,33,64,NaN,NaN,0,0
38,1,1.5,0,92,-92,0,0.697840018536226,-42,0
38,1,1.5,11,60,-49,0,0.899009459128138,-10,0
38,1,1.5,99,25,74,0,1.37204183910762,25,0
38,1,1.5,48,100,-52,NaN,NaN,0,0
38,1,1.5,44,68,-24,0,0.520886510892524,-18,0
38,1,1.5,41,82,-41,0,0.88068087771353,-32,0
38,1,1.5,27,88,-61,0,0.745043579383491,-38,0
38,1,1.5,90,13,77,0,1.44751845255996,37,0
38,1,1.5,56,19,37,NaN,NaN,0,0
38,1,1.5,26,55,-29,0,1.1202365868885,-5,0
38,1,1.5,12,87,-75,0,0.726566478411769,-37,0
38,1,1.5,6,86,-80,0,0.733022249316491,-36,0
38,1,1.5,84,27,57,0,0.970810213497316,23,0
38,1,1.5,14,98,-84,0,0.735168236195022,-48,0
38,1,1.5,50,56,-6,NaN,NaN,0,0
38,1,1.5,99,8,91,0,1.06891432510565,42,0
38,1,1.5,28,76,-48,0,0.629199229088044,-26,0
38,1,1.5,94,11,83,0,0.607660572495661,39,0
38,1,10,75,30,45,0,2.78198751777745,20,0
38,1,10,96,14,82,1,1.24180135515235,-36,0
38,1,10,56,44,12,0,4.5765336501554,6,0
38,1,10,36,73,-37,0,6.48444126012328,-23,0
38,1,10,50,95,-45,0,2.23520129085227,-45,0
38,1,10,58,26,32,0,1.65318302475862,24,0
38,1,10,10,68,-58,0,1.04979514872502,-18,0
38,1,10,96,21,75,0,2.61533076247724,29,0
38,1,10,71,4,67,0,1.79324451547836,46,0
38,1,10,38,82,-44,0,2.34066074305156,-32,0
38,1,10,8,61,-53,0,1.4866687516369,-11,0
38,1,10,98,15,83,0,2.55824491545536,35,0
38,1,10,98,44,54,1,2.85006743458143,-6,0
38,1,10,89,32,57,0,2.48977347452819,18,0
38,1,10,76,40,36,1,2.48902302813985,-10,0
38,1,10,55,2,53,0,2.50367635420662,48,0
38,1,10,90,32,58,0,3.17343104034626,18,0
38,1,10,7,95,-88,0,3.43989988218163,-45,0
38,1,10,98,11,87,0,3.25604866738468,39,0
38,1,10,95,30,65,0,2.43170655318499,20,0
38,1,1.5,45,56,-11,0,1.17764000012176,-6,0
38,1,1.5,81,38,43,0,0.980601637098516,12,0
38,1,1.5,76,24,52,0,0.984265723287535,26,0
38,1,1.5,89,43,46,1,1.21929339712915,-7,0
38,1,1.5,45,91,-46,0,1.36423309124621,-41,0
38,1,1.5,97,12,85,0,0.983930044934823,38,0
38,1,1.5,93,12,81,0,0.802178932925017,38,0
38,1,1.5,38,81,-43,0,0.96395597548144,-31,0
38,1,1.5,75,12,63,0,0.943635058525615,38,0
38,1,1.5,89,23,66,0,0.964704006919419,27,0
38,1,1.5,90,18,72,0,0.885691601612052,32,0
38,1,1.5,11,64,-53,0,0.700221765120659,-14,0
38,1,1.5,39,90,-51,0,1.44252916136247,-40,0
38,1,1.5,100,9,91,0,1.16277113957221,41,0
38,1,1.5,64,26,38,0,1.09440897523018,24,0
38,1,1.5,89,23,66,0,1.06944833140551,27,0
38,1,1.5,98,9,89,0,0.964368932303842,41,0
38,1,1.5,18,61,-43,0,0.887565604502015,-11,0
38,1,1.5,40,75,-35,NaN,NaN,0,0
38,1,1.5,76,42,34,NaN,NaN,0,0
39,1,10,53,0,53,0,5.92403017593961,50,0
39,1,10,48,80,-32,1,3.2376409973408,30,0
39,1,10,100,0,100,1,2.07528768681868,-50,0
39,1,10,48,100,-52,1,2.42466183686838,50,0
39,1,10,80,45,35,1,2.59996744151977,-5,0
39,1,10,85,15,70,1,2.67986070063398,-35,0
39,1,10,30,100,-70,0,2.26904352609745,-50,0
39,1,10,0,68,-68,0,2.32307868478256,-18,0
39,1,10,48,60,-12,1,2.84709945940858,10,0
39,1,10,50,43,7,0,2.73225097501745,7,0
39,1,10,53,23,30,0,2.57345156849215,27,0
39,1,10,53,23,30,0,2.30202181114964,27,0
39,1,10,30,100,-70,1,3.13799795745945,50,0
39,1,10,50,100,-50,1,1.6684256002095,50,0
39,1,10,75,0,75,1,3.82246513599512,-50,0
39,1,10,48,60,-12,1,4.57327678632828,10,0
39,1,10,5,83,-78,0,2.9898964872059,-33,0
39,1,10,3,100,-97,0,3.2223766883717,-50,0
39,1,10,53,40,13,0,2.94947230085654,10,0
39,1,10,3,100,-97,0,3.35923866932671,-50,0
39,1,1.5,28,85,-57,0,1.36593472797404,-35,0
39,1,1.5,100,0,100,0,0.871611223999025,50,0
39,1,1.5,50,100,-50,1,1.24538937139869,50,0
39,1,1.5,53,40,13,1,1.46832537969431,-10,0
39,1,1.5,80,45,35,1,1.43327446193643,-5,0
39,1,1.5,25,55,-30,0,1.04822090282551,-5,0
39,1,1.5,100,15,85,0,1.46327963899057,35,0
39,1,1.5,5,83,-78,0,1.33285652427594,-33,0
39,1,1.5,75,0,75,0,1.28714329079094,50,0
39,1,1.5,48,80,-32,1,1.41217321355771,30,0
39,1,1.5,50,43,7,1,1.03508929849704,-7,0
39,1,1.5,100,15,85,0,0.833451055314526,35,0
39,1,1.5,85,15,70,0,1.19192897133189,35,0
39,1,1.5,0,68,-68,1,1.41626474628265,18,0
39,1,1.5,48,100,-52,1,1.3985063954533,50,0
39,1,1.5,98,38,60,NaN,NaN,0,0
39,1,1.5,53,0,53,NaN,NaN,0,0
39,1,1.5,28,85,-57,0,0.874520033895351,-35,0
39,1,1.5,25,55,-30,0,0.990998007267535,-5,0
39,1,1.5,98,38,60,1,1.0874086336612,-12,0
39,1,10,64,48,16,1,1.70052665388312,-2,0
39,1,10,5,50,-45,0,3.77979413851426,0,0
39,1,10,53,40,13,0,2.71602793003422,10,0
39,1,10,3,53,-50,0,2.11857751579464,-3,0
39,1,10,69,7,62,0,4.07320267748355,43,0
39,1,10,12,86,-74,0,3.60542523343838,-36,0
39,1,10,84,25,59,0,6.06763681645452,25,0
39,1,10,97,44,53,1,2.9497732642717,-6,0
39,1,10,53,23,30,0,2.11689429412763,27,0
39,1,10,53,0,53,0,4.18676067180513,50,0
39,1,10,82,23,59,0,7.30338414604603,27,0
39,1,10,49,80,-31,1,2.53656196652128,30,0
39,1,10,15,68,-53,0,2.82524142539069,-18,0
39,1,10,12,76,-64,0,3.84630644948766,-26,0
39,1,10,30,100,-70,0,3.9704515941512,-50,0
39,1,10,100,15,85,0,3.84928831168781,35,0
39,1,10,49,97,-48,1,2.99746343798233,47,0
39,1,10,99,44,55,1,2.93259540757163,-6,0
39,1,10,42,52,-10,0,2.92567626771734,-2,0
39,1,10,5,76,-71,0,3.27953105966162,-26,0
39,1,1.5,16,58,-42,0,1.23580412434148,-8,0
39,1,1.5,49,80,-31,1,1.28943266545411,30,0
39,1,1.5,46,70,-24,NaN,NaN,0,0
39,1,1.5,5,69,-64,0,0.937617300622151,-19,0
39,1,1.5,74,44,30,1,1.00343531284489,-6,0
39,1,1.5,52,9,43,0,0.729762668669082,41,0
39,1,1.5,28,64,-36,0,1.09894486020767,-14,0
39,1,1.5,100,0,100,0,1.00528607181923,50,0
39,1,1.5,50,100,-50,1,0.923715628418904,50,0
39,1,1.5,46,68,-22,1,0.924744699915209,18,0
39,1,1.5,11,88,-77,0,0.771749932815055,-38,0
39,1,1.5,97,8,89,0,0.995605434151457,42,0
39,1,1.5,12,72,-60,0,0.930657710318883,-22,0
39,1,1.5,48,60,-12,1,1.2284327846919,10,0
39,1,1.5,49,89,-40,1,1.02602326615806,39,0
39,1,1.5,39,72,-33,0,1.28708804875941,-22,0
39,1,1.5,70,24,46,0,1.20942197929025,26,0
39,1,1.5,69,38,31,NaN,NaN,0,0
39,1,1.5,50,56,-6,1,1.19362939953271,6,0
39,1,1.5,47,98,-51,1,1.12861556638518,48,0
39,1,10,48,60,-12,1,1.77892294451703,10,0
39,1,10,96,0,96,0,1.68235142193453,50,0
39,1,10,100,46,54,1,4.32836078893024,-4,0
39,1,10,17,76,-59,0,6.44040641945185,-26,0
39,1,10,49,83,-34,1,3.04311750513853,33,0
39,1,10,49,91,-42,1,2.83884545473848,41,0
39,1,10,73,20,53,0,3.81870052742124,30,0
39,1,10,54,42,12,0,3.55950854023286,8,0
39,1,10,95,25,70,0,4.43845121379582,25,0
39,1,10,12,95,-83,0,3.95375552041014,-45,0
39,1,10,47,93,-46,1,2.52582569288325,43,0
39,1,10,72,12,60,0,2.19044739817127,38,0
39,1,10,47,86,-39,1,2.70041556608294,36,0
39,1,10,4,98,-94,0,2.17363329364343,-48,0
39,1,10,48,84,-36,1,2.02769954483756,34,0
39,1,10,89,3,86,0,2.39171856862322,47,0
39,1,10,9,85,-76,1,2.69302430307835,35,0
39,1,10,63,20,43,0,2.32618038898408,30,0
39,1,10,24,69,-45,0,2.43018905866256,-19,0
39,1,10,8,57,-49,0,2.5861388216199,-7,0
39,1,1.5,31,75,-44,1,0.96773296173842,25,0
39,1,1.5,84,25,59,1,1.09414785957824,-25,0
39,1,1.5,60,11,49,0,0.831759985053395,39,0
39,1,1.5,97,46,51,0,0.994931662493855,4,0
39,1,1.5,29,100,-71,1,1.05596384324144,50,0
39,1,1.5,49,97,-48,1,1.15430673324454,47,0
39,1,1.5,50,43,7,1,0.904668296865566,-7,0
39,1,1.5,2,79,-77,0,0.95304461886326,-29,0
39,1,1.5,81,24,57,0,1.21543792703096,26,0
39,1,1.5,31,85,-54,0,0.930427987992971,-35,0
39,1,1.5,30,76,-46,0,0.944148538783793,-26,0
39,1,1.5,14,57,-43,0,0.735192688637653,-7,0
39,1,1.5,7,53,-46,0,0.797670821999873,-3,0
39,1,1.5,50,94,-44,1,0.937429839959805,44,0
39,1,1.5,59,49,10,1,1.40781392301005,-1,0
39,1,1.5,68,41,27,0,1.34732208781224,9,0
39,1,1.5,81,9,72,0,0.993617324772458,41,0
39,1,1.5,45,98,-53,1,0.942084962148783,48,0
39,1,1.5,49,91,-42,1,0.996414443130107,41,0
39,1,1.5,30,100,-70,0,1.02474696393256,-50,0
39,1,10,49,94,-45,1,1.19954452301999,44,0
39,1,10,90,32,58,0,4.17912489489208,18,0
39,1,10,16,52,-36,0,3.2865226480817,-2,0
39,1,10,39,61,-22,0,4.52683997279746,-11,0
39,1,10,67,3,64,0,4.31744762004519,47,0
39,1,10,64,42,22,0,3.69211929974972,8,0
39,1,10,41,94,-53,1,3.71500006601445,44,0
39,1,10,95,14,81,0,2.66520888391005,36,0
39,1,10,48,84,-36,1,3.20236458342379,34,0
39,1,10,48,97,-49,1,2.39731672963717,47,0
39,1,10,80,34,46,0,2.59867423462947,16,0
39,1,10,73,30,43,0,3.34517519532756,20,0
39,1,10,53,23,30,0,3.07012300972065,27,0
39,1,10,7,92,-85,0,1.73924256343707,-42,0
39,1,10,44,100,-56,1,3.52002829831463,50,0
39,1,10,81,18,63,0,3.14089197577368,32,0
39,1,10,98,21,77,0,2.87326788119208,29,0
39,1,10,11,75,-64,0,4.1289956194837,-25,0
39,1,10,64,42,22,1,3.79038068511773,-8,0
39,1,10,36,52,-16,0,2.88120099909156,-2,0
39,1,1.5,28,94,-66,0,1.05701736612809,-44,0
39,1,1.5,49,92,-43,1,0.930072386285701,42,0
39,1,1.5,19,56,-37,0,1.05642238228575,-6,0
39,1,1.5,73,29,44,NaN,NaN,0,0
39,1,1.5,45,93,-48,1,0.945978770664169,43,0
39,1,1.5,2,78,-76,0,0.783664703115392,-28,0
39,1,1.5,20,72,-52,0,1.07478296181353,-22,0
39,1,1.5,57,8,49,0,1.08244168077226,42,0
39,1,1.5,50,47,3,1,0.810144653729367,-3,0
39,1,1.5,49,90,-41,1,0.933213937198161,40,0
39,1,1.5,52,18,34,0,0.927665584572424,32,0
39,1,1.5,47,100,-53,1,0.829287074024705,50,0
39,1,1.5,95,14,81,0,1.43968163192949,36,0
39,1,1.5,63,39,24,0,1.03263721643089,11,0
39,1,1.5,98,5,93,0,0.745662713798083,45,0
39,1,1.5,95,19,76,0,0.886776218059822,31,0
39,1,1.5,45,95,-50,1,0.861839120017521,45,0
39,1,1.5,49,51,-2,0,1.14221657704275,-1,0
39,1,1.5,26,55,-29,0,1.30713818920412,-5,0
39,1,1.5,98,37,61,0,1.37743533397588,13,0
40,1,10,50,43,7,0,4.07977074324481,7,0
40,1,10,48,80,-32,0,4.11581360260789,-30,0
40,1,10,100,15,85,0,3.17392610617571,35,0
40,1,10,3,100,-97,0,3.12697460596246,-50,0
40,1,10,48,100,-52,1,4.80934771909233,50,0
40,1,10,48,80,-32,0,3.84864774520247,-30,0
40,1,10,53,23,30,0,3.60611439999593,27,0
40,1,10,30,100,-70,0,2.94172211516343,-50,0
40,1,10,28,85,-57,0,3.44815268000639,-35,0
40,1,10,100,0,100,0,1.74249731481359,50,0
40,1,10,75,0,75,0,3.77002716588504,50,0
40,1,10,50,43,7,0,2.39490449386176,7,0
40,1,10,30,100,-70,0,4.1862960949602,-50,0
40,1,10,0,68,-68,0,2.21026962708493,-18,0
40,1,10,53,0,53,0,3.02635592539991,50,0
40,1,10,28,85,-57,0,3.09739657357386,-35,0
40,1,10,0,68,-68,0,2.46984710101424,-18,0
40,1,10,75,0,75,0,2.93841815871747,50,0
40,1,10,50,100,-50,0,4.32424510626333,-50,0
40,1,10,53,40,13,0,2.85496827878524,10,0
40,1,1.5,5,83,-78,0,1.4798975282356,-33,0
40,1,1.5,50,100,-50,NaN,NaN,0,0
40,1,1.5,48,60,-12,0,1.18670965551973,-10,0
40,1,1.5,48,100,-52,0,1.29173290698054,-50,0
40,1,1.5,25,55,-30,0,1.00069162488398,-5,0
40,1,1.5,80,45,35,1,1.25717765815716,-5,0
40,1,1.5,100,0,100,0,0.87942932938131,50,0
40,1,1.5,53,23,30,0,1.06922736391243,27,0
40,1,1.5,80,45,35,1,1.32221201840002,-5,0
40,1,1.5,48,60,-12,NaN,NaN,0,0
40,1,1.5,85,15,70,0,1.17908534963135,35,0
40,1,1.5,85,15,70,0,1.26810350554115,35,0
40,1,1.5,100,15,85,0,1.36107644751246,35,0
40,1,1.5,3,100,-97,0,1.00275127722125,-50,0
40,1,1.5,53,40,13,0,1.05848565663109,10,0
40,1,1.5,98,38,60,1,1.11221411638871,-12,0
40,1,1.5,5,83,-78,0,1.00393792434625,-33,0
40,1,1.5,53,0,53,0,1.41963541536097,50,0
40,1,1.5,25,55,-30,0,1.00258917355677,-5,0
40,1,1.5,98,38,60,1,1.04229159107308,-12,0
40,1,10,80,29,51,1,3.86995245330399,-21,0
40,1,10,7,55,-48,0,1.03416316391667,-5,0
40,1,10,25,54,-29,0,2.47981209930185,-4,0
40,1,10,21,71,-50,0,2.70048861796749,-21,0
40,1,10,87,24,63,0,3.6555261327394,26,0
40,1,10,94,23,71,1,2.85987666908477,-27,0
40,1,10,78,10,68,0,2.85706687222773,40,0
40,1,10,70,2,68,0,2.74078330250632,48,0
40,1,10,50,34,16,0,1.39875543697599,16,0
40,1,10,79,23,56,1,2.12562494956182,-27,0
40,1,10,32,71,-39,0,6.44144213164691,-21,0
40,1,10,95,31,64,1,3.50815609112578,-19,0
40,1,10,8,97,-89,0,5.12644995760093,-47,0
40,1,10,82,19,63,0,3.62297016245066,31,0
40,1,10,68,0,68,0,1.62851760946614,50,0
40,1,10,89,15,74,1,4.37870650400691,-35,0
40,1,10,97,7,90,0,3.25740436179331,43,0
40,1,10,96,25,71,1,3.78968970650567,-25,0
40,1,10,66,36,30,1,2.71590265397026,-14,0
40,1,10,23,74,-51,0,2.96579254724384,-24,0
40,1,1.5,99,2,97,0,0.702117503209593,48,0
40,1,1.5,100,1,99,0,0.656618294860891,49,0
40,1,1.5,31,56,-25,0,1.17375404083214,-6,0
40,1,1.5,98,7,91,0,0.764800303768425,43,0
40,1,1.5,70,13,57,0,1.06920985550823,37,0
40,1,1.5,27,61,-34,0,0.936267643804968,-11,0
40,1,1.5,49,91,-42,1,1.28066246433445,41,0
40,1,1.5,50,70,-20,NaN,NaN,0,0
40,1,1.5,80,2,78,0,1.03083505795075,48,0
40,1,1.5,25,56,-31,0,0.819891098424705,-6,0
40,1,1.5,87,15,72,0,0.919654282175543,35,0
40,1,1.5,10,82,-72,0,0.84874887132537,-32,0
40,1,1.5,61,32,29,0,1.15648290660465,18,0
40,1,1.5,96,33,63,1,0.972849339374079,-17,0
40,1,1.5,16,76,-60,0,0.907909464136537,-26,0
40,1,1.5,14,65,-51,0,0.87833777099695,-15,0
40,1,1.5,48,89,-41,0,1.15342044537647,-39,0
40,1,1.5,92,9,83,0,1.15309533243817,41,0
40,1,1.5,13,84,-71,0,1.03281682807938,-34,0
40,1,1.5,98,7,91,0,0.884470240180235,43,0
40,1,10,82,23,59,0,4.01392405346451,27,0
40,1,10,44,58,-14,1,4.77138225592535,8,0
40,1,10,34,67,-33,0,2.29796529481064,-17,0
40,1,10,33,57,-24,0,2.6685870997153,-7,0
40,1,10,84,17,67,0,2.99911103868362,33,0
40,1,10,41,73,-32,1,4.18088297965733,23,0
40,1,10,95,6,89,0,2.87497676130624,44,0
40,1,10,40,82,-42,1,2.88545101263298,32,0
40,1,10,96,26,70,1,2.36725661200217,-24,0
40,1,10,99,4,95,0,2.10986557539763,46,0
40,1,10,99,38,61,1,2.22191392273999,-12,0
40,1,10,25,83,-58,0,2.30658667407988,-33,0
40,1,10,29,86,-57,0,4.90368692025368,-36,0
40,1,10,31,99,-68,0,2.69622562363656,-49,0
40,1,10,53,0,53,0,1.44211862012526,50,0
40,1,10,96,2,94,0,4.64564807273018,48,0
40,1,10,85,17,68,0,3.97555287833347,33,0
40,1,10,11,53,-42,0,3.22903591857903,-3,0
40,1,10,89,14,75,0,3.56803513220984,36,0
40,1,10,40,98,-58,0,2.12496657322663,-48,0
40,1,1.5,95,43,52,0,0.94446187840731,7,0
40,1,1.5,21,56,-35,0,1.01621976737806,-6,0
40,1,1.5,97,8,89,0,1.17183173889862,42,0
40,1,1.5,97,10,87,0,1.0575030729633,40,0
40,1,1.5,88,43,45,1,0.93994652157744,-7,0
40,1,1.5,89,34,55,1,0.986980733903692,-16,0
40,1,1.5,92,41,51,1,1.12801816717001,-9,0
40,1,1.5,90,42,48,1,1.12767282900859,-8,0
40,1,1.5,85,16,69,0,1.06402253823398,34,0
40,1,1.5,82,12,70,0,0.801713149654461,38,0
40,1,1.5,20,70,-50,0,1.08414965528027,-20,0
40,1,1.5,89,47,42,1,1.37248166290374,-3,0
40,1,1.5,85,38,47,1,0.87341368351008,-12,0
40,1,1.5,24,51,-27,0,0.914475417233916,-1,0
40,1,1.5,99,3,96,0,0.73821047283127,47,0
40,1,1.5,99,5,94,0,0.721349578603622,45,0
40,1,1.5,27,71,-44,0,0.768505746013034,-21,0
40,1,1.5,75,27,48,1,1.10960868486109,-23,0
40,1,1.5,96,20,76,1,1.05325215339508,-30,0
40,1,1.5,94,8,86,0,0.774943706648628,42,0
40,1,10,0,84,-84,0,2.21861872049521,-34,0
40,1,10,62,18,44,0,3.26127009649099,32,0
40,1,10,79,32,47,1,3.21426425985192,-18,0
40,1,10,87,15,72,0,4.08120341362519,35,0
40,1,10,8,67,-59,0,2.79335288708899,-17,0
40,1,10,40,82,-42,1,3.58910589181687,32,0
40,1,10,48,78,-30,1,3.33601950746743,28,0
40,1,10,10,91,-81,0,3.5896045794434,-41,0
40,1,10,95,7,88,0,2.40118970876938,43,0
40,1,10,28,84,-56,0,2.51585073249953,-34,0
40,1,10,36,74,-38,0,2.71171331568257,-24,0
40,1,10,28,71,-43,0,2.78221059961652,-21,0
40,1,10,17,99,-82,0,4.04199394821808,-49,0
40,1,10,98,3,95,0,2.45942114873105,47,0
40,1,10,12,98,-86,0,3.43597981169296,-48,0
40,1,10,84,49,35,1,1.56497931209924,-1,0
40,1,10,25,96,-71,0,4.27092507529233,-46,0
40,1,10,99,7,92,0,4.11033347238299,43,0
40,1,10,89,14,75,0,3.81236580557379,36,0
40,1,10,79,27,52,1,3.87049913810188,-23,0
40,1,1.5,90,11,79,0,0.950112564632946,39,0
40,1,1.5,100,12,88,0,0.971134119588896,38,0
40,1,1.5,95,8,87,0,1.19953063662433,42,0
40,1,1.5,9,90,-81,0,0.770495364738963,-40,0
40,1,1.5,50,80,-30,0,1.09423268435239,-30,0
40,1,1.5,8,93,-85,0,0.901910421060165,-43,0
40,1,1.5,98,4,94,0,0.868977114492736,46,0
40,1,1.5,19,100,-81,0,0.781398873816215,-50,0
40,1,1.5,50,53,-3,1,1.25713388715121,3,0
40,1,1.5,14,53,-39,0,1.07349247132515,-3,0
40,1,1.5,46,63,-17,1,0.99843726702602,13,0
40,1,1.5,75,43,32,1,1.1208080255783,-7,0
40,1,1.5,24,91,-67,0,0.990417210849046,-41,0
40,1,1.5,80,9,71,0,1.08147630321946,41,0
40,1,1.5,74,47,27,1,1.07248543626702,-3,0
40,1,1.5,44,58,-14,1,1.03219407228607,8,0
40,1,1.5,100,5,95,0,0.888552716834965,45,0
40,1,1.5,100,38,62,1,1.19946875347523,-12,0
40,1,1.5,93,31,62,1,1.08186541238865,-19,0
40,1,1.5,99,4,95,0,0.984841086272354,46,0
41,1,10,30,100,-70,0,1.57725934380505,-50,0
41,1,10,48,80,-32,1,1.97011470779216,30,0
41,1,10,85,15,70,0,1.81894413519149,35,0
41,1,10,3,100,-97,0,2.30710860550971,-50,0
41,1,10,28,85,-57,0,1.65503257677665,-35,0
41,1,10,53,0,53,0,2.10125445956328,50,0
41,1,10,5,83,-78,0,1.89734253890674,-33,0
41,1,10,48,60,-12,1,2.02281379418491,10,0
41,1,10,53,40,13,1,1.92623110244858,-10,0
41,1,10,28,85,-57,0,1.57836237321135,-35,0
41,1,10,100,15,85,0,1.49641368792618,35,0
41,1,10,80,45,35,1,2.20181789809249,-5,0
41,1,10,0,68,-68,0,2.35040386812761,-18,0
41,1,10,100,15,85,0,4.03305741757868,35,0
41,1,10,75,0,75,0,2.87123841522407,50,0
41,1,10,53,23,30,0,3.41230241296944,27,0
41,1,10,30,100,-70,0,2.62003599544369,-50,0
41,1,10,100,0,100,0,2.60324332361597,50,0
41,1,10,25,55,-30,0,2.79514206467138,-5,0
41,1,10,0,68,-68,0,2.75568355732321,-18,0
41,1,1.5,85,15,70,0,0.900213313307177,35,0
41,1,1.5,75,0,75,0,0.800586272483997,50,0
41,1,1.5,50,43,7,1,0.993126787079746,-7,0
41,1,1.5,48,80,-32,NaN,NaN,0,0
41,1,1.5,50,100,-50,0,0.471385123571963,-50,0
41,1,1.5,53,23,30,0,0.652621247027128,27,0
41,1,1.5,48,100,-52,0,0.819199516383378,-50,0
41,1,1.5,100,0,100,0,0.94627973354909,50,0
41,1,1.5,80,45,35,1,1.02872831393324,-5,0
41,1,1.5,5,83,-78,0,1.0037335589077,-33,0
41,1,1.5,53,0,53,0,0.995497968249765,50,0
41,1,1.5,48,60,-12,0,0.787891170763032,-10,0
41,1,1.5,50,100,-50,0,1.00440642495778,-50,0
41,1,1.5,48,100,-52,1,1.14007843822765,50,0
41,1,1.5,53,40,13,1,0.942445393229718,-10,0
41,1,1.5,98,38,60,0,1.15290153241403,12,0
41,1,1.5,25,55,-30,1,1.25056823580962,5,0
41,1,1.5,98,38,60,0,1.10417564609088,12,0
41,1,1.5,3,100,-97,0,1.22793168158569,-50,0
41,1,1.5,50,43,7,1,0.738907790160738,-7,0
41,1,10,31,70,-39,0,2.72852530701493,-20,0
41,1,10,25,96,-71,0,1.81909959773657,-46,0
41,1,10,92,13,79,0,2.72919756932788,37,0
41,1,10,80,35,45,1,2.37106710455555,-15,0
41,1,10,96,12,84,0,2.65103975522288,38,0
41,1,10,41,76,-35,1,2.55165420961566,26,0
41,1,10,9,84,-75,0,2.40016275024573,-34,0
41,1,10,37,79,-42,0,2.58278203756345,-29,0
41,1,10,78,34,44,0,2.7813581213868,16,0
41,1,10,63,43,20,1,1.90990270517614,-7,0
41,1,10,60,34,26,1,2.421278790207,-16,0
41,1,10,43,95,-52,1,2.48327906490704,45,0
41,1,10,71,32,39,1,2.04584700430496,-18,0
41,1,10,66,31,35,1,2.2790695013955,-19,0
41,1,10,7,74,-67,0,2.18286052350777,-24,0
41,1,10,71,25,46,0,3.23025094128207,25,0
41,1,10,44,50,-6,1,2.94732752092386,0,0
41,1,10,95,14,81,0,3.3324354164597,36,0
41,1,10,90,36,54,0,3.73345090384828,14,0
41,1,10,37,52,-15,0,3.00628405027419,-2,0
41,1,1.5,89,3,86,0,0.906327368480561,47,0
41,1,1.5,98,14,84,0,0.81342385638527,36,0
41,1,1.5,92,18,74,0,0.812553567995565,32,0
41,1,1.5,0,85,-85,0,0.867014965737326,-35,0
41,1,1.5,52,38,14,1,1.04672604689767,-12,0
41,1,1.5,12,50,-38,0,1.23577303130151,0,0
41,1,1.5,58,44,14,1,0.920800478741512,-6,0
41,1,1.5,66,25,41,0,1.18652491156718,25,0
41,1,1.5,26,56,-30,1,1.02487555960579,6,0
41,1,1.5,95,27,68,0,1.05455079381682,23,0
41,1,1.5,80,37,43,1,1.04087280655949,-13,0
41,1,1.5,96,37,59,0,1.38198329213083,13,0
41,1,1.5,18,99,-81,0,1.2841662579649,-49,0
41,1,1.5,7,67,-60,0,0.775182786803271,-17,0
41,1,1.5,79,32,47,0,1.23100440635972,18,0
41,1,1.5,92,22,70,0,1.40465033512737,28,0
41,1,1.5,90,41,49,0,1.08223278687728,9,0
41,1,1.5,74,21,53,NaN,NaN,0,0
41,1,1.5,11,81,-70,0,0.823791246077235,-31,0
41,1,1.5,6,96,-90,0,0.724898954455057,-46,0
41,1,10,38,59,-21,0,1.08489315856968,-9,0
41,1,10,65,32,33,1,1.25175095863779,-18,0
41,1,10,45,74,-29,0,1.18723098321061,-24,0
41,1,10,95,11,84,0,1.29342820329839,39,0
41,1,10,93,16,77,0,3.32354658123586,34,0
41,1,10,66,8,58,0,3.85120306636418,42,0
41,1,10,76,48,28,1,2.90933790823692,-2,0
41,1,10,90,16,74,0,3.94249339040471,34,0
41,1,10,71,16,55,0,3.70196053120708,34,0
41,1,10,31,99,-68,0,4.25479862828615,-49,0
41,1,10,62,32,30,1,4.46347796640839,-18,0
41,1,10,55,18,37,0,4.49812800210384,32,0
41,1,10,29,55,-26,0,4.82672692231608,-5,0
41,1,10,100,26,74,0,3.98994086142193,24,0
41,1,10,93,8,85,0,4.25074996096009,42,0
41,1,10,49,52,-3,1,3.74877105858832,2,0
41,1,10,36,63,-27,1,4.33960752255371,13,0
41,1,10,89,6,83,0,4.73895186303889,44,0
41,1,10,99,36,63,1,3.79352978222414,-14,0
41,1,10,28,55,-27,0,4.22234499159458,-5,0
41,1,1.5,100,0,100,0,0.733878350385567,50,0
41,1,1.5,96,10,86,0,0.885705789974963,40,0
41,1,1.5,71,31,40,1,1.03213249089458,-19,0
41,1,1.5,93,16,77,0,0.611820630008879,34,0
41,1,1.5,30,75,-45,0,0.761048071713958,-25,0
41,1,1.5,82,23,59,0,0.912142271450648,27,0
41,1,1.5,19,92,-73,0,0.89658273457826,-42,0
41,1,1.5,53,42,11,1,0.729586074759936,-8,0
41,1,1.5,0,96,-96,0,0.761437784620284,-46,0
41,1,1.5,0,53,-53,0,0.727847912930883,-3,0
41,1,1.5,22,98,-76,0,0.988973974943292,-48,0
41,1,1.5,37,92,-55,0,1.01003296165982,-42,0
41,1,1.5,98,14,84,0,1.04574406696884,36,0
41,1,1.5,42,82,-40,0,1.08009495046281,-32,0
41,1,1.5,90,26,64,0,1.04911262338646,24,0
41,1,1.5,10,99,-89,0,1.1307757405757,-49,0
41,1,1.5,90,17,73,0,0.969806197650541,33,0
41,1,1.5,37,51,-14,1,0.790823828310749,1,0
41,1,1.5,20,55,-35,0,1.07525810312291,-5,0
41,1,1.5,89,22,67,0,0.924317856588459,28,0
41,1,10,82,22,60,0,1.0042877904325,28,0
41,1,10,19,90,-71,0,3.10846852545183,-40,0
41,1,10,27,63,-36,0,3.57152775668328,-13,0
41,1,10,84,16,68,0,4.23171108174029,34,0
41,1,10,92,39,53,1,3.44976496234267,-11,0
41,1,10,56,40,16,0,3.55469644562072,10,0
41,1,10,48,80,-32,1,3.11093871966114,30,0
41,1,10,70,13,57,0,3.62199995530136,37,0
41,1,10,92,21,71,0,3.84026423861178,29,0
41,1,10,4,71,-67,0,3.1376502038147,-21,0
41,1,10,65,32,33,0,3.92470092837539,18,0
41,1,10,96,18,78,0,4.57014187600362,32,0
41,1,10,64,27,37,0,3.83739104926099,23,0
41,1,10,11,92,-81,0,4.21421686630674,-42,0
41,1,10,97,12,85,0,4.51227267886861,38,0
41,1,10,50,33,17,0,4.00617416995192,17,0
41,1,10,44,97,-53,1,3.81622248408894,47,0
41,1,10,90,38,52,1,4.16173844616787,-12,0
41,1,10,27,90,-63,0,4.57445316937628,-40,0
41,1,10,85,26,59,0,3.65040764148944,24,0
41,1,1.5,75,35,40,0,0.949846316043477,15,0
41,1,1.5,100,28,72,0,0.626916194194564,22,0
41,1,1.5,79,25,54,1,0.909400395124976,-25,0
41,1,1.5,100,39,61,1,0.620427519565055,-11,0
41,1,1.5,30,51,-21,0,0.638937524259745,-1,0
41,1,1.5,15,88,-73,0,0.680019181338139,-38,0
41,1,1.5,12,58,-46,0,0.92849934628066,-8,0
41,1,1.5,1,60,-59,0,0.838924543890244,-10,0
41,1,1.5,8,76,-68,0,0.832004800298819,-26,0
41,1,1.5,98,19,79,1,0.713129081284933,-31,0
41,1,1.5,17,68,-51,0,1.08556753396442,-18,0
41,1,1.5,4,93,-89,0,0.876550102537294,-43,0
41,1,1.5,65,45,20,0,0.916262179864134,5,0
41,1,1.5,96,14,82,0,0.953980412301462,36,0
41,1,1.5,92,22,70,0,1.0543521640011,28,0
41,1,1.5,47,70,-23,0,1.40668402672964,-20,0
41,1,1.5,59,3,56,0,1.14487060895408,47,0
41,1,1.5,99,24,75,0,0.717947212746367,26,0
41,1,1.5,0,76,-76,0,0.883695040420207,-26,0
41,1,1.5,95,48,47,1,1.07475367998632,-2,0
42,1,10,53,0,53,1,2.09221619891832,-50,0
42,1,10,100,15,85,0,3.6322417672236,35,0
42,1,10,48,80,-32,0,3.32579429771795,-30,0
42,1,10,100,15,85,1,4.00080935343431,-35,0
42,1,10,48,100,-52,0,4.69556332263164,-50,0
42,1,10,85,15,70,1,3.69154544595222,-35,0
42,1,10,0,68,-68,0,3.96780480577581,-18,0
42,1,10,98,38,60,0,4.96058349502709,12,0
42,1,10,85,15,70,0,4.85773249305203,35,0
42,1,10,53,23,30,0,6.29496864066095,27,0
42,1,10,50,43,7,1,3.08238613608046,-7,0
42,1,10,53,23,30,0,4.30279097262974,27,0
42,1,10,48,100,-52,0,4.01018057535475,-50,0
42,1,10,28,85,-57,0,3.21769288783617,-35,0
42,1,10,53,0,53,0,4.76064839687024,50,0
42,1,10,5,83,-78,0,4.32190290415019,-33,0
42,1,10,98,38,60,0,4.68461302385549,12,0
42,1,10,25,55,-30,0,5.14046754714218,-5,0
42,1,10,28,85,-57,0,6.8542727721906,-35,0
42,1,10,100,0,100,0,4.66689723656236,50,0
42,1,1.5,3,100,-97,0,0.723379647406546,-50,0
42,1,1.5,80,45,35,1,1.03117798078893,-5,0
42,1,1.5,50,43,7,1,1.47820404265076,-7,0
42,1,1.5,0,68,-68,0,0.691830712174124,-18,0
42,1,1.5,48,60,-12,NaN,NaN,0,0
42,1,1.5,3,100,-97,0,0.766155393437657,-50,0
42,1,1.5,53,40,13,1,1.30401837206955,-10,0
42,1,1.5,25,55,-30,0,0.820291074509441,-5,0
42,1,1.5,5,83,-78,0,1.02014859232804,-33,0
42,1,1.5,80,45,35,1,1.08320752169311,-5,0
42,1,1.5,48,80,-32,0,1.27956969810839,-30,0
42,1,1.5,75,0,75,NaN,NaN,0,0
42,1,1.5,75,0,75,0,0.617649418694782,50,0
42,1,1.5,53,40,13,1,0.776936645561364,-10,0
42,1,1.5,50,100,-50,0,1.33806557533171,-50,0
42,1,1.5,30,100,-70,0,1.18039304586273,-50,0
42,1,1.5,30,100,-70,0,0.693431523599429,-50,0
42,1,1.5,100,0,100,0,1.12197354150339,50,0
42,1,1.5,48,60,-12,1,1.16500225377604,10,0
42,1,1.5,50,100,-50,0,1.31801030311181,-50,0
42,1,10,49,61,-12,0,3.68782430651481,-11,0
42,1,10,49,62,-13,0,3.36339449936349,-12,0
42,1,10,11,58,-47,0,5.06037294138878,-8,0
42,1,10,50,79,-29,0,3.56818546261275,-29,0
42,1,10,35,88,-53,0,4.45644351232841,-38,0
42,1,10,31,58,-27,0,3.53310888598935,-8,0
42,1,10,34,71,-37,0,3.23874161100684,-21,0
42,1,10,49,57,-8,0,4.22706501536231,-7,0
42,1,10,96,25,71,0,3.19246569366078,25,0
42,1,10,59,21,38,1,1.71962469864229,-29,0
42,1,10,59,31,28,1,5.58882787008042,-19,0
42,1,10,49,99,-50,1,2.09924038919053,49,0
42,1,10,49,96,-47,0,3.53391427253882,-46,0
42,1,10,12,69,-57,0,2.49415027374198,-19,0
42,1,10,38,63,-25,0,6.19276363838799,-13,0
42,1,10,51,1,50,0,6.81410155208141,49,0
42,1,10,92,0,92,0,4.81871924251027,50,0
42,1,10,49,98,-49,1,5.97530715658286,48,0
42,1,10,95,46,49,1,4.60544877843131,-4,0
42,1,10,5,52,-47,0,1.65071735884703,-2,0
42,1,1.5,83,35,48,NaN,NaN,0,0
42,1,1.5,89,49,40,0,0.862906226222549,1,0
42,1,1.5,82,1,81,0,0.691999456958001,49,0
42,1,1.5,55,7,48,0,1.11118896882181,43,0
42,1,1.5,99,3,96,NaN,NaN,0,0
42,1,1.5,1,59,-58,0,0.782115812373377,-9,0
42,1,1.5,94,23,71,1,1.17323120331639,-27,0
42,1,1.5,99,7,92,1,0.636917718373297,-43,0
42,1,1.5,51,1,50,1,0.754055879297084,-49,0
42,1,1.5,70,34,36,1,1.28254673040283,-16,0
42,1,1.5,89,49,40,1,1.21141461591833,-1,0
42,1,1.5,2,94,-92,0,0.665819262285368,-44,0
42,1,1.5,46,58,-12,1,1.27762052983235,8,0
42,1,1.5,15,62,-47,0,0.737246302804124,-12,0
42,1,1.5,23,75,-52,0,0.882421454756695,-25,0
42,1,1.5,21,76,-55,0,0.829516795558447,-26,0
42,1,1.5,36,69,-33,0,1.47527017762695,-19,0
42,1,1.5,55,7,48,NaN,NaN,0,0
42,1,1.5,23,52,-29,0,0.762033975683153,-2,0
42,1,1.5,75,0,75,1,0.594543760013039,-50,0
42,1,10,75,0,75,0,4.61050116025217,50,0
42,1,10,78,20,58,0,3.63109677802277,30,0
42,1,10,53,23,30,0,6.38800316390916,27,0
42,1,10,16,55,-39,0,6.75331660206211,-5,0
42,1,10,99,7,92,0,6.31124813514907,43,0
42,1,10,84,20,64,0,5.96735441719647,30,0
42,1,10,100,15,85,0,5.90886095492533,35,0
42,1,10,81,32,49,1,3.99710421305645,-18,0
42,1,10,13,89,-76,0,6.68185514847573,-39,0
42,1,10,2,99,-97,0,5.68311213108245,-49,0
42,1,10,88,9,79,0,5.5299926920743,41,0
42,1,10,85,15,70,0,5.74568565505251,35,0
42,1,10,96,25,71,0,5.81585601483675,25,0
42,1,10,89,49,40,1,4.97941016032928,-1,0
42,1,10,64,48,16,1,5.40056604700294,-2,0
42,1,10,50,93,-43,1,7.38021886743809,43,0
42,1,10,58,3,55,0,5.59263806087256,47,0
42,1,10,54,2,52,0,5.42896407338412,48,0
42,1,10,96,3,93,1,5.1358821566937,-47,0
42,1,10,33,97,-64,0,5.59031397127546,-47,0
42,1,1.5,43,50,-7,1,0.947575053261971,0,0
42,1,1.5,49,99,-50,0,0.867373887744179,-49,0
42,1,1.5,6,92,-86,0,0.997035990658333,-42,0
42,1,1.5,76,28,48,1,0.938757459131011,-22,0
42,1,1.5,18,100,-82,0,1.41850612298003,-50,0
42,1,1.5,13,67,-54,0,0.766763055784395,-17,0
42,1,1.5,50,93,-43,0,1.04522938002992,-43,0
42,1,1.5,49,60,-11,1,1.24824535342486,10,0
42,1,1.5,26,88,-62,0,0.923887089236814,-38,0
42,1,1.5,49,98,-49,0,0.994938604693743,-48,0
42,1,1.5,26,86,-60,0,1.00607576039329,-36,0
42,1,1.5,73,30,43,NaN,NaN,0,0
42,1,1.5,98,17,81,0,0.683558897235343,33,0
42,1,1.5,94,4,90,1,0.964058309342363,-46,0
42,1,1.5,22,60,-38,0,0.769698430154676,-10,0
42,1,1.5,96,25,71,1,0.798838148719369,-25,0
42,1,1.5,35,90,-55,0,1.27454176767787,-40,0
42,1,1.5,53,23,30,1,0.723577673485124,-27,0
42,1,1.5,23,64,-41,0,1.07533870189218,-14,0
42,1,1.5,43,50,-7,0,0.948349347305339,0,0
42,1,10,43,50,-7,0,4.52639954510596,0,0
42,1,10,17,61,-44,0,1.55634555582947,-11,0
42,1,10,77,8,69,1,4.10592075064778,-42,0
42,1,10,88,13,75,1,4.72855096562489,-37,0
42,1,10,14,89,-75,0,5.70240639149415,-39,0
42,1,10,53,23,30,1,5.47669167885033,-27,0
42,1,10,76,7,69,0,6.46825353407985,43,0
42,1,10,82,1,81,0,6.69164204403933,49,0
42,1,10,15,63,-48,0,5.88950028332329,-13,0
42,1,10,28,65,-37,0,6.0244188315155,-15,0
42,1,10,46,58,-12,1,5.89522975736327,8,0
42,1,10,17,70,-53,0,4.7893748567476,-20,0
42,1,10,81,38,43,1,7.44782183118878,-12,0
42,1,10,42,80,-38,0,6.99157276509868,-30,0
42,1,10,14,77,-63,0,3.08874138460669,-27,0
42,1,10,60,42,18,1,3.95979591874857,-8,0
42,1,10,32,92,-60,0,4.52329693529464,-42,0
42,1,10,78,20,58,1,3.98521057358812,-30,0
42,1,10,17,89,-72,0,3.70792878338398,-39,0
42,1,10,53,23,30,1,5.95345425433698,-27,0
42,1,1.5,16,56,-40,0,0.542084961358341,-6,0
42,1,1.5,75,0,75,1,1.39596948740291,-50,0
42,1,1.5,88,9,79,NaN,NaN,0,0
42,1,1.5,22,93,-71,0,0.94333168042067,-43,0
42,1,1.5,10,91,-81,0,0.573106229541736,-41,0
42,1,1.5,78,20,58,1,1.07359601202916,-30,0
42,1,1.5,45,61,-16,NaN,NaN,0,0
42,1,1.5,44,73,-29,0,0.773811697446945,-23,0
42,1,1.5,73,8,65,1,0.577533440620755,-42,0
42,1,1.5,11,91,-80,0,0.981994762896647,-41,0
42,1,1.5,71,49,22,0,1.08700835454874,1,0
42,1,1.5,2,72,-70,0,0.670713766608969,-22,0
42,1,1.5,18,66,-48,0,0.799134584100102,-16,0
42,1,1.5,82,42,40,1,0.881588899996132,-8,0
42,1,1.5,71,39,32,1,0.56133545076591,-11,0
42,1,1.5,78,20,58,1,0.725823880879034,-30,0
42,1,1.5,98,38,60,1,0.819623943971237,-12,0
42,1,1.5,89,49,40,NaN,NaN,0,0
42,1,1.5,67,46,21,1,0.502561250305007,-4,0
42,1,1.5,41,74,-33,0,1.0377813656487,-24,0
43,1,10,48,80,-32,1,3.53806968265189,30,0
43,1,10,28,85,-57,0,3.16363591842719,-35,0
43,1,10,85,15,70,1,4.21269791260329,-35,0
43,1,10,5,83,-78,0,3.56409041640563,-33,0
43,1,10,50,43,7,1,4.6536340045609,-7,0
43,1,10,50,43,7,1,3.12290648781118,-7,0
43,1,10,50,100,-50,1,4.38937615302984,50,0
43,1,10,53,40,13,1,4.1173991411606,-10,0
43,1,10,53,0,53,0,4.70411207871621,50,0
43,1,10,53,40,13,1,5.04342156539587,-10,0
43,1,10,48,100,-52,1,4.11322063357784,50,0
43,1,10,48,60,-12,1,4.81264641329744,10,0
43,1,10,3,100,-97,0,4.49188029923744,-50,0
43,1,10,100,15,85,0,4.94383500882759,35,0
43,1,10,98,38,60,1,4.36966936701492,-12,0
43,1,10,0,68,-68,0,4.68173252098222,-18,0
43,1,10,80,45,35,1,5.12631160018964,-5,0
43,1,10,100,15,85,1,5.43272190536345,-35,0
43,1,10,48,100,-52,1,4.90247949637933,50,0
43,1,10,75,0,75,0,5.48161998322576,50,0
43,1,1.5,53,0,53,0,0.976160634169901,50,0
43,1,1.5,98,38,60,1,1.20992461761989,-12,0
43,1,1.5,5,83,-78,0,1.17758359682284,-33,0
43,1,1.5,100,0,100,0,0.995270921775045,50,0
43,1,1.5,48,60,-12,1,1.22036605663016,10,0
43,1,1.5,28,85,-57,NaN,NaN,0,0
43,1,1.5,0,68,-68,0,1.00131559998908,-18,0
43,1,1.5,53,23,30,1,0.809653355742284,-27,0
43,1,1.5,25,55,-30,1,0.689411532388931,5,0
43,1,1.5,25,55,-30,1,0.597308676260127,5,0
43,1,1.5,30,100,-70,0,0.853110196847865,-50,0
43,1,1.5,100,0,100,1,0.914231662157363,-50,0
43,1,1.5,3,100,-97,0,0.694139748272846,-50,0
43,1,1.5,53,23,30,1,0.810523048008235,-27,0
43,1,1.5,85,15,70,0,1.09833836050848,35,0
43,1,1.5,50,100,-50,1,0.91869513659185,50,0
43,1,1.5,30,100,-70,1,0.84974915773364,50,0
43,1,1.5,48,80,-32,1,0.991534958052853,30,0
43,1,1.5,80,45,35,1,1.12796253632359,-5,0
43,1,1.5,75,0,75,0,0.754933079082548,50,0
43,1,10,71,49,22,1,3.36521343937238,-1,0
43,1,10,33,72,-39,1,2.71690872045428,22,0
43,1,10,33,63,-30,1,3.51873751937364,13,0
43,1,10,41,83,-42,1,3.42437304073292,33,0
43,1,10,65,36,29,1,4.26265193754898,-14,0
43,1,10,38,82,-44,1,4.15470987517347,32,0
43,1,10,13,69,-56,0,1.93079234168272,-19,0
43,1,10,0,72,-72,0,4.54890566792801,-22,0
43,1,10,15,100,-85,0,4.41351200010877,-50,0
43,1,10,56,47,9,1,4.30687462706828,-3,0
43,1,10,22,58,-36,1,5.06550921322923,8,0
43,1,10,46,85,-39,1,4.34729614858634,35,0
43,1,10,38,90,-52,0,4.58729619688575,-40,0
43,1,10,41,64,-23,1,3.59329529247816,14,0
43,1,10,50,76,-26,1,4.02349712991054,26,0
43,1,10,100,8,92,0,2.87630782679344,42,0
43,1,10,45,66,-21,1,3.23083043788665,16,0
43,1,10,45,94,-49,1,3.13177668480694,44,0
43,1,10,90,15,75,0,3.74088366993601,35,0
43,1,10,82,30,52,1,3.50971216034213,-20,0
43,1,1.5,48,62,-14,1,0.861323521100985,12,0
43,1,1.5,64,32,32,0,1.0264150214216,18,0
43,1,1.5,46,87,-41,1,0.864804403267044,37,0
43,1,1.5,21,53,-32,0,0.901208314799078,-3,0
43,1,1.5,45,70,-25,1,0.712363438798548,20,0
43,1,1.5,19,63,-44,0,0.875519941748735,-13,0
43,1,1.5,20,61,-41,0,0.885913986907326,-11,0
43,1,1.5,57,8,49,0,0.800363859004392,42,0
43,1,1.5,52,50,2,1,0.910167563935374,0,0
43,1,1.5,17,99,-82,0,0.783858723865251,-49,0
43,1,1.5,16,91,-75,NaN,NaN,0,0
43,1,1.5,72,25,47,0,0.856197438363324,25,0
43,1,1.5,39,77,-38,0,0.683301348023633,-27,0
43,1,1.5,63,40,23,1,0.677754456185085,-10,0
43,1,1.5,44,100,-56,0,0.856961777418292,-50,0
43,1,1.5,77,2,75,0,0.732728908786157,48,0
43,1,1.5,44,60,-16,1,0.661218228264715,10,0
43,1,1.5,49,82,-33,1,0.77699989777193,32,0
43,1,1.5,38,68,-30,1,1.01616828963552,18,0
43,1,1.5,69,27,42,0,0.733145793555195,23,0
43,1,10,21,88,-67,0,0.754309714095143,-38,0
43,1,10,49,83,-34,1,2.83061864472666,33,0
43,1,10,37,54,-17,1,3.15509838400658,4,0
43,1,10,32,91,-59,0,2.42614200868775,-41,0
43,1,10,46,69,-23,1,2.80665365700952,19,0
43,1,10,45,90,-45,0,2.2845732540959,-40,0
43,1,10,56,43,13,1,3.43858032876005,-7,0
43,1,10,67,1,66,0,3.86549478376401,49,0
43,1,10,14,95,-81,0,4.70771099270269,-45,0
43,1,10,39,64,-25,1,3.06023098717242,14,0
43,1,10,49,76,-27,1,3.85397234232278,26,0
43,1,10,41,99,-58,0,2.68075989047884,-49,0
43,1,10,83,40,43,1,3.9786115302154,-10,0
43,1,10,42,70,-28,1,3.46412259592535,20,0
43,1,10,6,80,-74,0,3.3383990850125,-30,0
43,1,10,48,81,-33,1,4.80133437640598,31,0
43,1,10,64,4,60,0,3.89321656434822,46,0
43,1,10,57,48,9,1,3.53404150715824,-2,0
43,1,10,73,24,49,0,3.92422693484741,26,0
43,1,10,13,72,-59,0,5.17176169989762,-22,0
43,1,1.5,39,64,-25,1,0.712508337198415,14,0
43,1,1.5,16,87,-71,0,0.825666741939131,-37,0
43,1,1.5,0,82,-82,0,0.710115400511768,-32,0
43,1,1.5,81,29,52,1,0.966571076997297,-21,0
43,1,1.5,80,20,60,0,0.92500183941047,30,0
43,1,1.5,46,87,-41,1,1.1327106757376,37,0
43,1,1.5,50,49,1,1,1.03570602751734,-1,0
43,1,1.5,41,74,-33,0,1.15074690395977,-24,0
43,1,1.5,3,65,-62,0,1.15707081346318,-15,0
43,1,1.5,14,83,-69,0,0.87473084921703,-33,0
43,1,1.5,76,47,29,1,0.842489747941272,-3,0
43,1,1.5,49,77,-28,1,0.836931083107174,27,0
43,1,1.5,71,15,56,0,0.839282663374888,35,0
43,1,1.5,68,28,40,1,1.11378030364449,-22,0
43,1,1.5,40,68,-28,1,1.29730861588587,18,0
43,1,1.5,44,75,-31,0,1.29770286027997,-25,0
43,1,1.5,13,58,-45,0,0.761962462666816,-8,0
43,1,1.5,49,86,-37,1,0.751713014035431,36,0
43,1,1.5,19,67,-48,0,0.885488649731997,-17,0
43,1,1.5,51,1,50,0,0.957858457010843,49,0
43,1,10,22,76,-54,0,0.922874247917662,-26,0
43,1,10,58,2,56,0,3.27847393711045,48,0
43,1,10,63,31,32,1,3.00676498727944,-19,0
43,1,10,30,53,-23,1,2.36988188466694,3,0
43,1,10,47,61,-14,1,3.04646141305921,11,0
43,1,10,13,70,-57,0,3.07153185481184,-20,0
43,1,10,56,22,34,1,2.5432223300968,-28,0
43,1,10,48,84,-36,1,3.58113107187728,34,0
43,1,10,1,83,-82,0,3.09740165273297,-33,0
43,1,10,42,73,-31,1,2.77643690711739,23,0
43,1,10,45,76,-31,1,2.83416231619822,26,0
43,1,10,41,61,-20,1,3.42733560925035,11,0
43,1,10,78,43,35,1,3.81360213898779,-7,0
43,1,10,84,4,80,0,4.22975396353058,46,0
43,1,10,4,67,-63,0,5.23173122293429,-17,0
43,1,10,100,1,99,0,5.73682832599252,49,0
43,1,10,85,3,82,0,5.85304620005536,47,0
43,1,10,30,71,-41,0,3.30861642657374,-21,0
43,1,10,47,61,-14,1,3.92292254738413,11,0
43,1,10,60,5,55,0,5.02433482378046,45,0
43,1,1.5,25,100,-75,0,0.746635532635082,-50,0
43,1,1.5,80,33,47,0,1.02441632912951,17,0
43,1,1.5,57,0,57,0,1.01877827204817,50,0
43,1,1.5,42,63,-21,1,0.709120431505198,13,0
43,1,1.5,45,77,-32,1,0.972204606003743,27,0
43,1,1.5,76,28,48,0,0.72856941911823,22,0
43,1,1.5,4,67,-63,0,0.743080088168426,-17,0
43,1,1.5,86,40,46,0,1.05219063538334,10,0
43,1,1.5,5,95,-90,0,0.772626984836734,-45,0
43,1,1.5,40,67,-27,1,0.848187877483724,17,0
43,1,1.5,56,48,8,1,1.01532335084539,-2,0
43,1,1.5,39,63,-24,1,0.873004445166771,13,0
43,1,1.5,16,64,-48,0,1.02544691899266,-14,0
43,1,1.5,47,85,-38,0,1.23581554655721,-35,0
43,1,1.5,40,69,-29,1,1.33271484156603,19,0
43,1,1.5,0,99,-99,0,0.873649243042564,-49,0
43,1,1.5,48,59,-11,1,0.81739304335315,9,0
43,1,1.5,78,21,57,0,1.32315366033026,29,0
43,1,1.5,16,53,-37,1,0.864733765297387,3,0
43,1,1.5,11,73,-62,0,0.912497409443858,-23,0
44,1,10,85,15,70,1,1.78976967084054,-35,0
44,1,10,28,85,-57,0,4.30644355223922,-35,0
44,1,10,0,68,-68,0,5.5604383709142,-18,0
44,1,10,75,0,75,1,3.72138970135347,-50,0
44,1,10,53,23,30,1,3.99630181141765,-27,0
44,1,10,25,55,-30,0,5.79641054559215,-5,0
44,1,10,48,100,-52,0,5.75597423236286,-50,0
44,1,10,50,43,7,1,2.86889204538602,-7,0
44,1,10,98,38,60,1,4.61006848756369,-12,0
44,1,10,25,55,-30,0,6.28134926262464,-5,0
44,1,10,98,38,60,1,5.76541194808669,-12,0
44,1,10,53,0,53,1,3.80639887523284,-50,0
44,1,10,80,45,35,0,5.89386347323307,5,0
44,1,10,100,15,85,1,5.02543786075148,-35,0
44,1,10,50,100,-50,0,5.33593430077781,-50,0
44,1,10,30,100,-70,1,6.28965707270982,50,0
44,1,10,50,43,7,0,5.70035105755414,7,0
44,1,10,0,68,-68,0,4.18338677561223,-18,0
44,1,10,5,83,-78,0,5.12740678849696,-33,0
44,1,10,48,80,-32,0,3.64990588741057,-30,0
44,1,1.5,100,0,100,1,0.635105119690706,-50,0
44,1,1.5,3,100,-97,0,0.754228508525557,-50,0
44,1,1.5,53,23,30,1,0.764721869461937,-27,0
44,1,1.5,28,85,-57,0,0.678577054379275,-35,0
44,1,1.5,50,100,-50,0,0.796394244520343,-50,0
44,1,1.5,53,40,13,1,0.829591071489631,-10,0
44,1,1.5,53,0,53,1,0.676628774654091,-50,0
44,1,1.5,48,60,-12,0,1.08247892676991,-10,0
44,1,1.5,48,80,-32,0,1.19887188639768,-30,0
44,1,1.5,75,0,75,1,0.807217853058319,-50,0
44,1,1.5,100,15,85,1,0.975703296506254,-35,0
44,1,1.5,53,40,13,1,0.984776351258915,-10,0
44,1,1.5,100,0,100,1,1.10516065803859,-50,0
44,1,1.5,48,60,-12,1,0.940879985009815,10,0
44,1,1.5,3,100,-97,1,1.19129249264006,50,0
44,1,1.5,80,45,35,1,1.39963556133443,-5,0
44,1,1.5,30,100,-70,1,1.26322669910587,50,0
44,1,1.5,85,15,70,1,1.15682659719459,-35,0
44,1,1.5,5,83,-78,0,1.36658906645607,-33,0
44,1,1.5,48,100,-52,1,1.21553399480217,50,0
44,1,10,49,98,-49,1,1.12739531737498,48,0
44,1,10,13,60,-47,0,2.03376076441964,-10,0
44,1,10,67,3,64,1,2.79117307220986,-47,0
44,1,10,49,97,-48,0,2.22236112436985,-47,0
44,1,10,61,21,40,1,3.33236829080306,-29,0
44,1,10,52,33,19,1,2.67742269713381,-17,0
44,1,10,64,26,38,1,3.29722559908623,-24,0
44,1,10,51,4,47,0,2.57958337376112,46,0
44,1,10,63,18,45,1,2.21083928667213,-32,0
44,1,10,49,100,-51,0,2.61758328078577,-50,0
44,1,10,56,0,56,1,2.21477961751043,-50,0
44,1,10,4,75,-71,0,3.73342955082808,-25,0
44,1,10,51,2,49,1,2.55829055401955,-48,0
44,1,10,51,3,48,0,3.15095398583071,47,0
44,1,10,49,99,-50,0,3.87134022458667,-49,0
44,1,10,51,4,47,1,4.9627862079742,-46,0
44,1,10,50,10,40,0,5.47462953899412,40,0
44,1,10,77,41,36,1,2.63756265691336,-9,0
44,1,10,25,72,-47,0,3.30689303914914,-22,0
44,1,10,84,17,67,0,2.33255937556714,33,0
44,1,1.5,49,96,-47,0,0.966472362872082,-46,0
44,1,1.5,25,80,-55,0,1.12689451228107,-30,0
44,1,1.5,7,67,-60,0,1.03324486574274,-17,0
44,1,1.5,74,37,37,1,0.734314940420518,-13,0
44,1,1.5,51,3,48,1,0.991435036439725,-47,0
44,1,1.5,13,89,-76,1,1.46247256331299,39,0
44,1,1.5,25,83,-58,0,1.00274284712759,-33,0
44,1,1.5,82,14,68,1,1.04910973108235,-36,0
44,1,1.5,51,2,49,1,0.757508646032875,-48,0
44,1,1.5,49,97,-48,0,0.965965218474594,-47,0
44,1,1.5,40,79,-39,0,1.14037006339277,-29,0
44,1,1.5,49,100,-51,0,0.925372535723,-50,0
44,1,1.5,20,68,-48,0,1.15112092086019,-18,0
44,1,1.5,41,86,-45,NaN,NaN,0,0
44,1,1.5,22,53,-31,0,0.746024844165731,-3,0
44,1,1.5,51,3,48,1,0.25051246833209,-47,0
44,1,1.5,51,4,47,1,0.414424857930499,-46,0
44,1,1.5,49,99,-50,0,0.740311922911133,-49,0
44,1,1.5,20,80,-60,0,0.572820844728994,-30,0
44,1,1.5,73,29,44,1,0.63602945072671,-21,0
44,1,10,6,81,-75,0,0.81133326946474,-31,0
44,1,10,44,100,-56,0,3.1576253496205,-50,0
44,1,10,72,27,45,1,3.62928352463496,-23,0
44,1,10,49,96,-47,0,2.94624998005384,-46,0
44,1,10,49,99,-50,0,2.53002359321181,-49,0
44,1,10,54,32,22,1,2.92263244662536,-18,0
44,1,10,33,74,-41,0,2.82709127223279,-24,0
44,1,10,95,18,77,1,4.61556979678062,-32,0
44,1,10,49,97,-48,0,3.14014547087572,-47,0
44,1,10,51,1,50,0,2.38785562336489,49,0
44,1,10,97,9,88,0,3.12849262087911,41,0
44,1,10,49,97,-48,0,3.56023823000578,-47,0
44,1,10,51,3,48,0,2.17515020724386,47,0
44,1,10,98,27,71,1,3.49379506911646,-23,0
44,1,10,29,88,-59,0,2.58278653399611,-38,0
44,1,10,49,96,-47,0,3.19595067429691,-46,0
44,1,10,51,0,51,0,2.08097802085103,50,0
44,1,10,38,57,-19,0,3.45904239558877,-7,0
44,1,10,62,38,24,1,2.46131579109715,-12,0
44,1,10,8,72,-64,0,1.84725811066528,-22,0
44,1,1.5,49,99,-50,1,0.828760018797766,49,0
44,1,1.5,38,62,-24,1,0.68852946129482,12,0
44,1,1.5,18,53,-35,0,0.570271236651024,-3,0
44,1,1.5,51,2,49,1,0.416847981785395,-48,0
44,1,1.5,51,0,51,1,0.700733227084129,-50,0
44,1,1.5,49,100,-51,0,0.773884580099548,-50,0
44,1,1.5,45,58,-13,1,0.908314371696179,8,0
44,1,1.5,49,92,-43,1,1.05341411914924,42,0
44,1,1.5,94,10,84,1,1.24843951561343,-40,0
44,1,1.5,76,28,48,1,0.794761118821043,-22,0
44,1,1.5,36,79,-43,0,0.742496568153001,-29,0
44,1,1.5,29,52,-23,0,0.756937202975678,-2,0
44,1,1.5,90,13,77,1,0.570722232914704,-37,0
44,1,1.5,51,2,49,0,0.88797969261941,48,0
44,1,1.5,51,0,51,1,0.464985343052831,-50,0
44,1,1.5,49,97,-48,0,1.04216970151174,-47,0
44,1,1.5,19,67,-48,0,0.573245880033937,-17,0
44,1,1.5,49,98,-49,0,0.658399046697014,-48,0
44,1,1.5,46,97,-51,0,0.596220124949468,-47,0
44,1,1.5,18,53,-35,0,0.768727706454229,-3,0
44,1,10,51,3,48,1,1.00826649484952,-47,0
44,1,10,51,2,49,0,2.00051563798843,48,0
44,1,10,69,15,54,1,4.09991261914911,-35,0
44,1,10,47,74,-27,0,3.6906084514485,-24,0
44,1,10,95,10,85,0,3.04210751594655,40,0
44,1,10,31,95,-64,0,2.53199843764378,-45,0
44,1,10,49,99,-50,0,3.23443206662705,-49,0
44,1,10,1,85,-84,0,1.25214982024409,-35,0
44,1,10,49,98,-49,0,5.49025803881887,-48,0
44,1,10,91,31,60,1,4.44922371782377,-19,0
44,1,10,50,58,-8,1,3.90322843788817,8,0
44,1,10,51,3,48,0,3.3659548340911,47,0
44,1,10,49,96,-47,0,3.46562500911023,-46,0
44,1,10,51,4,47,0,3.91319986271628,46,0
44,1,10,77,38,39,1,5.74337622218081,-12,0
44,1,10,2,69,-67,0,5.22696436538536,-19,0
44,1,10,2,72,-70,0,3.8439435597902,-22,0
44,1,10,66,26,40,1,4.61277174832503,-24,0
44,1,10,87,12,75,0,5.00663608598916,38,0
44,1,10,49,98,-49,0,4.72778515444224,-48,0
44,1,1.5,49,99,-50,0,0.793841919596161,-49,0
44,1,1.5,51,1,50,1,0.765645294886781,-49,0
44,1,1.5,46,52,-6,0,0.706094165976538,-2,0
44,1,1.5,58,11,47,1,0.881241615192266,-39,0
44,1,1.5,51,2,49,0,0.713634014544368,48,0
44,1,1.5,56,33,23,1,0.776756888990349,-17,0
44,1,1.5,52,21,31,1,0.699839083212282,-29,0
44,1,1.5,82,13,69,0,1.03493051711848,37,0
44,1,1.5,51,4,47,0,0.821325221568259,46,0
44,1,1.5,98,15,83,1,1.00714866407361,-35,0
44,1,1.5,51,4,47,0,0.823412362260569,46,0
44,1,1.5,61,21,40,1,0.849157185308286,-29,0
44,1,1.5,63,24,39,0,0.921548425474612,26,0
44,1,1.5,49,99,-50,0,1.41530088950094,-49,0
44,1,1.5,28,70,-42,0,0.904852205570933,-20,0
44,1,1.5,2,60,-58,0,0.751247525837243,-10,0
44,1,1.5,51,1,50,1,0.603668808274961,-49,0
44,1,1.5,77,33,44,1,1.14220604686125,-17,0
44,1,1.5,47,52,-5,0,0.987138497039268,-2,0
44,1,1.5,51,3,48,0,0.742185942210199,47,0
45,1,10,25,55,-30,1,4.15558879062519,5,0
45,1,10,5,83,-78,0,3.16362735545044,-33,0
45,1,10,53,40,13,1,4.35673735540149,-10,0
45,1,10,53,23,30,1,6.17408241024623,-27,0
45,1,10,85,15,70,0,4.5342188083514,35,0
45,1,10,3,100,-97,0,5.94349613747909,-50,0
45,1,10,98,38,60,1,8.1450884549422,-12,0
45,1,10,53,23,30,1,6.53787690022727,-27,0
45,1,10,3,100,-97,0,3.38717124289269,-50,0
45,1,10,48,80,-32,1,8.72357290971286,30,0
45,1,10,30,100,-70,0,5.46023134934512,-50,0
45,1,10,53,0,53,0,4.90520329934498,50,0
45,1,10,80,45,35,1,4.46044175453062,-5,0
45,1,10,80,45,35,1,4.13773242401112,-5,0
45,1,10,100,0,100,0,3.78782920435879,50,0
45,1,10,85,15,70,0,5.04334079385171,35,0
45,1,10,48,100,-52,1,5.36121684255704,50,0
45,1,10,5,83,-78,0,5.40220419530306,-33,0
45,1,10,53,0,53,0,5.40926408923769,50,0
45,1,10,25,55,-30,1,3.93563748870929,5,0
45,1,1.5,48,80,-32,1,1.49516193072759,30,0
45,1,1.5,50,43,7,1,1.44410893880831,-7,0
45,1,1.5,100,15,85,NaN,NaN,0,0
45,1,1.5,28,85,-57,0,1.44754424872281,-35,0
45,1,1.5,50,100,-50,1,0.901803610395291,50,0
45,1,1.5,30,100,-70,0,0.97759536178728,-50,0
45,1,1.5,48,60,-12,1,0.882656134774152,10,0
45,1,1.5,50,100,-50,0,0.711109194796336,-50,0
45,1,1.5,28,85,-57,1,0.938250497726585,35,0
45,1,1.5,48,100,-52,1,0.876091311864911,50,0
45,1,1.5,100,15,85,0,0.937145040353244,35,0
45,1,1.5,98,38,60,1,1.36288317917661,-12,0
45,1,1.5,75,0,75,0,0.859811323843132,50,0
45,1,1.5,0,68,-68,0,1.22494703367829,-18,0
45,1,1.5,50,43,7,1,1.03126649455862,-7,0
45,1,1.5,100,0,100,0,0.66961741297564,50,0
45,1,1.5,53,40,13,1,0.77883309972367,-10,0
45,1,1.5,75,0,75,0,0.595998540384244,50,0
45,1,1.5,48,60,-12,1,1.28448355060027,10,0
45,1,1.5,0,68,-68,0,0.680750171703949,-18,0
45,1,10,15,85,-70,0,1.57093526789231,-35,0
45,1,10,48,67,-19,1,2.12309190594988,17,0
45,1,10,73,20,53,0,5.64107717215302,30,0
45,1,10,44,65,-21,1,5.82133675841851,15,0
45,1,10,1,87,-86,0,7.64155050835234,-37,0
45,1,10,86,39,47,1,5.4932130413772,-11,0
45,1,10,67,30,37,1,7.47216950410711,-20,0
45,1,10,96,25,71,0,5.05055373718096,25,0
45,1,10,49,53,-4,1,4.3663993909413,3,0
45,1,10,30,77,-47,0,9.47640688945557,-27,0
45,1,10,95,25,70,0,6.06678572746387,25,0
45,1,10,46,50,-4,0,8.02091226520224,0,0
45,1,10,28,93,-65,0,6.9425316545985,-43,0
45,1,10,49,55,-6,1,2.01368754884243,5,0
45,1,10,42,81,-39,0,5.48026874532025,-31,0
45,1,10,35,57,-22,0,6.61057506146062,-7,0
45,1,10,96,10,86,0,7.39119701556592,40,0
45,1,10,99,25,74,0,7.6282602663232,25,0
45,1,10,88,8,80,0,6.64779957254723,42,0
45,1,10,41,56,-15,0,6.75524024854894,-6,0
45,1,1.5,82,14,68,NaN,NaN,0,0
45,1,1.5,53,33,20,1,1.40110839785302,-17,0
45,1,1.5,100,19,81,0,0.87136096859922,31,0
45,1,1.5,36,93,-57,0,1.1231380924537,-43,0
45,1,1.5,23,95,-72,0,1.03683785482008,-45,0
45,1,1.5,8,70,-62,0,1.02586750353748,-20,0
45,1,1.5,38,99,-61,0,0.943557719484488,-49,0
45,1,1.5,21,53,-32,0,0.880111650832077,-3,0
45,1,1.5,86,26,60,0,1.40375280161788,24,0
45,1,1.5,88,19,69,0,0.761542744190592,31,0
45,1,1.5,0,59,-59,0,0.742539865533217,-9,0
45,1,1.5,22,90,-68,0,1.06289851430301,-40,0
45,1,1.5,62,27,35,0,0.946684817498863,23,0
45,1,1.5,35,92,-57,0,1.05106178872666,-42,0
45,1,1.5,89,20,69,0,0.958753984959003,30,0
45,1,1.5,3,100,-97,0,0.966465018038434,-50,0
45,1,1.5,4,68,-64,0,0.677676807008538,-18,0
45,1,1.5,80,24,56,0,1.28870855917285,26,0
45,1,1.5,92,20,72,0,0.811005773251964,30,0
45,1,1.5,74,39,35,1,1.47211667640659,-11,0
45,1,10,99,23,76,0,2.73124681246554,27,0
45,1,10,84,20,64,0,3.70771010959015,30,0
45,1,10,5,55,-50,0,5.39660627025478,-5,0
45,1,10,98,15,83,0,4.73705846329904,35,0
45,1,10,67,39,28,1,4.08016230505018,-11,0
45,1,10,29,90,-61,0,3.49025499200525,-40,0
45,1,10,78,44,34,1,4.25186682251297,-6,0
45,1,10,20,98,-78,0,7.30256058606665,-48,0
45,1,10,85,7,78,0,4.02165819233778,43,0
45,1,10,73,2,71,0,2.4416897319843,48,0
45,1,10,96,26,70,0,4.31635737027864,24,0
45,1,10,83,34,49,0,7.06035221912498,16,0
45,1,10,28,99,-71,0,4.49350887650144,-49,0
45,1,10,15,65,-50,0,4.24612943233296,-15,0
45,1,10,100,31,69,0,3.12889661371264,19,0
45,1,10,90,26,64,0,5.21657127718572,24,0
45,1,10,29,56,-27,0,6.05230037190631,-6,0
45,1,10,71,7,64,0,3.62177725088168,43,0
45,1,10,2,87,-85,0,4.23336022236981,-37,0
45,1,10,48,85,-37,1,4.33202244386302,35,0
45,1,1.5,16,88,-72,0,1.04826101496747,-38,0
45,1,1.5,96,27,69,0,1.13928555841449,23,0
45,1,1.5,10,81,-71,0,0.962251782496423,-31,0
45,1,1.5,96,8,88,0,0.842025595412451,42,0
45,1,1.5,46,76,-30,1,1.06977939779972,26,0
45,1,1.5,86,19,67,NaN,NaN,0,0
45,1,1.5,34,81,-47,0,1.49800074043196,-31,0
45,1,1.5,74,48,26,1,1.29898128293371,-2,0
45,1,1.5,6,74,-68,0,0.939179359642367,-24,0
45,1,1.5,43,89,-46,0,0.866264152026815,-39,0
45,1,1.5,90,27,63,0,1.36997295849505,23,0
45,1,1.5,6,65,-59,0,0.999534856862738,-15,0
45,1,1.5,94,25,69,0,1.17994175694548,25,0
45,1,1.5,69,43,26,1,1.1689587270148,-7,0
45,1,1.5,45,86,-41,NaN,NaN,0,0
45,1,1.5,69,36,33,0,0.727131987383473,14,0
45,1,1.5,76,27,49,0,0.918262306981887,23,0
45,1,1.5,48,82,-34,1,0.901283785819032,32,0
45,1,1.5,88,14,74,0,1.2130315193599,36,0
45,1,1.5,53,15,38,0,0.744665954085576,35,0
45,1,10,54,11,43,0,1.78314202887213,39,0
45,1,10,73,49,24,1,2.80198914127959,-1,0
45,1,10,97,24,73,0,4.1890604218479,26,0
45,1,10,15,67,-52,0,3.96776427760597,-17,0
45,1,10,22,74,-52,0,5.39585732439446,-24,0
45,1,10,66,17,49,0,4.4388919769508,33,0
45,1,10,97,20,77,0,4.28012873681928,30,0
45,1,10,49,89,-40,1,4.70415737124404,39,0
45,1,10,84,22,62,0,2.96605326384542,28,0
45,1,10,25,62,-37,0,3.47445317014353,-12,0
45,1,10,95,16,79,0,4.09604865123219,34,0
45,1,10,53,5,48,0,3.75142095671799,45,0
45,1,10,97,24,73,0,4.54761832825261,26,0
45,1,10,41,65,-24,1,5.10427830139906,15,0
45,1,10,80,26,54,0,3.03797078259777,24,0
45,1,10,41,70,-29,1,4.24698403359616,20,0
45,1,10,99,30,69,0,4.96769967687487,20,0
45,1,10,97,7,90,0,3.59484448152671,43,0
45,1,10,53,22,31,0,4.48574380822993,28,0
45,1,10,18,69,-51,0,6.46031376055907,-19,0
45,1,1.5,94,5,89,0,0.941115268472458,45,0
45,1,1.5,65,1,64,0,0.914804054751585,49,0
45,1,1.5,88,14,74,0,0.921924926946303,36,0
45,1,1.5,43,84,-41,1,0.952318061638834,34,0
45,1,1.5,79,5,74,0,0.701331542060871,45,0
45,1,1.5,86,49,37,1,0.924483900772429,-1,0
45,1,1.5,2,78,-76,0,0.84220037963405,-28,0
45,1,1.5,31,63,-32,0,0.907949736041701,-13,0
45,1,1.5,96,8,88,0,0.970984352373307,42,0
45,1,1.5,100,9,91,0,0.743293641355194,41,0
45,1,1.5,88,24,64,0,0.674471523996544,26,0
45,1,1.5,87,20,67,0,0.851040718021068,30,0
45,1,1.5,10,69,-59,NaN,NaN,0,0
45,1,1.5,52,14,38,0,0.955865366278886,36,0
45,1,1.5,96,27,69,0,1.19231974005106,23,0
45,1,1.5,89,29,60,0,0.707231943430997,21,0
45,1,1.5,66,13,53,0,1.20968495998295,37,0
45,1,1.5,50,43,7,1,0.80398180215434,-7,0
45,1,1.5,12,88,-76,NaN,NaN,0,0
45,1,1.5,73,15,58,0,0.837576899260057,35,0
46,1,10,53,23,30,1,4.05597867072856,-27,0
46,1,10,48,100,-52,0,1.44476869691607,-50,0
46,1,10,3,100,-97,0,3.50418231280037,-50,0
46,1,10,53,40,13,1,3.0518644729882,-10,0
46,1,10,75,0,75,0,4.05692805453464,50,0
46,1,10,98,38,60,1,2.73436547293522,-12,0
46,1,10,28,85,-57,0,2.91226852711361,-35,0
46,1,10,53,40,13,1,3.06738184188225,-10,0
46,1,10,53,0,53,0,3.00051473297435,50,0
46,1,10,80,45,35,1,2.87156909236683,-5,0
46,1,10,100,15,85,1,2.81205917968282,-35,0
46,1,10,5,83,-78,0,3.99662512714212,-33,0
46,1,10,53,23,30,1,4.00466123089518,-27,0
46,1,10,100,0,100,1,3.62019791952298,-50,0
46,1,10,30,100,-70,0,3.33116383075776,-50,0
46,1,10,48,80,-32,0,3.47015482746019,-30,0
46,1,10,30,100,-70,0,2.95511698040264,-50,0
46,1,10,85,15,70,1,4.30890025223016,-35,0
46,1,10,0,68,-68,0,2.81560163404401,-18,0
46,1,10,0,68,-68,0,1.63086663891136,-18,0
46,1,1.5,100,15,85,1,0.647615640850745,-35,0
46,1,1.5,50,100,-50,1,0.678139915040447,50,0
46,1,1.5,53,0,53,NaN,NaN,0,0
46,1,1.5,28,85,-57,0,0.565177731910353,-35,0
46,1,1.5,50,100,-50,0,0.519040093898639,-50,0
46,1,1.5,75,0,75,1,0.418885686961858,-50,0
46,1,1.5,48,80,-32,0,0.506889792405218,-30,0
46,1,1.5,25,55,-30,0,0.583399863571231,-5,0
46,1,1.5,80,45,35,0,0.415323610995983,5,0
46,1,1.5,25,55,-30,0,0.62251508012605,-5,0
46,1,1.5,100,0,100,1,0.693022147676857,-50,0
46,1,1.5,48,100,-52,0,0.512880117444638,-50,0
46,1,1.5,98,38,60,1,0.444073488360573,-12,0
46,1,1.5,5,83,-78,0,0.531295748317007,-33,0
46,1,1.5,85,15,70,1,0.765139394312882,-35,0
46,1,1.5,3,100,-97,0,0.477635790729892,-50,0
46,1,1.5,50,43,7,1,0.482853628278008,-7,0
46,1,1.5,48,60,-12,0,0.502696806374388,-10,0
46,1,1.5,48,60,-12,0,0.546012555731068,-10,0
46,1,1.5,50,43,7,1,0.643841953423362,-7,0
46,1,10,39,79,-40,0,0.847720390033828,-29,0
46,1,10,51,0,51,0,3.09863996409422,50,0
46,1,10,26,57,-31,0,5.64640242192672,-7,0
46,1,10,51,3,48,0,3.46664618263367,47,0
46,1,10,54,27,27,0,3.82163965467635,23,0
46,1,10,68,7,61,1,3.95518882566375,-43,0
46,1,10,49,100,-51,0,4.4352413511906,-50,0
46,1,10,79,9,70,1,3.23129016370649,-41,0
46,1,10,93,41,52,1,3.68429747652726,-9,0
46,1,10,49,99,-50,0,2.67053156227394,-49,0
46,1,10,49,98,-49,0,3.33638529075597,-48,0
46,1,10,49,78,-29,1,3.62466862673091,28,0
46,1,10,17,57,-40,0,2.54167799227389,-7,0
46,1,10,9,95,-86,0,2.48617662253491,-45,0
46,1,10,21,94,-73,0,3.01679311826729,-44,0
46,1,10,41,65,-24,0,3.6218838681898,-15,0
46,1,10,49,100,-51,0,3.74550782767892,-50,0
46,1,10,51,1,50,0,4.08100285812998,49,0
46,1,10,51,2,49,0,3.90771540916512,48,0
46,1,10,13,85,-72,0,3.58921178294167,-35,0
46,1,1.5,60,12,48,1,0.63957621651889,-38,0
46,1,1.5,36,79,-43,0,0.515376891200049,-29,0
46,1,1.5,51,0,51,1,0.645266783809348,-50,0
46,1,1.5,73,16,57,1,0.593788144944938,-34,0
46,1,1.5,51,4,47,1,0.640323346859077,-46,0
46,1,1.5,68,31,37,1,0.524811864446747,-19,0
46,1,1.5,44,54,-10,0,0.677998035743258,-4,0
46,1,1.5,49,100,-51,1,0.673109237415702,50,0
46,1,1.5,51,1,50,1,0.804246460354989,-49,0
46,1,1.5,15,77,-62,0,0.6661474919988,-27,0
46,1,1.5,51,27,24,1,1.24389236585421,-23,0
46,1,1.5,74,14,60,1,0.576188470965917,-36,0
46,1,1.5,51,2,49,1,0.567442668856984,-48,0
46,1,1.5,39,96,-57,0,0.662590849707613,-46,0
46,1,1.5,9,68,-59,0,1.09773404968973,-18,0
46,1,1.5,49,100,-51,0,0.916135190761452,-50,0
46,1,1.5,8,80,-72,0,1.39715370299109,-30,0
46,1,1.5,51,4,47,1,1.13143159019728,-46,0
46,1,1.5,49,99,-50,0,0.643123802684386,-49,0
46,1,1.5,83,0,83,1,0.647695334753735,-50,0
46,1,10,85,6,79,1,0.94747753493948,-44,0
46,1,10,87,29,58,1,2.3830723337046,-21,0
46,1,10,66,13,53,1,3.78774106818719,-37,0
46,1,10,51,3,48,0,2.57652234011994,47,0
46,1,10,88,16,72,1,4.39848072722361,-34,0
46,1,10,49,96,-47,0,7.05908190301034,-46,0
46,1,10,49,100,-51,0,4.13222792548459,-50,0
46,1,10,12,75,-63,0,1.32364422801948,-25,0
46,1,10,49,98,-49,1,4.52781276251244,48,0
46,1,10,40,82,-42,0,5.30243176377189,-32,0
46,1,10,49,99,-50,1,5.00468749365791,49,0
46,1,10,85,19,66,1,4.54453580355948,-31,0
46,1,10,17,94,-77,0,3.75919646299553,-44,0
46,1,10,49,96,-47,1,2.62136948027,46,0
46,1,10,86,19,67,1,4.90516339304486,-31,0
46,1,10,51,2,49,0,1.91307784284709,48,0
46,1,10,50,76,-26,1,4.30582298084028,26,0
46,1,10,46,50,-4,0,5.08110972040868,0,0
46,1,10,51,0,51,0,4.02626461788623,50,0
46,1,10,84,13,71,1,4.1657180807224,-37,0
46,1,1.5,25,67,-42,0,0.63791713435603,-17,0
46,1,1.5,51,2,49,0,0.873128255278061,48,0
46,1,1.5,80,33,47,1,0.778867574710603,-17,0
46,1,1.5,51,1,50,0,0.744669230472937,49,0
46,1,1.5,50,82,-32,NaN,NaN,0,0
46,1,1.5,6,62,-56,0,0.545627670403519,-12,0
46,1,1.5,96,10,86,1,0.440823848719447,-40,0
46,1,1.5,49,99,-50,0,0.620109169493844,-49,0
46,1,1.5,49,98,-49,0,0.599861182595305,-48,0
46,1,1.5,39,95,-56,1,0.667671336021158,45,0
46,1,1.5,99,49,50,1,1.17152064209586,-1,0
46,1,1.5,54,30,24,1,0.784458524623005,-20,0
46,1,1.5,60,38,22,1,0.532959056669824,-12,0
46,1,1.5,56,21,35,1,0.795442095301951,-29,0
46,1,1.5,51,3,48,1,0.951869453857398,-47,0
46,1,1.5,49,99,-50,0,0.589591838333945,-49,0
46,1,1.5,69,31,38,1,0.609401206896109,-19,0
46,1,1.5,49,97,-48,0,0.573247947068012,-47,0
46,1,1.5,65,3,62,1,0.506408006536731,-47,0
46,1,1.5,51,1,50,1,0.554283816871248,-49,0
46,1,10,18,64,-46,0,0.673594041991237,-14,0
46,1,10,13,99,-86,0,3.55059586076368,-49,0
46,1,10,0,87,-87,0,3.05947433510846,-37,0
46,1,10,51,2,49,0,3.6925171177536,48,0
46,1,10,75,30,45,1,3.48338310973941,-20,0
46,1,10,39,71,-32,0,4.91494883834184,-21,0
46,1,10,51,1,50,0,3.92876818373497,49,0
46,1,10,49,100,-51,1,3.87098950034488,50,0
46,1,10,51,4,47,0,3.16638280032112,46,0
46,1,10,47,75,-28,1,5.84944014823486,25,0
46,1,10,49,100,-51,1,2.2062581276623,50,0
46,1,10,51,0,51,0,2.44890130877684,50,0
46,1,10,55,43,12,1,3.17017490187118,-7,0
46,1,10,64,18,46,1,5.85313716046858,-32,0
46,1,10,81,46,35,1,3.50802210994243,-4,0
46,1,10,85,38,47,1,2.59365532177253,-12,0
46,1,10,51,3,48,0,3.22079864250372,47,0
46,1,10,0,75,-75,0,3.32577694553584,-25,0
46,1,10,26,91,-65,0,2.03543877472293,-41,0
46,1,10,49,99,-50,1,3.06395983398761,49,0
46,1,1.5,27,96,-69,0,0.515223238940052,-46,0
46,1,1.5,70,17,53,1,0.448338621523362,-33,0
46,1,1.5,3,79,-76,0,0.480909881909611,-29,0
46,1,1.5,49,97,-48,0,0.616811230517669,-47,0
46,1,1.5,65,0,65,1,0.531246543368979,-50,0
46,1,1.5,19,73,-54,0,0.511811494654467,-23,0
46,1,1.5,89,48,41,1,0.422273583449169,-2,0
46,1,1.5,51,3,48,1,0.680138903771876,-47,0
46,1,1.5,49,100,-51,0,0.535942748097114,-50,0
46,1,1.5,51,4,47,1,0.644377774171517,-46,0
46,1,1.5,51,4,47,1,0.41088792080609,-46,0
46,1,1.5,49,97,-48,0,0.604821826183979,-47,0
46,1,1.5,51,2,49,1,0.462659072518363,-48,0
46,1,1.5,46,65,-19,0,0.463081691700609,-15,0
46,1,1.5,23,88,-65,0,0.638903648276937,-38,0
46,1,1.5,46,52,-6,0,0.551407289593953,-2,0
46,1,1.5,14,78,-64,0,0.539288986409701,-28,0
46,1,1.5,14,69,-55,0,0.471736932556269,-19,0
46,1,1.5,49,98,-49,0,0.453644907229318,-48,0
46,1,1.5,54,39,15,1,0.532147325969163,-11,0
47,1,10,98,38,60,0,4.2051448282964,12,0
47,1,10,53,0,53,0,2.72380059742682,50,0
47,1,10,80,45,35,NaN,NaN,0,0
47,1,10,98,38,60,1,3.34953508692342,-12,0
47,1,10,48,60,-12,1,3.19989318121407,10,0
47,1,10,53,40,13,1,4.09561219983152,-10,0
47,1,10,100,0,100,0,1.80370641372247,50,0
47,1,10,85,15,70,0,2.37988578537806,35,0
47,1,10,48,100,-52,1,2.62119228239317,50,0
47,1,10,100,0,100,0,2.45247304491932,50,0
47,1,10,50,43,7,1,2.22641736484184,-7,0
47,1,10,85,15,70,0,3.74573574047463,35,0
47,1,10,50,100,-50,1,2.09193601668449,50,0
47,1,10,30,100,-70,1,2.08518497711884,50,0
47,1,10,28,85,-57,1,3.12196039275659,35,0
47,1,10,48,60,-12,1,2.81303724152713,10,0
47,1,10,50,43,7,0,2.22883957649719,7,0
47,1,10,100,15,85,1,2.99622152613119,-35,0
47,1,10,0,68,-68,0,1.50868169804562,-18,0
47,1,10,0,68,-68,0,1.86945358179582,-18,0
47,1,1.5,75,0,75,0,0.813946174641387,50,0
47,1,1.5,48,100,-52,1,1.2063969885603,50,0
47,1,1.5,53,23,30,1,1.14208521635192,-27,0
47,1,1.5,5,83,-78,0,1.40844246540291,-33,0
47,1,1.5,28,85,-57,NaN,NaN,0,0
47,1,1.5,50,100,-50,1,1.03061638828876,50,0
47,1,1.5,53,23,30,0,1.16634929296561,27,0
47,1,1.5,48,80,-32,1,0.960041399797774,30,0
47,1,1.5,53,40,13,0,1.12978548879073,10,0
47,1,1.5,100,15,85,1,1.01281083839422,-35,0
47,1,1.5,48,80,-32,NaN,NaN,0,0
47,1,1.5,25,55,-30,0,1.05645653258398,-5,0
47,1,1.5,80,45,35,1,0.493454125164135,-5,0
47,1,1.5,5,83,-78,1,0.810020042436008,33,0
47,1,1.5,75,0,75,0,0.641849606157848,50,0
47,1,1.5,30,100,-70,1,0.760392777459856,50,0
47,1,1.5,25,55,-30,0,0.714164578195778,-5,0
47,1,1.5,53,0,53,0,0.749317438045182,50,0
47,1,1.5,3,100,-97,1,0.975136149509126,50,0
47,1,1.5,3,100,-97,1,1.04819462943851,50,0
47,1,10,87,23,64,1,3.40031368729979,-27,0
47,1,10,59,6,53,0,1.56729475245083,44,0
47,1,10,74,4,70,0,1.80751330694147,46,0
47,1,10,83,46,37,1,5.44699801341085,-4,0
47,1,10,27,93,-66,1,4.61066031049813,43,0
47,1,10,36,70,-34,1,3.95326983301311,20,0
47,1,10,21,64,-43,0,2.49742976418565,-14,0
47,1,10,35,87,-52,1,2.12533168634764,37,0
47,1,10,36,89,-53,1,2.08742546252688,39,0
47,1,10,4,60,-56,0,1.40280955544222,-10,0
47,1,10,39,96,-57,1,3.59838835505434,46,0
47,1,10,37,76,-39,1,3.54061872778766,26,0
47,1,10,49,69,-20,1,3.39758598234766,19,0
47,1,10,34,94,-60,1,3.41257085107281,44,0
47,1,10,42,54,-12,1,2.73088490240661,4,0
47,1,10,42,96,-54,1,2.30872607305901,46,0
47,1,10,21,63,-42,0,2.43939901864178,-13,0
47,1,10,10,100,-90,1,2.46449867375304,50,0
47,1,10,33,51,-18,0,3.9250639269103,-1,0
47,1,10,28,59,-31,0,2.74190681068103,-9,0
47,1,1.5,27,82,-55,1,0.876410497279721,32,0
47,1,1.5,39,83,-44,1,0.832853854988571,33,0
47,1,1.5,46,90,-44,1,0.749940197598335,40,0
47,1,1.5,40,62,-22,1,0.935115320422483,12,0
47,1,1.5,63,13,50,0,0.76814663197365,37,0
47,1,1.5,22,99,-77,1,0.728023770539949,49,0
47,1,1.5,3,82,-79,0,1.04976888589226,-32,0
47,1,1.5,38,80,-42,1,0.885483225512871,30,0
47,1,1.5,36,75,-39,1,1.10384753834114,25,0
47,1,1.5,50,20,30,0,0.945547373068621,30,0
47,1,1.5,11,59,-48,0,0.815983500970106,-9,0
47,1,1.5,15,69,-54,0,0.917101781515157,-19,0
47,1,1.5,17,85,-68,1,0.790164487634684,35,0
47,1,1.5,92,21,71,NaN,NaN,0,0
47,1,1.5,47,86,-39,1,0.712532362538695,36,0
47,1,1.5,99,41,58,1,1.09030198980508,-9,0
47,1,1.5,87,31,56,1,1.4933650732637,-19,0
47,1,1.5,1,85,-84,0,1.07161135459319,-35,0
47,1,1.5,40,69,-29,1,0.443325754586112,19,0
47,1,1.5,9,88,-79,0,0.936508454369687,-38,0
47,1,10,95,19,76,1,6.70673463109779,-31,0
47,1,10,50,3,47,0,1.77941909305264,47,0
47,1,10,92,37,55,1,3.92668497334489,-13,0
47,1,10,37,89,-52,1,3.03814836773199,39,0
47,1,10,30,91,-61,1,4.29793992591294,41,0
47,1,10,29,54,-25,0,4.17926453517794,-4,0
47,1,10,82,44,38,1,4.29732712809891,-6,0
47,1,10,53,41,12,0,2.00271416425494,9,0
47,1,10,74,49,25,1,4.10342129670971,-1,0
47,1,10,30,87,-57,1,2.48750636391378,37,0
47,1,10,6,95,-89,0,3.89475005669919,-45,0
47,1,10,4,70,-66,0,2.90356528910161,-20,0
47,1,10,36,54,-18,0,3.27201374842844,-4,0
47,1,10,36,97,-61,1,2.31371509250857,47,0
47,1,10,6,89,-83,0,1.69035934526619,-39,0
47,1,10,33,96,-63,NaN,NaN,0,0
47,1,10,84,40,44,1,2.65220256864086,-10,0
47,1,10,50,90,-40,1,2.41477964004116,40,0
47,1,10,49,68,-19,1,2.25076687090404,18,0
47,1,10,50,36,14,0,2.5291630311076,14,0
47,1,1.5,37,79,-42,1,0.717608622660919,29,0
47,1,1.5,35,54,-19,0,0.853404316474553,-4,0
47,1,1.5,28,81,-53,1,0.679788130159068,31,0
47,1,1.5,33,79,-46,1,0.761616561865594,29,0
47,1,1.5,37,62,-25,0,1.22406699844578,-12,0
47,1,1.5,97,17,80,1,1.14774921900789,-33,0
47,1,1.5,3,70,-67,0,0.898050108773532,-20,0
47,1,1.5,4,64,-60,0,1.01910846795181,-14,0
47,1,1.5,23,53,-30,1,0.799465430225609,3,0
47,1,1.5,41,69,-28,1,1.01124956238709,19,0
47,1,1.5,11,79,-68,0,1.04496129082327,-29,0
47,1,1.5,72,16,56,0,0.863317151266529,34,0
47,1,1.5,2,68,-66,0,0.69705061440618,-18,0
47,1,1.5,12,56,-44,0,0.969544595855041,-6,0
47,1,1.5,48,99,-51,1,0.742566700348107,49,0
47,1,1.5,34,81,-47,1,0.981004216855581,31,0
47,1,1.5,50,24,26,0,0.866042139381534,26,0
47,1,1.5,84,30,54,1,0.883160329363818,-20,0
47,1,1.5,7,94,-87,1,0.667574737659379,44,0
47,1,1.5,40,80,-40,1,0.740707175944408,30,0
47,1,10,35,85,-50,1,1.98728494164789,35,0
47,1,10,57,16,41,0,2.01535893019354,34,0
47,1,10,55,1,54,0,1.10545469871795,49,0
47,1,10,29,94,-65,1,2.64047126388141,44,0
47,1,10,95,37,58,1,2.10557484331548,-13,0
47,1,10,46,70,-24,1,3.78495661182387,20,0
47,1,10,19,83,-64,1,3.10785245883562,33,0
47,1,10,15,55,-40,0,2.44283008266029,-5,0
47,1,10,40,78,-38,1,3.57209057455839,28,0
47,1,10,66,22,44,0,2.45562367092316,28,0
47,1,10,35,58,-23,0,3.38153671702639,-8,0
47,1,10,85,7,78,0,3.04113417225562,43,0
47,1,10,63,13,50,0,2.18622446937115,37,0
47,1,10,36,82,-46,1,2.71684881374676,32,0
47,1,10,8,50,-42,0,1.32269273142629,0,0
47,1,10,16,72,-56,0,3.78945146869955,-22,0
47,1,10,37,77,-40,1,2.46429400532179,27,0
47,1,10,17,56,-39,0,3.45688337795764,-6,0
47,1,10,83,21,62,0,3.83311618075459,29,0
47,1,10,5,75,-70,0,4.21794898203916,-25,0
47,1,1.5,23,63,-40,1,0.679815298535686,13,0
47,1,1.5,6,52,-46,0,0.90436494496862,-2,0
47,1,1.5,0,96,-96,0,0.975428058616671,-46,0
47,1,1.5,20,93,-73,1,1.08233712757101,43,0
47,1,1.5,84,35,49,1,1.00939215107792,-15,0
47,1,1.5,43,69,-26,1,0.940472018557557,19,0
47,1,1.5,29,98,-69,1,0.881513925778563,48,0
47,1,1.5,24,84,-60,1,0.80124194014752,34,0
47,1,1.5,17,75,-58,0,1.20362913478493,-25,0
47,1,1.5,26,83,-57,1,1.28663757962204,33,0
47,1,1.5,3,75,-72,0,0.874910501053819,-25,0
47,1,1.5,7,81,-74,0,0.946657955904811,-31,0
47,1,1.5,49,90,-41,1,1.17565083929912,40,0
47,1,1.5,6,69,-63,0,1.02722728431763,-19,0
47,1,1.5,68,6,62,0,0.884970346947739,44,0
47,1,1.5,96,40,56,1,1.09208091469191,-10,0
47,1,1.5,24,87,-63,1,1.4830902953272,37,0
47,1,1.5,95,14,81,NaN,NaN,0,0
47,1,1.5,41,72,-31,1,0.881114550649727,22,0
47,1,1.5,74,4,70,0,0.664819260589866,46,0
48,1,10,100,0,100,0,1.28555808891178,50,0
48,1,10,100,15,85,1,2.13786143892139,-35,0
48,1,10,25,55,-30,1,2.91589007137372,5,0
48,1,10,5,83,-78,0,2.7270327279839,-33,0
48,1,10,100,0,100,0,2.6422236235594,50,0
48,1,10,48,80,-32,0,2.84813244347242,-30,0
48,1,10,80,45,35,1,3.55860177717113,-5,0
48,1,10,85,15,70,1,3.29634393418746,-35,0
48,1,10,53,40,13,1,3.30927728865208,-10,0
48,1,10,53,23,30,0,4.0969799760569,27,0
48,1,10,48,80,-32,1,4.20511011257986,30,0
48,1,10,48,100,-52,0,3.20371909172536,-50,0
48,1,10,3,100,-97,0,3.87549009250142,-50,0
48,1,10,53,0,53,0,3.01636717824294,50,0
48,1,10,80,45,35,1,3.54345178509175,-5,0
48,1,10,75,0,75,0,4.13771805027136,50,0
48,1,10,28,85,-57,0,4.0918336818977,-35,0
48,1,10,50,43,7,0,4.23994812113597,7,0
48,1,10,48,60,-12,0,4.54200008820408,-10,0
48,1,10,53,0,53,0,4.38399575635412,50,0
48,1,1.5,0,68,-68,0,0.767469535097916,-18,0
48,1,1.5,30,100,-70,0,0.776594486989779,-50,0
48,1,1.5,30,100,-70,0,0.826401063244703,-50,0
48,1,1.5,28,85,-57,0,0.930190900762682,-35,0
48,1,1.5,75,0,75,1,1.05405394195986,-50,0
48,1,1.5,53,23,30,0,1.05977831878772,27,0
48,1,1.5,50,100,-50,0,1.27407643133847,-50,0
48,1,1.5,53,40,13,0,1.38377901308922,10,0
48,1,1.5,98,38,60,1,1.09602908289526,-12,0
48,1,1.5,25,55,-30,1,1.21237312509766,5,0
48,1,1.5,48,60,-12,0,1.31605459098137,-10,0
48,1,1.5,85,15,70,NaN,NaN,0,0
48,1,1.5,100,15,85,1,1.10022961569848,-35,0
48,1,1.5,50,100,-50,0,0.943951079469116,-50,0
48,1,1.5,98,38,60,1,0.866337670366192,-12,0
48,1,1.5,0,68,-68,0,0.695508657558094,-18,0
48,1,1.5,3,100,-97,0,0.716009914100141,-50,0
48,1,1.5,48,100,-52,1,1.04713566594364,50,0
48,1,1.5,5,83,-78,0,1.10082430126204,-33,0
48,1,1.5,50,43,7,1,1.19987748335916,-7,0
48,1,10,1,60,-59,0,2.47516829818414,-10,0
48,1,10,100,0,100,0,1.96778438639012,50,0
48,1,10,32,83,-51,0,2.12056454140111,-33,0
48,1,10,54,12,42,0,1.82658912877741,38,0
48,1,10,6,86,-80,0,1.9613832151299,-36,0
48,1,10,72,0,72,0,3.51133333097459,50,0
48,1,10,73,43,30,1,3.81831726389646,-7,0
48,1,10,32,99,-67,0,3.19983190085986,-49,0
48,1,10,53,0,53,0,3.13421695221405,50,0
48,1,10,48,80,-32,1,3.72728901633309,30,0
48,1,10,65,2,63,0,3.10279098981482,48,0
48,1,10,53,23,30,0,2.99319949653363,27,0
48,1,10,3,51,-48,0,2.07231380747908,-1,0
48,1,10,85,47,38,1,3.10043609535569,-3,0
48,1,10,53,0,53,0,1.4387850127714,50,0
48,1,10,2,87,-85,0,4.26037179686682,-37,0
48,1,10,67,42,25,1,3.55241553794986,-8,0
48,1,10,48,100,-52,1,3.72066687561892,50,0
48,1,10,47,58,-11,0,3.81025731234695,-8,0
48,1,10,1,77,-76,0,2.14440841379837,-27,0
48,1,1.5,48,80,-32,0,0.802772122886381,-30,0
48,1,1.5,4,97,-93,0,0.793226664911344,-47,0
48,1,1.5,71,6,65,1,1.26435075646805,-44,0
48,1,1.5,75,0,75,0,0.763992888583743,50,0
48,1,1.5,20,95,-75,0,0.843790031372919,-45,0
48,1,1.5,62,11,51,1,1.19288675834105,-39,0
48,1,1.5,5,54,-49,0,0.895220069032803,-4,0
48,1,1.5,53,41,12,1,0.697657977972995,-9,0
48,1,1.5,82,48,34,1,0.860799547852366,-2,0
48,1,1.5,100,0,100,0,1.04130533245188,50,0
48,1,1.5,94,43,51,1,0.932245735602919,-7,0
48,1,1.5,0,89,-89,0,0.677356258067448,-39,0
48,1,1.5,15,83,-68,0,0.800485451240093,-33,0
48,1,1.5,73,20,53,1,0.958977606369444,-30,0
48,1,1.5,53,19,34,1,1.13474884864627,-31,0
48,1,1.5,25,55,-30,1,1.11101787594453,5,0
48,1,1.5,58,20,38,1,1.04939456547436,-30,0
48,1,1.5,48,100,-52,0,0.949093449307838,-50,0
48,1,1.5,26,55,-29,0,1.25286215586675,-5,0
48,1,1.5,53,23,30,1,0.927110006923613,-27,0
48,1,10,50,43,7,0,2.74914778606035,7,0
48,1,10,100,0,100,1,4.34029210296285,-50,0
48,1,10,75,35,40,0,4.44298494183022,15,0
48,1,10,21,64,-43,0,2.21368656514096,-14,0
48,1,10,71,7,64,0,5.59425695010214,43,0
48,1,10,12,78,-66,0,5.40655426269586,-28,0
48,1,10,81,36,45,1,4.83420170773752,-14,0
48,1,10,22,92,-70,0,4.54876712692203,-42,0
48,1,10,75,0,75,0,5.76407469558035,50,0
48,1,10,85,14,71,0,7.28225471625774,36,0
48,1,10,100,0,100,0,3.85730992089157,50,0
48,1,10,20,71,-51,0,4.2442201973281,-21,0
48,1,10,68,29,39,0,7.23955991522962,21,0
48,1,10,6,86,-80,0,5.05795260391824,-36,0
48,1,10,75,35,40,1,4.53177693018006,-15,0
48,1,10,96,23,73,1,5.09901669864485,-27,0
48,1,10,30,75,-45,0,4.73949818264373,-25,0
48,1,10,90,6,84,0,6.30475465965719,44,0
48,1,10,39,54,-15,0,5.95943192199047,-4,0
48,1,10,25,55,-30,0,5.98090822135782,-5,0
48,1,1.5,53,40,13,1,0.831946732530923,-10,0
48,1,1.5,48,80,-32,0,0.899044772635534,-30,0
48,1,1.5,91,46,45,1,0.859502106963191,-4,0
48,1,1.5,17,53,-36,0,0.861884169797122,-3,0
48,1,1.5,18,91,-73,0,0.760324855949875,-41,0
48,1,1.5,97,50,47,1,0.942739068028459,0,0
48,1,1.5,58,46,12,0,1.04580773609996,4,0
48,1,1.5,75,35,40,0,1.1447975253177,15,0
48,1,1.5,12,79,-67,0,1.20716524928503,-29,0
48,1,1.5,84,11,73,1,0.666807985140622,-39,0
48,1,1.5,48,80,-32,0,0.905921994213713,-30,0
48,1,1.5,53,23,30,1,1.00965175943566,-27,0
48,1,1.5,49,71,-22,0,1.14139906335186,-21,0
48,1,1.5,100,0,100,0,1.11567181875216,50,0
48,1,1.5,25,62,-37,0,1.17070891113326,-12,0
48,1,1.5,2,56,-54,0,1.06370173415053,-6,0
48,1,1.5,57,4,53,0,1.04073087223514,46,0
48,1,1.5,34,98,-64,0,1.0670829894807,-48,0
48,1,1.5,28,88,-60,NaN,NaN,0,0
48,1,1.5,71,33,38,NaN,NaN,0,0
48,1,10,6,89,-83,0,4.28329194448088,-39,0
48,1,10,64,34,30,0,6.27318953479698,16,0
48,1,10,0,53,-53,0,4.22132570873509,-3,0
48,1,10,19,69,-50,0,4.5892781942639,-19,0
48,1,10,71,7,64,0,5.31854894977005,43,0
48,1,10,65,2,63,0,6.69820949600398,48,0
48,1,10,53,23,30,0,4.38281121516047,27,0
48,1,10,34,100,-66,0,7.32003777677528,-50,0
48,1,10,84,44,40,1,7.25178296759623,-6,0
48,1,10,7,71,-64,0,3.49818232763209,-21,0
48,1,10,20,51,-31,0,5.05181889022424,-1,0
48,1,10,68,33,35,0,5.23419204787206,17,0
48,1,10,51,25,26,0,7.30451920039923,25,0
48,1,10,79,8,71,0,6.14823341927331,42,0
48,1,10,76,19,57,0,6.75025504831865,31,0
48,1,10,53,23,30,0,3.08681024917314,27,0
48,1,10,14,68,-54,0,5.99528723529511,-18,0
48,1,10,8,51,-43,0,7.76338884502184,-1,0
48,1,10,25,55,-30,0,5.4282623988729,-5,0
48,1,10,75,35,40,1,7.64312500990491,-15,0
48,1,1.5,64,34,30,0,0.72381689788017,16,0
48,1,1.5,79,50,29,1,0.712847817001602,0,0
48,1,1.5,95,7,88,0,0.830038908792631,43,0
48,1,1.5,11,58,-47,0,0.654437921675708,-8,0
48,1,1.5,94,24,70,1,0.628890592099197,-26,0
48,1,1.5,2,86,-84,0,0.509356982551253,-36,0
48,1,1.5,57,4,53,0,0.794522596446768,46,0
48,1,1.5,23,62,-39,0,0.781611882295692,-12,0
48,1,1.5,93,3,90,1,0.47805750403495,-47,0
48,1,1.5,53,23,30,0,0.691184961451654,27,0
48,1,1.5,19,57,-38,0,0.676363102986215,-7,0
48,1,1.5,12,57,-45,0,1.17062982097195,-7,0
48,1,1.5,65,2,63,0,0.781007536865218,48,0
48,1,1.5,15,83,-68,0,1.07009988669961,-33,0
48,1,1.5,72,0,72,0,1.18838737340047,50,0
48,1,1.5,45,89,-44,0,1.35798867748599,-39,0
48,1,1.5,22,54,-32,0,1.14365947223268,-4,0
48,1,1.5,50,43,7,1,1.12259341534809,-7,0
48,1,1.5,64,48,16,1,1.40619714948843,-2,0
48,1,1.5,58,48,10,0,0.672344900172902,2,0
49,1,10,48,80,-32,0,4.99780271234522,-30,0
49,1,10,53,40,13,0,7.54895924655921,10,0
49,1,10,48,60,-12,0,6.60530466848104,-10,0
49,1,10,25,55,-30,NaN,NaN,0,0
49,1,10,3,100,-97,0,1.46719434250645,-50,0
49,1,10,98,38,60,1,4.72531441292631,-12,0
49,1,10,48,100,-52,0,4.7919615383762,-50,0
49,1,10,100,15,85,1,4.50309816107347,-35,0
49,1,10,3,100,-97,1,4.27510165313561,50,0
49,1,10,0,68,-68,0,5.57581051031866,-18,0
49,1,10,53,23,30,1,5.59209985638972,-27,0
49,1,10,80,45,35,1,4.45507053610982,-5,0
49,1,10,30,100,-70,0,5.22043222775574,-50,0
49,1,10,50,43,7,1,4.59472644967354,-7,0
49,1,10,50,100,-50,0,4.36214661041413,-50,0
49,1,10,48,60,-12,0,3.28350488003343,-10,0
49,1,10,5,83,-78,0,3.27184112744271,-33,0
49,1,10,53,40,13,1,3.47622697372481,-10,0
49,1,10,5,83,-78,0,2.90449631409683,-33,0
49,1,10,28,85,-57,0,3.73096124133281,-35,0
49,1,1.5,80,45,35,1,0.597898828574216,-5,0
49,1,1.5,53,23,30,1,0.565775662147644,-27,0
49,1,1.5,53,0,53,1,0.423621451146573,-50,0
49,1,1.5,50,43,7,1,0.511588327272875,-7,0
49,1,1.5,100,0,100,1,0.460129920483269,-50,0
49,1,1.5,48,100,-52,0,0.538712181967639,-50,0
49,1,1.5,75,0,75,1,0.533222025428586,-50,0
49,1,1.5,53,0,53,1,0.536484362357442,-50,0
49,1,1.5,28,85,-57,0,1.09037918270678,-35,0
49,1,1.5,85,15,70,1,0.630680982833837,-35,0
49,1,1.5,98,38,60,1,0.621193731515632,-12,0
49,1,1.5,30,100,-70,0,0.732426530817065,-50,0
49,1,1.5,0,68,-68,0,0.606878330218933,-18,0
49,1,1.5,75,0,75,1,0.486773797782917,-50,0
49,1,1.5,100,15,85,1,0.515292001906346,-35,0
49,1,1.5,25,55,-30,0,0.494538564182221,-5,0
49,1,1.5,48,80,-32,0,0.603068698310381,-30,0
49,1,1.5,50,100,-50,1,0.51430306734801,50,0
49,1,1.5,100,0,100,1,0.677520739211104,-50,0
49,1,1.5,85,15,70,1,0.489262133427474,-35,0
49,1,10,49,98,-49,0,3.14840452551289,-48,0
49,1,10,15,93,-78,0,3.08550635558549,-43,0
49,1,10,81,25,56,1,3.51332711331088,-25,0
49,1,10,75,4,71,1,3.18021676318676,-46,0
49,1,10,87,49,38,1,3.17261229112501,-1,0
49,1,10,21,95,-74,0,3.32500511428589,-45,0
49,1,10,49,97,-48,0,3.43933663557891,-47,0
49,1,10,51,1,50,1,3.28431178542814,-49,0
49,1,10,51,0,51,1,3.55131989010351,-50,0
49,1,10,63,18,45,1,3.25491181151028,-32,0
49,1,10,49,97,-48,0,2.90522926071117,-47,0
49,1,10,41,96,-55,0,2.90035764107961,-46,0
49,1,10,0,64,-64,0,3.95081262342683,-14,0
49,1,10,51,0,51,1,3.09569123442634,-50,0
49,1,10,49,100,-51,0,2.76275657414135,-50,0
49,1,10,51,4,47,1,2.33124663166654,-46,0
49,1,10,45,82,-37,0,2.23725709577684,-32,0
49,1,10,65,47,18,1,3.20711813779326,-3,0
49,1,10,30,54,-24,0,3.34948245210762,-4,0
49,1,10,12,58,-46,0,3.26983216544886,-8,0
49,1,1.5,68,13,55,1,0.542946850463522,-37,0
49,1,1.5,94,49,45,1,0.384797619151868,-1,0
49,1,1.5,51,0,51,1,0.528727444645483,-50,0
49,1,1.5,49,100,-51,0,0.603290574654238,-50,0
49,1,1.5,50,92,-42,1,0.345779381218563,42,0
49,1,1.5,95,30,65,1,0.475034275175858,-20,0
49,1,1.5,53,40,13,1,0.575614293144099,-10,0
49,1,1.5,51,2,49,1,0.480111771903466,-48,0
49,1,1.5,59,9,50,1,0.596009408121063,-41,0
49,1,1.5,49,98,-49,0,0.562548644311391,-48,0
49,1,1.5,58,15,43,1,0.553065317337314,-35,0
49,1,1.5,7,59,-52,0,0.592935741553447,-9,0
49,1,1.5,80,42,38,1,0.463457461888538,-8,0
49,1,1.5,46,63,-17,0,0.483285962041009,-13,0
49,1,1.5,49,97,-48,0,0.574497364613308,-47,0
49,1,1.5,49,99,-50,0,0.509733924038301,-49,0
49,1,1.5,91,7,84,1,0.472285725372785,-43,0
49,1,1.5,64,50,14,1,0.499477803270565,0,0
49,1,1.5,51,1,50,1,0.613370401837528,-49,0
49,1,1.5,49,100,-51,0,0.891220863823037,-50,0
49,1,10,76,24,52,1,3.14852799139771,-26,0
49,1,10,91,2,89,1,3.34759605038016,-48,0
49,1,10,37,93,-56,0,3.24260688156937,-43,0
49,1,10,49,98,-49,0,4.06292175881572,-48,0
49,1,10,49,100,-51,0,2.70571654342257,-50,0
49,1,10,51,2,49,1,2.54757606641579,-48,0
49,1,10,56,11,45,1,2.77072631201918,-39,0
49,1,10,51,4,47,1,2.44131722154998,-46,0
49,1,10,28,98,-70,0,2.8932304295613,-48,0
49,1,10,39,66,-27,0,3.07903450942922,-16,0
49,1,10,39,79,-40,0,2.42341829090219,-29,0
49,1,10,78,49,29,1,2.27535764107961,-1,0
49,1,10,51,2,49,0,2.02136386690017,48,0
49,1,10,75,5,70,1,2.17739968830756,-45,0
49,1,10,43,75,-32,0,2.23138718353766,-25,0
49,1,10,49,97,-48,0,1.91542621445387,-47,0
49,1,10,8,77,-69,0,2.2841774521321,-27,0
49,1,10,49,98,-49,0,2.75817988401741,-48,0
49,1,10,51,1,50,1,2.01268442659602,-49,0
49,1,10,31,65,-34,0,4.21392234565519,-15,0
49,1,1.5,49,100,-51,0,0.759555215473483,-50,0
49,1,1.5,49,96,-47,0,0.534726256474642,-46,0
49,1,1.5,57,43,14,1,0.47056988165059,-7,0
49,1,1.5,51,0,51,1,0.353820662897306,-50,0
49,1,1.5,21,53,-32,0,0.440336739423401,-3,0
49,1,1.5,80,29,51,1,0.492231955829084,-21,0
49,1,1.5,93,21,72,1,0.541454694320237,-29,0
49,1,1.5,79,0,79,1,0.908659438790892,-50,0
49,1,1.5,51,2,49,1,0.533123614968645,-48,0
49,1,1.5,29,76,-47,0,0.596234001317498,-26,0
49,1,1.5,9,54,-45,1,0.735387900786918,4,0
49,1,1.5,49,97,-48,NaN,NaN,0,0
49,1,1.5,51,2,49,1,1.11165485998845,-48,0
49,1,1.5,80,36,44,1,0.584058272838774,-14,0
49,1,1.5,55,20,35,1,0.707878856685056,-30,0
49,1,1.5,51,3,48,1,0.435623602894339,-47,0
49,1,1.5,92,27,65,1,0.382189741967522,-23,0
49,1,1.5,9,53,-44,0,0.49145131334808,-3,0
49,1,1.5,54,42,12,1,0.587982012581051,-8,0
49,1,1.5,49,99,-50,0,0.584481800063259,-49,0
49,1,10,51,3,48,1,2.52103844826343,-47,0
49,1,10,20,54,-34,0,1.8389160063316,-4,0
49,1,10,54,10,44,1,1.66500993217142,-40,0
49,1,10,51,1,50,1,3.10301315375636,-49,0
49,1,10,51,0,51,1,2.12675694121845,-50,0
49,1,10,91,16,75,1,2.15012459545142,-34,0
49,1,10,36,52,-16,0,2.02747920154343,-2,0
49,1,10,38,54,-16,0,1.69418953911008,-4,0
49,1,10,49,98,-49,0,1.75768511486513,-48,0
49,1,10,77,50,27,1,1.83446670643389,0,0
49,1,10,51,4,47,1,2.55106993960999,-46,0
49,1,10,78,6,72,1,3.68427725120546,-44,0
49,1,10,15,69,-54,0,2.58712590195591,-19,0
49,1,10,49,99,-50,0,2.79101396036003,-49,0
49,1,10,46,65,-19,0,3.4181210309398,-15,0
49,1,10,16,94,-78,0,2.38779611944938,-44,0
49,1,10,51,2,49,1,2.92704196930481,-48,0
49,1,10,49,97,-48,0,2.90078358328446,-47,0
49,1,10,67,25,42,1,3.74726477541572,-25,0
49,1,10,40,83,-43,0,3.20806601768163,-33,0
49,1,1.5,33,86,-53,0,0.646260324606374,-36,0
49,1,1.5,71,46,25,1,0.528155094241811,-4,0
49,1,1.5,64,31,33,1,0.534625431034328,-19,0
49,1,1.5,51,1,50,1,0.62050002833621,-49,0
49,1,1.5,54,50,4,1,0.566986473050747,0,0
49,1,1.5,63,25,38,1,0.491462180760209,-25,0
49,1,1.5,49,98,-49,0,0.499318414549634,-48,0
49,1,1.5,49,99,-50,0,0.514543961663549,-49,0
49,1,1.5,34,64,-30,0,0.71301702980054,-14,0
49,1,1.5,51,4,47,1,0.592168985210265,-46,0
49,1,1.5,57,3,54,1,0.480677782984458,-47,0
49,1,1.5,51,2,49,1,0.384500576536993,-48,0
49,1,1.5,6,62,-56,0,0.468394285995601,-12,0
49,1,1.5,20,60,-40,0,0.508252937181169,-10,0
49,1,1.5,2,80,-78,0,0.563432527213081,-30,0
49,1,1.5,49,98,-49,0,0.559920239792518,-48,0
49,1,1.5,51,4,47,1,0.660420261527179,-46,0
49,1,1.5,49,96,-47,0,0.508898340747692,-46,0
49,1,1.5,98,13,85,1,0.691417443244973,-37,0
49,1,1.5,46,91,-45,0,0.850519686277948,-41,0
50,1,10,100,0,100,1,1.51956017806879,-50,0
50,1,10,28,85,-57,1,1.12244891749651,35,0
50,1,10,80,45,35,1,1.3539848813889,-5,0
50,1,10,50,100,-50,1,2.22480032374369,50,0
50,1,10,98,38,60,1,1.14407265386035,-12,0
50,1,10,30,100,-70,0,1.38721803327644,-50,0
50,1,10,5,83,-78,0,1.37666607738356,-33,0
50,1,10,50,100,-50,0,3.05477150094885,-50,0
50,1,10,48,60,-12,0,3.26855916860586,-10,0
50,1,10,53,23,30,1,1.74563738016877,-27,0
50,1,10,0,68,-68,0,2.28442649681892,-18,0
50,1,10,100,15,85,1,2.65363326021179,-35,0
50,1,10,53,40,13,1,2.78820322461615,-10,0
50,1,10,48,60,-12,0,2.56469737311636,-10,0
50,1,10,50,43,7,1,2.59863056751055,-7,0
50,1,10,48,100,-52,0,2.26258360096836,-50,0
50,1,10,53,40,13,1,3.07652775936731,-10,0
50,1,10,25,55,-30,0,2.77638913948249,-5,0
50,1,10,3,100,-97,0,2.65747307937636,-50,0
50,1,10,100,15,85,1,2.95137169124791,-35,0
50,1,1.5,0,68,-68,0,1.11526072771812,-18,0
50,1,1.5,85,15,70,1,0.567006396449869,-35,0
50,1,1.5,25,55,-30,0,0.472885545990721,-5,0
50,1,1.5,50,43,7,1,0.654801507080265,-7,0
50,1,1.5,85,15,70,1,0.597307460007869,-35,0
50,1,1.5,5,83,-78,0,0.574521212358377,-33,0
50,1,1.5,3,100,-97,0,0.688354945770698,-50,0
50,1,1.5,98,38,60,1,0.50152631038145,-12,0
50,1,1.5,53,0,53,1,0.49745042685754,-50,0
50,1,1.5,53,23,30,1,0.662006299851782,-27,0
50,1,1.5,75,0,75,0,0.787878711595113,50,0
50,1,1.5,53,0,53,0,0.444299722410506,50,0
50,1,1.5,80,45,35,1,0.578901081560616,-5,0
50,1,1.5,48,100,-52,0,0.652058692852734,-50,0
50,1,1.5,48,80,-32,0,1.03392538834305,-30,0
50,1,1.5,48,80,-32,0,1.19224427203881,-30,0
50,1,1.5,75,0,75,0,0.863956034445437,50,0
50,1,1.5,30,100,-70,1,0.461124892302905,50,0
50,1,1.5,100,0,100,0,0.842997625240969,50,0
50,1,1.5,28,85,-57,0,0.8254494705252,-35,0
50,1,10,46,51,-5,0,1.52676587645692,-1,0
50,1,10,49,100,-51,0,1.37349128350252,-50,0
50,1,10,43,56,-13,0,3.2176818665248,-6,0
50,1,10,92,5,87,0,3.28798889508471,45,0
50,1,10,51,1,50,0,3.29835459559763,49,0
50,1,10,8,55,-47,0,2.32604325388456,-5,0
50,1,10,90,47,43,1,2.45604286748858,-3,0
50,1,10,66,29,37,0,2.00466457768198,21,0
50,1,10,49,98,-49,1,3.23539846613858,48,0
50,1,10,49,99,-50,0,1.64842324142228,-49,0
50,1,10,88,2,86,0,1.41648186265957,48,0
50,1,10,49,96,-47,1,1.56392789991878,46,0
50,1,10,75,14,61,0,2.13281039179492,36,0
50,1,10,51,1,50,0,3.682646837231,49,0
50,1,10,51,2,49,0,3.1969287306747,48,0
50,1,10,50,19,31,0,2.76328364347137,31,0
50,1,10,90,15,75,1,2.2597955058518,-35,0
50,1,10,30,98,-68,0,2.49645394548497,-48,0
50,1,10,49,99,-50,0,4.31576328517986,-49,0
50,1,10,38,99,-61,0,2.91709828646344,-49,0
50,1,1.5,75,14,61,0,0.57534894696073,36,0
50,1,1.5,30,100,-70,0,1.16726492012458,-50,0
50,1,1.5,99,19,80,1,0.751605702866073,-31,0
50,1,1.5,59,31,28,1,0.936104787590011,-19,0
50,1,1.5,47,66,-19,1,0.944453979296668,16,0
50,1,1.5,49,98,-49,1,0.60150409255948,48,0
50,1,1.5,61,36,25,1,0.806799179037625,-14,0
50,1,1.5,14,99,-85,0,0.731857198945363,-49,0
50,1,1.5,95,17,78,1,0.66757947134829,-33,0
50,1,1.5,50,3,47,1,0.65471909586995,-47,0
50,1,1.5,24,70,-46,0,1.08856734331493,-20,0
50,1,1.5,51,1,50,0,0.850952873232018,49,0
50,1,1.5,50,13,37,1,1.07074659766658,-37,0
50,1,1.5,48,76,-28,0,1.37038501469578,-26,0
50,1,1.5,73,42,31,1,1.2499994388927,-8,0
50,1,1.5,6,94,-88,0,0.709632434289233,-44,0
50,1,1.5,53,0,53,0,0.871453039868356,50,0
50,1,1.5,36,65,-29,0,1.00255358275535,-15,0
50,1,1.5,36,74,-38,0,1.04761349842374,-24,0
50,1,1.5,50,19,31,0,0.724003983887087,31,0
50,1,10,40,89,-49,0,2.84077523933593,-39,0
50,1,10,88,2,86,0,2.19727588413662,48,0
50,1,10,41,51,-10,1,1.61932906442235,1,0
50,1,10,27,59,-32,0,3.70065383825931,-9,0
50,1,10,50,100,-50,1,2.20555443765988,50,0
50,1,10,70,40,30,1,2.09892278016196,-10,0
50,1,10,94,40,54,1,2.56424577174039,-10,0
50,1,10,20,80,-60,0,2.0754748278232,-30,0
50,1,10,16,86,-70,0,2.47407069772453,-36,0
50,1,10,92,5,87,0,1.12468247268771,45,0
50,1,10,75,14,61,0,2.8868120146617,36,0
50,1,10,90,34,56,0,2.7033045813514,16,0
50,1,10,57,11,46,0,2.63242942860597,39,0
50,1,10,78,46,32,0,3.05163172428365,4,0
50,1,10,22,57,-35,0,3.16613953916385,-7,0
50,1,10,56,19,37,0,2.42844175225036,31,0
50,1,10,79,14,65,0,2.64104366442916,36,0
50,1,10,49,96,-47,0,3.01290539713227,-46,0
50,1,10,75,0,75,0,3.32204223476583,50,0
50,1,10,78,22,56,0,2.52170105837649,28,0
50,1,1.5,34,81,-47,0,1.22465814175666,-31,0
50,1,1.5,65,37,28,1,0.901627316943632,-13,0
50,1,1.5,39,88,-49,0,0.79873193632011,-38,0
50,1,1.5,11,65,-54,0,0.763795921233395,-15,0
50,1,1.5,78,22,56,NaN,NaN,0,0
50,1,1.5,52,14,38,0,0.684809150494402,36,0
50,1,1.5,50,19,31,1,0.565944106856477,-31,0
50,1,1.5,90,34,56,1,0.403745556806825,-16,0
50,1,1.5,11,58,-47,0,0.488323007655708,-8,0
50,1,1.5,70,37,33,1,0.416822374929325,-13,0
50,1,1.5,95,7,88,1,0.594046330570563,-43,0
50,1,1.5,39,87,-48,0,0.391270672607789,-37,0
50,1,1.5,13,61,-48,0,0.564464025617781,-11,0
50,1,1.5,88,2,86,1,0.450310005398933,-48,0
50,1,1.5,84,16,68,0,0.580131212307606,34,0
50,1,1.5,9,59,-50,1,0.633343196888745,9,0
50,1,1.5,56,19,37,0,1.01179782664985,31,0
50,1,1.5,22,84,-62,0,0.439484552953218,-34,0
50,1,1.5,95,41,54,1,0.922019111323607,-9,0
50,1,1.5,78,46,32,1,0.521149235311896,-4,0
50,1,10,39,58,-19,0,1.01650432198221,-8,0
50,1,10,93,10,83,0,0.95929645011347,40,0
50,1,10,70,45,25,1,3.08152858046378,-5,0
50,1,10,51,2,49,0,3.28988435299107,48,0
50,1,10,75,14,61,0,2.74559541988128,36,0
50,1,10,87,28,59,1,2.3434881681751,-22,0
50,1,10,39,60,-21,1,2.64542655236073,10,0
50,1,10,75,0,75,0,3.70257163473798,50,0
50,1,10,9,71,-62,0,2.63745168264722,-21,0
50,1,10,19,75,-56,0,3.71854763707597,-25,0
50,1,10,88,2,86,0,2.68211765460728,48,0
50,1,10,51,1,50,0,3.08130398726644,49,0
50,1,10,87,24,63,1,2.9450562150887,-26,0
50,1,10,77,47,30,1,3.43008393906348,-3,0
50,1,10,34,53,-19,0,2.99176254378472,-3,0
50,1,10,11,53,-42,0,2.6828499974763,-3,0
50,1,10,50,100,-50,1,2.26667820058356,50,0
50,1,10,58,41,17,1,2.23534292158365,-9,0
50,1,10,52,11,41,0,3.54516621745279,39,0
50,1,10,7,82,-75,0,3.07801750053113,-32,0
50,1,1.5,46,78,-32,1,0.715151570595481,28,0
50,1,1.5,79,21,58,1,0.761775540493545,-29,0
50,1,1.5,68,27,41,1,0.702977351476875,-23,0
50,1,1.5,15,87,-72,0,0.597966749712214,-37,0
50,1,1.5,52,34,18,1,0.569822565710638,-16,0
50,1,1.5,75,0,75,0,0.725624737744511,50,0
50,1,1.5,36,74,-38,0,0.563388453625521,-24,0
50,1,1.5,93,10,83,1,0.72792742175443,-40,0
50,1,1.5,78,46,32,0,0.853665198330418,4,0
50,1,1.5,65,47,18,1,0.910089107121166,-3,0
50,1,1.5,17,59,-42,0,0.586440651019075,-9,0
50,1,1.5,100,48,52,1,0.885624146074406,-2,0
50,1,1.5,66,29,37,1,0.676650742258062,-21,0
50,1,1.5,100,16,84,0,0.588458669190004,34,0
50,1,1.5,52,6,46,0,0.64761482666654,44,0
50,1,1.5,7,70,-63,0,0.736142582038156,-20,0
50,1,1.5,52,14,38,0,0.813196462670021,36,0
50,1,1.5,36,88,-52,0,0.638996062749356,-38,0
50,1,1.5,65,49,16,1,0.784052778570185,-1,0
50,1,1.5,90,34,56,0,0.947228490142152,16,0
51,1,10,53,0,53,0,2.24981861662673,50,0
51,1,10,0,68,-68,0,2.27844157053187,-18,0
51,1,10,3,100,-97,0,2.67509458853601,-50,0
51,1,10,48,80,-32,0,3.24833008295172,-30,0
51,1,10,30,100,-70,0,3.30932192756154,-50,0
51,1,10,100,15,85,0,3.66437328212851,35,0
51,1,10,100,15,85,0,4.0292865118754,35,0
51,1,10,48,100,-52,0,5.00343022012385,-50,0
51,1,10,98,38,60,1,3.54590761590589,-12,0
51,1,10,48,60,-12,1,4.60419377661674,10,0
51,1,10,0,68,-68,0,3.68280773472361,-18,0
51,1,10,28,85,-57,0,3.94232547516731,-35,0
51,1,10,100,0,100,0,5.86448129213386,50,0
51,1,10,50,100,-50,0,5.68475722781659,-50,0
51,1,10,50,43,7,1,3.17561531872707,-7,0
51,1,10,53,23,30,1,3.84004048089264,-27,0
51,1,10,5,83,-78,0,4.1815899807516,-33,0
51,1,10,98,38,60,1,3.29367919254946,-12,0
51,1,10,85,15,70,1,5.76057252527244,-35,0
51,1,10,48,60,-12,1,5.3202578653727,10,0
51,1,1.5,30,100,-70,0,1.04425365606221,-50,0
51,1,1.5,80,45,35,1,0.849283215426112,-5,0
51,1,1.5,53,40,13,1,0.750411192489992,-10,0
51,1,1.5,100,0,100,0,0.735530383859441,50,0
51,1,1.5,53,40,13,1,0.817361699879257,-10,0
51,1,1.5,25,55,-30,0,0.879807362816791,-5,0
51,1,1.5,80,45,35,1,0.636255361037911,-5,0
51,1,1.5,50,43,7,1,0.71413124069295,-7,0
51,1,1.5,48,80,-32,1,1.06126810006026,30,0
51,1,1.5,25,55,-30,0,1.09037555945542,-5,0
51,1,1.5,28,85,-57,0,1.05399176348874,-35,0
51,1,1.5,85,15,70,1,0.730382852696494,-35,0
51,1,1.5,75,0,75,0,0.859614502463955,50,0
51,1,1.5,53,0,53,0,0.695945832976577,50,0
51,1,1.5,3,100,-97,0,0.650440655255807,-50,0
51,1,1.5,53,23,30,1,0.846934646782756,-27,0
51,1,1.5,75,0,75,0,0.700182312702964,50,0
51,1,1.5,50,100,-50,0,0.758616089107818,-50,0
51,1,1.5,5,83,-78,0,0.647137565527373,-33,0
51,1,1.5,48,100,-52,0,0.852256962170941,-50,0
51,1,10,48,72,-24,1,3.98950091384904,22,0
51,1,10,83,27,56,1,5.25958147760684,-23,0
51,1,10,49,56,-7,1,5.15068758702182,6,0
51,1,10,10,69,-59,0,4.47846958430819,-19,0
51,1,10,54,7,47,0,4.64835230077369,43,0
51,1,10,15,84,-69,0,3.52442606152908,-34,0
51,1,10,42,63,-21,1,3.8605958902117,13,0
51,1,10,1,93,-92,0,3.67880580998099,-43,0
51,1,10,48,55,-7,1,3.7529846562029,5,0
51,1,10,73,48,25,1,3.28852622767954,-2,0
51,1,10,96,15,81,0,4.63153497956955,35,0
51,1,10,49,91,-42,0,5.0353976203005,-41,0
51,1,10,31,52,-21,1,5.29321370503749,2,0
51,1,10,49,70,-21,1,5.70954941873424,20,0
51,1,10,71,3,68,0,5.7011597761084,47,0
51,1,10,88,13,75,0,6.31731158903131,37,0
51,1,10,71,20,51,1,5.27675440470557,-30,0
51,1,10,6,67,-61,0,4.75914013989677,-17,0
51,1,10,74,14,60,0,3.01503118321853,36,0
51,1,10,95,2,93,0,4.50878996770916,48,0
51,1,1.5,98,29,69,1,0.727096064085345,-21,0
51,1,1.5,79,43,36,1,0.745534441026393,-7,0
51,1,1.5,40,63,-23,1,0.49139939048473,13,0
51,1,1.5,84,33,51,1,0.591325250577938,-17,0
51,1,1.5,2,66,-64,0,0.663187526646652,-16,0
51,1,1.5,62,22,40,1,0.651658409227821,-28,0
51,1,1.5,36,68,-32,1,0.760833041305887,18,0
51,1,1.5,47,67,-20,1,0.961288808517565,17,0
51,1,1.5,44,62,-18,1,0.81772183386056,12,0
51,1,1.5,54,18,36,1,0.68752177686838,-32,0
51,1,1.5,43,56,-13,1,0.896601741707855,6,0
51,1,1.5,82,41,41,1,0.763797430001432,-9,0
51,1,1.5,88,14,74,1,0.51620576941059,-36,0
51,1,1.5,45,88,-43,0,1.03006715435549,-38,0
51,1,1.5,73,16,57,1,1.00375141254699,-34,0
51,1,1.5,22,76,-54,NaN,NaN,0,0
51,1,1.5,15,70,-55,NaN,NaN,0,0
51,1,1.5,94,10,84,1,0.599240047646163,-40,0
51,1,1.5,46,56,-10,1,0.565745172236348,6,0
51,1,1.5,57,6,51,1,0.437646148369822,-44,0
51,1,10,44,71,-27,0,2.45134995582703,-21,0
51,1,10,61,26,35,1,1.67133385998386,-24,0
51,1,10,29,67,-38,0,3.47931271441485,-17,0
51,1,10,42,68,-26,1,2.59435876809221,18,0
51,1,10,33,67,-34,0,2.66416438630404,-17,0
51,1,10,48,61,-13,1,2.81201976277225,11,0
51,1,10,25,68,-43,0,3.40920009179536,-18,0
51,1,10,65,7,58,0,3.53415662213956,43,0
51,1,10,92,41,51,1,2.78975756591535,-9,0
51,1,10,11,69,-58,0,2.65958950741697,-19,0
51,1,10,98,8,90,0,2.18001360215931,42,0
51,1,10,84,4,80,0,2.72274849524547,46,0
51,1,10,46,85,-39,0,2.83529987396105,-35,0
51,1,10,30,52,-22,1,3.04710272943339,2,0
51,1,10,48,94,-46,1,2.34623339678728,44,0
51,1,10,68,41,27,1,2.12219594768612,-9,0
51,1,10,46,55,-9,1,2.52290703872495,5,0
51,1,10,24,95,-71,0,2.44340497150188,-45,0
51,1,10,80,34,46,1,2.21473257086836,-16,0
51,1,10,46,61,-15,1,2.62735977996999,11,0
51,1,1.5,49,75,-26,1,0.72652250619285,25,0
51,1,1.5,49,66,-17,1,0.727036897063954,16,0
51,1,1.5,100,2,98,1,0.72754223175798,-48,0
51,1,1.5,68,6,62,0,0.655929000560718,44,0
51,1,1.5,16,74,-58,1,0.811127427441534,24,0
51,1,1.5,46,69,-23,1,0.61624966168165,19,0
51,1,1.5,43,95,-52,1,0.716749381546833,45,0
51,1,1.5,96,44,52,1,0.789218723370141,-6,0
51,1,1.5,9,53,-44,0,0.674994064964267,-3,0
51,1,1.5,57,3,54,1,0.524813665917463,-47,0
51,1,1.5,47,59,-12,1,0.715327259840706,9,0
51,1,1.5,43,99,-56,1,0.499776354467031,49,0
51,1,1.5,93,36,57,1,0.59624003798308,-14,0
51,1,1.5,46,60,-14,1,0.489494272656884,10,0
51,1,1.5,80,49,31,1,0.578694298255868,-1,0
51,1,1.5,0,74,-74,0,0.632563157563709,-24,0
51,1,1.5,34,58,-24,0,0.907737821034971,-8,0
51,1,1.5,45,61,-16,1,0.7400943953362,11,0
51,1,1.5,48,51,-3,1,0.459232754405093,1,0
51,1,1.5,63,30,33,1,0.525106784185482,-20,0
51,1,10,63,43,20,1,1.08400967057241,-7,0
51,1,10,91,32,59,0,1.56155578462858,18,0
51,1,10,94,42,52,0,2.72770856354691,8,0
51,1,10,47,62,-15,1,1.87825875650014,12,0
51,1,10,48,65,-17,1,3.05222762015546,15,0
51,1,10,98,33,65,0,2.83796540880576,17,0
51,1,10,45,60,-15,1,3.33571977871179,10,0
51,1,10,17,57,-40,0,4.07735277652318,-7,0
51,1,10,22,66,-44,0,3.24475893038107,-16,0
51,1,10,45,64,-19,1,4.07037921814845,14,0
51,1,10,43,99,-56,0,2.87647680268492,-49,0
51,1,10,72,19,53,0,2.82886244127803,31,0
51,1,10,59,35,24,1,2.56671418320548,-15,0
51,1,10,44,83,-39,0,3.0432360436098,-33,0
51,1,10,26,87,-61,0,2.35634522246619,-37,0
51,1,10,57,26,31,1,3.67288729625943,-24,0
51,1,10,47,56,-9,1,4.03244047654516,6,0
51,1,10,99,2,97,0,2.9211898667636,48,0
51,1,10,33,97,-64,0,2.21497165394612,-47,0
51,1,10,1,56,-55,0,1.48166128305456,-6,0
51,1,1.5,62,35,27,1,0.862231435825379,-15,0
51,1,1.5,49,62,-13,1,0.911925397405867,12,0
51,1,1.5,48,72,-24,1,0.775719585515617,22,0
51,1,1.5,45,56,-11,1,0.732828624306421,6,0
51,1,1.5,100,24,76,0,0.707223188666831,26,0
51,1,1.5,99,46,53,1,0.946456299501733,-4,0
51,1,1.5,92,18,74,0,0.768130207085051,32,0
51,1,1.5,19,96,-77,0,1.25254965782005,-46,0
51,1,1.5,11,87,-76,0,0.541455297279754,-37,0
51,1,1.5,64,25,39,1,0.803320398881624,-25,0
51,1,1.5,47,58,-11,1,0.611760514606431,8,0
51,1,1.5,33,95,-62,0,0.782261466109048,-45,0
51,1,1.5,72,12,60,1,0.55407930653746,-38,0
51,1,1.5,64,44,20,1,0.806518738823797,-6,0
51,1,1.5,0,61,-61,0,0.553547708928818,-11,0
51,1,1.5,71,22,49,1,0.646776525929454,-28,0
51,1,1.5,48,94,-46,1,0.600626850260596,44,0
51,1,1.5,62,44,18,1,0.971798502250749,-6,0
51,1,1.5,68,36,32,1,0.648128009452194,-14,0
51,1,1.5,46,58,-12,1,0.601267423866375,8,0
52,1,10,3,100,-97,1,2.16400677420552,50,0
52,1,10,0,68,-68,0,3.06142200509839,-18,0
52,1,10,50,43,7,1,1.14650098205857,-7,0
52,1,10,5,83,-78,1,1.62603036541168,33,0
52,1,10,53,23,30,1,9.50203721787966,-27,0
52,1,10,50,100,-50,1,3.42315866806803,50,0
52,1,10,75,0,75,1,5.84548413011908,-50,0
52,1,10,48,60,-12,1,6.33704940591451,10,0
52,1,10,100,15,85,1,6.60972149116424,-35,0
52,1,10,48,60,-12,1,6.7683482806915,10,0
52,1,10,53,23,30,1,5.03967281448968,-27,0
52,1,10,98,38,60,1,5.38145973895462,-12,0
52,1,10,98,38,60,1,5.96586327990008,-12,0
52,1,10,53,0,53,1,4.60670851826399,-50,0
52,1,10,80,45,35,1,5.14998487347566,-5,0
52,1,10,5,83,-78,1,5.9110565149731,33,0
52,1,10,48,80,-32,1,4.91394692831,30,0
52,1,10,28,85,-57,1,2.92516112831527,35,0
52,1,10,28,85,-57,1,3.73633246265945,35,0
52,1,10,85,15,70,1,3.28985280498091,-35,0
52,1,1.5,75,0,75,1,0.577193096437441,-50,0
52,1,1.5,48,100,-52,1,0.746471096845198,50,0
52,1,1.5,30,100,-70,1,1.15691914864601,50,0
52,1,1.5,3,100,-97,1,0.942619224868395,50,0
52,1,1.5,48,100,-52,1,1.04096844415471,50,0
52,1,1.5,50,43,7,1,1.15136563071792,-7,0
52,1,1.5,0,68,-68,1,1.06438547117978,18,0
52,1,1.5,30,100,-70,NaN,NaN,0,0
52,1,1.5,100,0,100,1,1.30599021658963,-50,0
52,1,1.5,53,40,13,1,1.12564593289153,-10,0
52,1,1.5,85,15,70,1,1.35265461922518,-35,0
52,1,1.5,48,80,-32,NaN,NaN,0,0
52,1,1.5,25,55,-30,1,1.36683439840635,5,0
52,1,1.5,25,55,-30,1,0.911789155513361,5,0
52,1,1.5,100,15,85,1,1.22753730466775,-35,0
52,1,1.5,53,40,13,1,0.962559001634872,-10,0
52,1,1.5,50,100,-50,1,1.01231667481443,50,0
52,1,1.5,80,45,35,NaN,NaN,0,0
52,1,1.5,53,0,53,1,1.081246769073,-50,0
52,1,1.5,100,0,100,1,0.541668029837638,-50,0
52,1,10,2,100,-98,0,2.59686722686001,-50,0
52,1,10,78,24,54,1,0.867524626092745,-26,0
52,1,10,47,84,-37,1,1.57969349264295,34,0
52,1,10,96,45,51,NaN,NaN,0,0
52,1,10,91,27,64,1,3.8203186671617,-23,0
52,1,10,62,15,47,1,2.52912197566638,-35,0
52,1,10,26,90,-64,1,3.42709717697653,40,0
52,1,10,53,27,26,1,2.67937788667496,-23,0
52,1,10,20,88,-68,1,2.82723573569365,38,0
52,1,10,48,55,-7,1,3.10438184872964,5,0
52,1,10,69,24,45,1,2.52675319514856,-26,0
52,1,10,45,87,-42,1,1.74337510946316,37,0
52,1,10,97,22,75,1,5.05269190027411,-28,0
52,1,10,12,57,-45,1,7.11251002309018,7,0
52,1,10,42,99,-57,1,5.25698661678052,49,0
52,1,10,94,46,48,1,4.60402881077698,-4,0
52,1,10,1,99,-98,1,3.96132525549365,49,0
52,1,10,60,18,42,1,3.88809018111988,-32,0
52,1,10,39,86,-47,1,3.81822609846677,36,0
52,1,10,41,87,-46,1,5.94312516040372,37,0
52,1,1.5,18,84,-66,1,0.756015649208166,34,0
52,1,1.5,39,80,-41,1,1.09248964680864,30,0
52,1,1.5,93,32,61,1,0.991523509170293,-18,0
52,1,1.5,86,41,45,1,0.806593203601551,-9,0
52,1,1.5,17,87,-70,1,0.669033678444976,37,0
52,1,1.5,17,72,-55,1,0.52027353747053,22,0
52,1,1.5,13,81,-68,1,0.466079268489011,31,0
52,1,1.5,43,60,-17,1,0.917307052681281,10,0
52,1,1.5,30,87,-57,1,0.966396383811116,37,0
52,1,1.5,19,91,-72,1,0.789434864796931,41,0
52,1,1.5,92,23,69,1,1.44116466020387,-27,0
52,1,1.5,98,10,88,1,1.19741210373468,-40,0
52,1,1.5,13,100,-87,NaN,NaN,0,0
52,1,1.5,5,86,-81,1,1.11901835849858,36,0
52,1,1.5,47,81,-34,1,0.448043391139436,31,0
52,1,1.5,30,97,-67,1,0.459859823477927,47,0
52,1,1.5,54,41,13,1,0.815782755851615,-9,0
52,1,1.5,66,39,27,1,0.740881656287456,-11,0
52,1,1.5,6,99,-93,1,0.677394595225451,49,0
52,1,1.5,90,47,43,1,0.352510626831645,-3,0
52,1,10,47,78,-31,1,1.00159059996531,28,0
52,1,10,71,7,64,1,7.43440033831939,-43,0
52,1,10,42,85,-43,1,4.63614454805884,35,0
52,1,10,21,95,-74,1,3.48676466624056,45,0
52,1,10,28,75,-47,1,3.38437973563396,25,0
52,1,10,62,40,22,1,3.18930656968769,-10,0
52,1,10,43,93,-50,1,1.96227282807467,43,0
52,1,10,37,85,-48,1,7.16108466442984,35,0
52,1,10,79,44,35,1,5.19822443817793,-6,0
52,1,10,86,36,50,1,6.19457572527972,-14,0
52,1,10,70,30,40,1,6.18864939685864,-20,0
52,1,10,20,93,-73,1,6.51279136671747,43,0
52,1,10,83,46,37,1,4.16012290391882,-4,0
52,1,10,22,83,-61,1,4.02209276211579,33,0
52,1,10,99,8,91,1,4.81365577388078,-42,0
52,1,10,50,54,-4,1,6.03219698302473,4,0
52,1,10,43,81,-38,1,5.04231478812198,31,0
52,1,10,32,69,-37,1,4.86742410310126,19,0
52,1,10,48,74,-26,1,5.14054808900346,24,0
52,1,10,52,30,22,1,2.56171829133291,-20,0
52,1,1.5,32,65,-33,1,0.967584849326158,15,0
52,1,1.5,43,55,-12,1,0.781294313731451,5,0
52,1,1.5,76,30,46,1,1.33907797799111,-20,0
52,1,1.5,62,27,35,1,1.14601285690333,-23,0
52,1,1.5,35,73,-38,1,1.17696971201258,23,0
52,1,1.5,52,1,51,NaN,NaN,0,0
52,1,1.5,4,54,-50,NaN,NaN,0,0
52,1,1.5,33,78,-45,1,1.37035330684103,28,0
52,1,1.5,26,78,-52,1,0.591883641088316,28,0
52,1,1.5,45,80,-35,1,0.669142955690404,30,0
52,1,1.5,25,62,-37,1,0.668267228370496,12,0
52,1,1.5,69,12,57,1,0.277431725340648,-38,0
52,1,1.5,33,69,-36,1,0.455391531237183,19,0
52,1,1.5,63,14,49,1,0.313279491872891,-36,0
52,1,1.5,88,50,38,1,0.321148359178551,0,0
52,1,1.5,34,76,-42,1,0.560395795162549,26,0
52,1,1.5,30,97,-67,1,0.79094150218225,47,0
52,1,1.5,44,67,-23,NaN,NaN,0,0
52,1,1.5,38,100,-62,1,0.541221260987186,50,0
52,1,1.5,73,1,72,1,0.291693915261931,-49,0
52,1,10,19,59,-40,1,1.54476914902352,9,0
52,1,10,48,63,-15,1,4.8629630557607,13,0
52,1,10,31,54,-23,1,4.72679304210033,4,0
52,1,10,26,75,-49,1,4.63600900804886,25,0
52,1,10,26,76,-50,1,4.01324855011171,26,0
52,1,10,31,56,-25,1,3.21532300655508,6,0
52,1,10,70,40,30,1,2.60844457749135,-10,0
52,1,10,35,84,-49,1,2.52290102130155,34,0
52,1,10,83,36,47,1,2.63220302044101,-14,0
52,1,10,45,87,-42,1,1.83269537178876,37,0
52,1,10,47,74,-27,1,7.13059027545478,24,0
52,1,10,75,25,50,1,5.47838503346793,-25,0
52,1,10,53,10,43,1,5.65328266151664,-40,0
52,1,10,7,62,-55,1,3.87628129555196,12,0
52,1,10,38,75,-37,NaN,NaN,0,0
52,1,10,54,4,50,1,1.6361804706894,-46,0
52,1,10,65,49,16,1,5.98558570965815,-1,0
52,1,10,51,23,28,1,4.59498053408242,-27,0
52,1,10,31,92,-61,1,4.36420480147899,42,0
52,1,10,47,82,-35,1,4.49484846558789,32,0
52,1,1.5,56,15,41,1,0.758396806430028,-35,0
52,1,1.5,96,32,64,1,1.074742357986,-18,0
52,1,1.5,70,33,37,NaN,NaN,0,0
52,1,1.5,19,89,-70,1,0.794363510075527,39,0
52,1,1.5,75,30,45,1,0.701354084158993,-20,0
52,1,1.5,35,99,-64,1,0.667110459294236,49,0
52,1,1.5,48,67,-19,1,0.795041210121781,17,0
52,1,1.5,83,43,40,1,0.622011558858503,-7,0
52,1,1.5,34,54,-20,1,0.695162713136597,4,0
52,1,1.5,52,27,25,1,1.10160795753836,-23,0
52,1,1.5,24,81,-57,NaN,NaN,0,0
52,1,1.5,47,71,-24,1,1.10457172549104,21,0
52,1,1.5,49,83,-34,1,0.29407205377538,33,0
52,1,1.5,13,96,-83,1,0.787994940868884,46,0
52,1,1.5,70,34,36,1,0.846430193345441,-16,0
52,1,1.5,66,25,41,1,0.670912220710306,-25,0
52,1,1.5,47,58,-11,1,0.989322870713295,8,0
52,1,1.5,100,42,58,1,1.02365494373589,-8,0
52,1,1.5,92,29,63,1,1.19276268898739,-21,0
52,1,1.5,58,41,17,1,1.00306765400819,-9,0
53,1,10,53,23,30,1,1.38726441369727,-27,0
53,1,10,53,0,53,0,3.36805425876264,50,0
53,1,10,30,100,-70,0,2.60038251311926,-50,0
53,1,10,53,40,13,1,2.36837122314864,-10,0
53,1,10,48,60,-12,1,5.33342393734711,10,0
53,1,10,53,40,13,1,2.20717853144197,-10,0
53,1,10,3,100,-97,0,2.50322900424908,-50,0
53,1,10,5,83,-78,0,4.5391187308287,-33,0
53,1,10,25,55,-30,0,2.85313202823818,-5,0
53,1,10,48,60,-12,0,5.27488574691051,-10,0
53,1,10,53,23,30,1,2.37535591074993,-27,0
53,1,10,75,0,75,0,2.52066144178025,50,0
53,1,10,48,100,-52,0,1.94724479209435,-50,0
53,1,10,80,45,35,0,2.83810127514698,5,0
53,1,10,100,15,85,0,2.78055352295269,35,0
53,1,10,48,80,-32,0,3.19772635155823,-30,0
53,1,10,53,0,53,0,3.74213230746864,50,0
53,1,10,85,15,70,0,3.49565204605096,35,0
53,1,10,5,83,-78,0,4.05199095644821,-33,0
53,1,10,48,80,-32,0,2.69744425325371,-30,0
53,1,1.5,30,100,-70,1,1.30577015301787,50,0
53,1,1.5,100,0,100,0,1.32545635827591,50,0
53,1,1.5,50,100,-50,NaN,NaN,0,0
53,1,1.5,0,68,-68,0,0.790273462276673,-18,0
53,1,1.5,0,68,-68,0,0.591501472872551,-18,0
53,1,1.5,100,15,85,1,1.46463330741608,-35,0
53,1,1.5,75,0,75,1,0.66290660618688,-50,0
53,1,1.5,98,38,60,0,1.48541288887282,12,0
53,1,1.5,98,38,60,NaN,NaN,0,0
53,1,1.5,28,85,-57,1,0.654900085775807,35,0
53,1,1.5,100,0,100,1,0.692727219435255,-50,0
53,1,1.5,50,100,-50,0,0.752582774237453,-50,0
53,1,1.5,28,85,-57,1,0.793735920862673,35,0
53,1,1.5,48,100,-52,0,0.561586977790284,-50,0
53,1,1.5,80,45,35,0,0.57071826896572,5,0
53,1,1.5,50,43,7,0,1.21929955146516,7,0
53,1,1.5,3,100,-97,0,1.39356053390293,-50,0
53,1,1.5,25,55,-30,0,0.73713272254281,-5,0
53,1,1.5,85,15,70,1,1.09163897504186,-35,0
53,1,1.5,50,43,7,1,1.43203035059196,-7,0
53,1,10,48,90,-42,1,3.23069487397515,40,0
53,1,10,40,50,-10,0,4.90836835537812,0,0
53,1,10,38,51,-13,0,1.74293981197843,-1,0
53,1,10,98,38,60,0,4.58090399500361,12,0
53,1,10,92,47,45,1,3.91683764379195,-3,0
53,1,10,63,13,50,1,2.00641842065488,-37,0
53,1,10,75,0,75,0,2.9929912054904,50,0
53,1,10,0,53,-53,1,2.91940384784175,3,0
53,1,10,80,45,35,1,2.96850012200048,-5,0
53,1,10,14,98,-84,0,2.56097780242453,-48,0
53,1,10,80,45,35,1,2.71085607300665,-5,0
53,1,10,31,78,-47,0,2.49674512037745,-28,0
53,1,10,13,90,-77,0,2.75533251576053,-40,0
53,1,10,52,25,27,1,1.75520512626463,-25,0
53,1,10,75,0,75,1,2.21937230233743,-50,0
53,1,10,58,16,42,1,1.63266699620362,-34,0
53,1,10,0,98,-98,0,1.2862200915115,-48,0
53,1,10,100,0,100,0,2.32571536345858,50,0
53,1,10,93,39,54,1,2.97565415914505,-11,0
53,1,10,43,71,-28,0,2.41540722879472,-21,0
53,1,1.5,25,83,-58,NaN,NaN,0,0
53,1,1.5,50,43,7,1,0.595905466623663,-7,0
53,1,1.5,79,5,74,1,0.75516195873206,-45,0
53,1,1.5,69,25,44,1,0.635517562588575,-25,0
53,1,1.5,49,58,-9,1,0.817363955609835,8,0
53,1,1.5,63,3,60,1,0.70313874486601,-47,0
53,1,1.5,53,0,53,1,0.745645480359599,-50,0
53,1,1.5,0,98,-98,0,0.914157332563263,-48,0
53,1,1.5,0,56,-56,0,0.827932755748407,-6,0
53,1,1.5,48,60,-12,0,1.20102881859748,-10,0
53,1,1.5,90,20,70,0,1.33992774469152,30,0
53,1,1.5,56,16,40,1,0.996228166555738,-34,0
53,1,1.5,75,0,75,1,0.763271718971737,-50,0
53,1,1.5,0,98,-98,0,0.867830421531835,-48,0
53,1,1.5,39,73,-34,0,0.574844541539278,-23,0
53,1,1.5,58,5,53,0,0.814015604200904,45,0
53,1,1.5,98,38,60,0,1.04380482288434,12,0
53,1,1.5,89,33,56,0,1.02418955727626,17,0
53,1,1.5,48,90,-42,0,1.18120013030057,-40,0
53,1,1.5,46,94,-48,0,0.884204801754095,-44,0
53,1,10,8,88,-80,1,1.42690458365178,38,0
53,1,10,100,0,100,1,1.22387923404858,-50,0
53,1,10,1,99,-98,1,1.8573361834915,49,0
53,1,10,73,46,27,1,2.28866283038587,-4,0
53,1,10,60,38,22,1,2.41865415159918,-12,0
53,1,10,44,59,-15,0,2.86387319663118,-9,0
53,1,10,85,15,70,1,3.91499653351093,-35,0
53,1,10,7,62,-55,0,3.99579890621681,-12,0
53,1,10,30,100,-70,1,4.61735188077546,50,0
53,1,10,30,81,-51,0,2.5413094075484,-31,0
53,1,10,70,9,61,1,3.29111794596429,-41,0
53,1,10,50,38,12,1,2.4522191708038,-12,0
53,1,10,48,90,-42,1,4.6626575627397,40,0
53,1,10,51,39,12,1,3.31264797834046,-11,0
53,1,10,26,79,-53,0,3.26494755496606,-29,0
53,1,10,71,35,36,1,1.83526187798452,-15,0
53,1,10,30,100,-70,0,3.23527033036771,-50,0
53,1,10,51,47,4,1,2.31024991635059,-3,0
53,1,10,100,0,100,0,3.11092127710981,50,0
53,1,10,33,81,-48,0,3.27062363245568,-31,0
53,1,1.5,74,44,30,1,0.937388709018705,-6,0
53,1,1.5,65,25,40,1,1.04847234988301,-25,0
53,1,1.5,51,47,4,1,1.32282525199298,-3,0
53,1,1.5,44,77,-33,0,1.1864140435282,-27,0
53,1,1.5,0,53,-53,0,1.42335880871178,-3,0
53,1,1.5,85,15,70,1,1.31503275801151,-35,0
53,1,1.5,69,33,36,1,1.31457149936068,-17,0
53,1,1.5,81,4,77,1,1.34627578668187,-46,0
53,1,1.5,30,100,-70,NaN,NaN,0,0
53,1,1.5,76,43,33,1,0.85030198907225,-7,0
53,1,1.5,30,100,-70,NaN,NaN,0,0
53,1,1.5,24,87,-63,NaN,NaN,0,0
53,1,1.5,100,15,85,1,1.10438335835715,-35,0
53,1,1.5,70,40,30,1,0.656096399932721,-10,0
53,1,1.5,98,28,70,1,0.59390044047359,-22,0
53,1,1.5,1,50,-49,0,0.566321218244411,0,0
53,1,1.5,74,8,66,0,0.571551130626176,42,0
53,1,1.5,52,48,4,1,1.02472145370302,-2,0
53,1,1.5,22,90,-68,0,0.643745354327621,-40,0
53,1,1.5,75,0,75,1,0.614216650184972,-50,0
53,1,10,2,52,-50,0,5.13096640679942,-2,0
53,1,10,53,0,53,0,3.46474499963006,50,0
53,1,10,53,48,5,1,1.4576724676117,-2,0
53,1,10,88,31,57,1,1.7984263900471,-19,0
53,1,10,0,51,-51,0,2.7858507525325,-1,0
53,1,10,67,49,18,1,3.28562419846457,-1,0
53,1,10,28,85,-57,0,2.53332854615837,-35,0
53,1,10,14,94,-80,0,3.40385070725279,-44,0
53,1,10,91,41,50,1,2.44616001921349,-9,0
53,1,10,98,38,60,1,2.1441255606569,-12,0
53,1,10,23,51,-28,0,2.04350295203949,-1,0
53,1,10,29,88,-59,0,1.56487133257724,-38,0
53,1,10,17,94,-77,0,1.54948044756748,-44,0
53,1,10,42,90,-48,0,4.52684828473866,-40,0
53,1,10,51,3,48,1,2.10013482809154,-47,0
53,1,10,51,1,50,1,1.97081426389559,-49,0
53,1,10,49,100,-51,0,2.43889730856426,-50,0
53,1,10,51,4,47,0,4.56011747051707,46,0
53,1,10,44,76,-32,0,2.11604493095365,-26,0
53,1,10,65,24,41,1,4.07059012479294,-26,0
53,1,1.5,20,55,-35,0,1.44755556812743,-5,0
53,1,1.5,72,5,67,1,0.641108210629682,-45,0
53,1,1.5,49,96,-47,0,1.15493344250353,-46,0
53,1,1.5,49,97,-48,0,0.879942989169649,-47,0
53,1,1.5,63,29,34,1,0.983657057106029,-21,0
53,1,1.5,52,2,50,1,0.722747067446107,-48,0
53,1,1.5,21,83,-62,0,0.904451279297064,-33,0
53,1,1.5,51,2,49,1,0.766840436097482,-48,0
53,1,1.5,29,99,-70,1,0.826645276594718,49,0
53,1,1.5,49,100,-51,1,0.908393410656572,50,0
53,1,1.5,49,99,-50,0,1.11206657509319,-49,0
53,1,1.5,43,57,-14,0,0.71048024380616,-7,0
53,1,1.5,48,67,-19,NaN,NaN,0,0
53,1,1.5,36,58,-22,0,0.840657819328044,-8,0
53,1,1.5,99,21,78,1,1.05772469126896,-29,0
53,1,1.5,51,1,50,1,0.61008917012623,-49,0
53,1,1.5,68,8,60,1,0.852554549313936,-42,0
53,1,1.5,29,53,-24,1,1.16499359026966,3,0
53,1,1.5,49,96,-47,0,0.816535320142066,-46,0
53,1,1.5,51,0,51,1,0.794422677035982,-50,0
54,1,10,75,0,75,1,3.01633306546864,-50,0
54,1,10,50,100,-50,1,2.35881248164878,50,0
54,1,10,100,15,85,1,4.68072513532024,-35,0
54,1,10,100,0,100,0,1.43737285959287,50,0
54,1,10,100,15,85,0,1.34757292449649,35,0
54,1,10,25,55,-30,1,3.94629148275999,5,0
54,1,10,53,40,13,1,3.09330198031967,-10,0
54,1,10,25,55,-30,1,2.51366920620057,5,0
54,1,10,48,60,-12,1,1.83029247893501,10,0
54,1,10,5,83,-78,0,2.65376535206451,-33,0
54,1,10,98,38,60,1,2.0190800901546,-12,0
54,1,10,98,38,60,1,3.12971666029989,-12,0
54,1,10,30,100,-70,0,1.76482273016518,-50,0
54,1,10,53,23,30,0,1.44235825659052,27,0
54,1,10,53,0,53,0,4.51772152041667,50,0
54,1,10,80,45,35,0,1.71239017943299,5,0
54,1,10,80,45,35,0,6.49635963010223,5,0
54,1,10,48,80,-32,1,5.75572947471665,30,0
54,1,10,30,100,-70,0,1.30871037383622,-50,0
54,1,10,0,68,-68,0,4.66951848208919,-18,0
54,1,1.5,3,100,-97,0,0.943272170574346,-50,0
54,1,1.5,48,100,-52,0,1.08244308229769,-50,0
54,1,1.5,5,83,-78,0,1.42346023611026,-33,0
54,1,1.5,28,85,-57,NaN,NaN,0,0
54,1,1.5,3,100,-97,0,1.21623254247606,-50,0
54,1,1.5,48,80,-32,1,0.831279898466164,30,0
54,1,1.5,50,43,7,0,0.902318258704327,7,0
54,1,1.5,75,0,75,1,0.83481903225038,-50,0
54,1,1.5,0,68,-68,NaN,NaN,0,0
54,1,1.5,50,43,7,1,0.951135906070704,-7,0
54,1,1.5,48,100,-52,1,0.224918574156618,50,0
54,1,1.5,53,23,30,1,0.928914287593216,-27,0
54,1,1.5,48,60,-12,0,0.540050303046883,-10,0
54,1,1.5,100,0,100,1,0.502560359120253,-50,0
54,1,1.5,53,0,53,0,0.554455579753267,50,0
54,1,1.5,85,15,70,0,1.31631721724989,35,0
54,1,1.5,85,15,70,0,0.711328197801777,35,0
54,1,1.5,28,85,-57,1,1.01109228573841,35,0
54,1,1.5,53,40,13,0,1.24216445550701,10,0
54,1,1.5,50,100,-50,1,0.752477721976902,50,0
54,1,10,48,69,-21,1,5.13057336975544,19,0
54,1,10,71,7,64,0,4.43491593279032,43,0
54,1,10,43,100,-57,1,2.60695001400745,50,0
54,1,10,4,81,-77,1,1.12551824059119,31,0
54,1,10,0,89,-89,0,1.21242806422379,-39,0
54,1,10,37,84,-47,1,3.21878999227192,34,0
54,1,10,87,8,79,0,3.97646860547684,42,0
54,1,10,49,62,-13,1,2.58391274050518,12,0
54,1,10,37,62,-25,1,3.07044341435903,12,0
54,1,10,47,54,-7,1,2.61820587218972,4,0
54,1,10,19,72,-53,0,2.3981042926498,-22,0
54,1,10,49,74,-25,0,3.74051971220979,-24,0
54,1,10,43,70,-27,0,3.93358422955862,-20,0
54,1,10,49,52,-3,1,2.94236595429902,2,0
54,1,10,47,93,-46,0,3.00750696571413,-43,0
54,1,10,2,84,-82,0,2.95798294057022,-34,0
54,1,10,39,66,-27,0,2.7584336337386,-16,0
54,1,10,92,3,89,0,3.47088927759251,47,0
54,1,10,1,92,-91,0,2.07396896394857,-42,0
54,1,10,47,51,-4,0,4.69390874071541,-1,0
54,1,1.5,71,7,64,0,0.869855671819096,43,0
54,1,1.5,25,55,-30,1,0.673646867759089,5,0
54,1,1.5,52,28,24,0,0.670184409173089,22,0
54,1,1.5,0,98,-98,0,1.02670202710942,-48,0
54,1,1.5,37,62,-25,0,1.20037587075421,-12,0
54,1,1.5,92,11,81,1,0.614773600686021,-39,0
54,1,1.5,78,24,54,1,0.692610997957672,-26,0
54,1,1.5,25,93,-68,0,0.975696117984626,-43,0
54,1,1.5,17,66,-49,0,0.959391168060392,-16,0
54,1,1.5,19,97,-78,0,0.75917804724304,-47,0
54,1,1.5,78,3,75,0,1.13293913156303,47,0
54,1,1.5,92,3,89,0,0.957291354465269,47,0
54,1,1.5,0,85,-85,0,1.16500506015655,-35,0
54,1,1.5,71,7,64,0,0.8133539021037,43,0
54,1,1.5,63,7,56,0,1.19583120519019,43,0
54,1,1.5,70,45,25,1,0.834835333273077,-5,0
54,1,1.5,59,2,57,0,0.871978729472175,48,0
54,1,1.5,58,43,15,NaN,NaN,0,0
54,1,1.5,28,85,-57,1,0.717693144561053,35,0
54,1,1.5,32,77,-45,0,0.27940565786048,-27,0
54,1,10,34,76,-42,0,4.95353547741615,-26,0
54,1,10,19,84,-65,0,2.15813508347492,-34,0
54,1,10,53,0,53,0,2.06073253115756,50,0
54,1,10,21,64,-43,0,1.71142449459876,-14,0
54,1,10,100,15,85,0,1.13630046341859,35,0
54,1,10,77,43,34,0,3.71644732358618,7,0
54,1,10,60,6,54,0,4.21998660830286,44,0
54,1,10,85,15,70,0,3.78342612470442,35,0
54,1,10,88,16,72,0,4.31620129884686,34,0
54,1,10,3,95,-92,1,2.90759345171318,45,0
54,1,10,43,100,-57,0,5.466657652094,-50,0
54,1,10,91,0,91,0,0.932378859277378,50,0
54,1,10,0,98,-98,0,1.00066536489612,-48,0
54,1,10,96,23,73,1,7.32213034410233,-27,0
54,1,10,8,83,-75,1,6.08919170690206,33,0
54,1,10,75,44,31,0,4.16934203857818,6,0
54,1,10,78,3,75,0,4.3187164867195,47,0
54,1,10,50,43,7,1,4.11005732154445,-7,0
54,1,10,66,41,25,0,4.6621887561123,9,0
54,1,10,97,3,94,0,4.36803976775627,47,0
54,1,1.5,86,28,58,0,0.57649124578893,22,0
54,1,1.5,66,41,25,0,0.759003264025523,9,0
54,1,1.5,43,100,-57,0,0.645468431899644,-50,0
54,1,1.5,11,50,-39,0,1.40067321353854,0,0
54,1,1.5,52,28,24,1,0.756925185130967,-22,0
54,1,1.5,5,63,-58,0,1.44401884810577,-13,0
54,1,1.5,0,98,-98,0,1.06364045300143,-48,0
54,1,1.5,82,12,70,0,0.786677877440525,38,0
54,1,1.5,37,77,-40,1,0.640447414145456,27,0
54,1,1.5,100,23,77,0,1.21886938430544,27,0
54,1,1.5,82,16,66,0,1.17187896115865,34,0
54,1,1.5,63,49,14,0,0.632804346230841,1,0
54,1,1.5,92,3,89,0,0.803303414206312,47,0
54,1,1.5,33,82,-49,0,0.599083863540727,-32,0
54,1,1.5,91,50,41,1,1.11491714027215,0,0
54,1,1.5,11,76,-65,0,0.993882930757536,-26,0
54,1,1.5,91,0,91,0,0.59024991514525,50,0
54,1,1.5,0,98,-98,0,0.834791863871942,-48,0
54,1,1.5,48,100,-52,0,0.861179601877666,-50,0
54,1,1.5,56,33,23,1,0.782905397496506,-17,0
54,1,10,0,96,-96,0,0.989673945572576,-46,0
54,1,10,3,95,-92,1,4.63053246625714,45,0
54,1,10,78,3,75,0,2.91186613164609,47,0
54,1,10,66,4,62,0,2.19091191790721,46,0
54,1,10,66,46,20,1,6.58273423672654,-4,0
54,1,10,67,28,39,0,4.77814368679537,22,0
54,1,10,38,79,-41,0,5.51721316991461,-29,0
54,1,10,51,5,46,0,5.77021233222331,45,0
54,1,10,2,85,-83,0,4.85306048364509,-35,0
54,1,10,48,69,-21,1,4.12551522188369,19,0
54,1,10,43,100,-57,0,4.1769612586977,-50,0
54,1,10,45,75,-30,0,5.8042769476815,-25,0
54,1,10,12,63,-51,0,3.61386798815511,-13,0
54,1,10,0,98,-98,0,5.48002992676629,-48,0
54,1,10,97,3,94,1,6.27904824278085,-47,0
54,1,10,88,40,48,0,3.55778491329693,10,0
54,1,10,71,0,71,0,3.07401937638133,50,0
54,1,10,47,54,-7,1,2.24178711695276,4,0
54,1,10,80,22,58,0,2.34705098980339,28,0
54,1,10,50,93,-43,1,2.84034779676585,43,0
54,1,1.5,99,2,97,1,0.969639381361048,-48,0
54,1,1.5,91,40,51,0,0.774049412528257,10,0
54,1,1.5,53,40,13,1,1.18717717181789,-10,0
54,1,1.5,91,16,75,0,0.758863799692335,34,0
54,1,1.5,82,16,66,0,0.979905405045429,34,0
54,1,1.5,30,98,-68,1,1.11964323021311,48,0
54,1,1.5,43,89,-46,1,1.06994321437014,39,0
54,1,1.5,88,16,72,0,0.782262110726151,34,0
54,1,1.5,1,100,-99,1,1.09745813810514,50,0
54,1,1.5,30,50,-20,NaN,NaN,0,0
54,1,1.5,48,80,-32,1,0.884182763977151,30,0
54,1,1.5,15,71,-56,1,0.611274011986097,21,0
54,1,1.5,40,78,-38,1,0.581749835906521,28,0
54,1,1.5,64,4,60,0,0.752209660666267,46,0
54,1,1.5,7,77,-70,0,0.725347683564905,-27,0
54,1,1.5,48,100,-52,1,0.555204521318956,50,0
54,1,1.5,0,98,-98,0,1.18358853121754,-48,0
54,1,1.5,24,89,-65,0,0.818576871457481,-39,0
54,1,1.5,99,25,74,1,1.02833665773142,-25,0
54,1,1.5,85,15,70,1,0.84606040062863,-35,0
55,1,10,48,60,-12,1,2.27605217655855,10,0
55,1,10,98,38,60,1,3.1571751361007,-12,0
55,1,10,53,40,13,0,3.85426162964404,10,0
55,1,10,75,0,75,1,2.76311233187107,-50,0
55,1,10,50,100,-50,0,3.11626861795412,-50,0
55,1,10,80,45,35,0,4.95070483641803,5,0
55,1,10,85,15,70,1,2.27121469627446,-35,0
55,1,10,28,85,-57,1,4.11517524175497,35,0
55,1,10,3,100,-97,0,6.52723890631614,-50,0
55,1,10,25,55,-30,0,3.5452925940458,-5,0
55,1,10,100,0,100,1,1.74764265857038,-50,0
55,1,10,3,100,-97,0,2.45025338857022,-50,0
55,1,10,28,85,-57,1,3.90423272551061,35,0
55,1,10,98,38,60,0,3.09902122725043,12,0
55,1,10,48,100,-52,0,3.77417559645346,-50,0
55,1,10,30,100,-70,0,7.46231131758532,-50,0
55,1,10,5,83,-78,0,2.85808150331104,-33,0
55,1,10,85,15,70,0,5.54321300579795,35,0
55,1,10,100,0,100,0,2.92090807096383,50,0
55,1,10,100,15,85,1,3.38803810937725,-35,0
55,1,1.5,30,100,-70,1,1.13143913724707,50,0
55,1,1.5,25,55,-30,0,0.974526672245702,-5,0
55,1,1.5,48,80,-32,NaN,NaN,0,0
55,1,1.5,50,43,7,0,0.780172864522228,7,0
55,1,1.5,48,60,-12,1,0.493938929711476,10,0
55,1,1.5,53,23,30,1,1.26646626788988,-27,0
55,1,1.5,53,0,53,0,0.647476478670796,50,0
55,1,1.5,0,68,-68,1,0.637980527513719,18,0
55,1,1.5,75,0,75,0,0.667869363574937,50,0
55,1,1.5,48,100,-52,1,0.624362831844337,50,0
55,1,1.5,48,80,-32,0,0.910894713179005,-30,0
55,1,1.5,80,45,35,1,0.882643526449556,-5,0
55,1,1.5,53,0,53,1,0.887047822071509,-50,0
55,1,1.5,53,23,30,0,0.939499390668061,27,0
55,1,1.5,0,68,-68,1,1.1978963055476,18,0
55,1,1.5,5,83,-78,0,0.997551870914322,-33,0
55,1,1.5,100,15,85,1,0.997301619984228,-35,0
55,1,1.5,50,100,-50,0,1.20575309801961,-50,0
55,1,1.5,53,40,13,1,0.693400995866341,-10,0
55,1,1.5,50,43,7,0,0.761230469026032,7,0
55,1,10,64,2,62,0,1.41232724127212,48,0
55,1,10,64,31,33,0,1.87109847599959,19,0
55,1,10,50,43,7,0,2.38375275086764,7,0
55,1,10,15,91,-76,0,1.87972081293265,-41,0
55,1,10,24,96,-72,0,2.01180983464474,-46,0
55,1,10,53,40,13,0,2.01503230591015,10,0
55,1,10,48,100,-52,0,1.91717875855056,-50,0
55,1,10,2,100,-98,0,0.883211345508244,-50,0
55,1,10,19,51,-32,NaN,NaN,0,0
55,1,10,49,75,-26,0,1.27330756683978,-25,0
55,1,10,44,88,-44,0,1.44746349822435,-38,0
55,1,10,39,71,-32,0,1.78839552445697,-21,0
55,1,10,80,45,35,0,1.33568917686807,5,0
55,1,10,75,28,47,0,2.10116360463417,22,0
55,1,10,2,100,-98,0,1.47919767075882,-50,0
55,1,10,28,85,-57,1,2.36730320480638,35,0
55,1,10,48,60,-12,0,1.9179379637244,-10,0
55,1,10,4,50,-46,0,1.66335367761121,0,0
55,1,10,50,97,-47,1,5.07480243126201,47,0
55,1,10,83,14,69,0,2.34865815209196,36,0
55,1,1.5,47,90,-43,0,1.00318478087365,-40,0
55,1,1.5,19,94,-75,0,0.857575265904416,-44,0
55,1,1.5,0,99,-99,0,1.02937479347702,-49,0
55,1,1.5,53,23,30,1,0.874369246600054,-27,0
55,1,1.5,83,14,69,0,1.22951365406516,36,0
55,1,1.5,56,26,30,NaN,NaN,0,0
55,1,1.5,20,50,-30,0,0.845719590355657,0,0
55,1,1.5,62,41,21,0,0.809386717375219,9,0
55,1,1.5,77,8,69,1,0.703181309359024,-42,0
55,1,1.5,0,68,-68,0,0.697004428137916,-18,0
55,1,1.5,96,11,85,0,0.825479150227693,39,0
55,1,1.5,85,1,84,1,0.774596102539817,-49,0
55,1,1.5,50,43,7,0,0.901687350549309,7,0
55,1,1.5,10,77,-67,0,1.04745836642041,-27,0
55,1,1.5,97,24,73,1,0.915817019170845,-26,0
55,1,1.5,29,80,-51,0,1.27684579500874,-30,0
55,1,1.5,92,9,83,1,0.999840353787022,-41,0
55,1,1.5,28,85,-57,0,0.781625467026061,-35,0
55,1,1.5,53,0,53,0,0.988081276907906,50,0
55,1,1.5,1,100,-99,1,0.817817366322288,50,0
55,1,10,83,46,37,1,1.95800377156866,-4,0
55,1,10,65,39,26,0,1.43456184019897,11,0
55,1,10,29,87,-58,1,5.3072918846492,37,0
55,1,10,75,0,75,1,2.12369916879334,-50,0
55,1,10,100,0,100,1,1.93177421388509,-50,0
55,1,10,53,17,36,0,1.53563997192032,33,0
55,1,10,75,28,47,0,1.99919676514628,22,0
55,1,10,37,67,-30,0,1.8040049639585,-17,0
55,1,10,1,100,-99,0,2.75724577387791,-50,0
55,1,10,68,15,53,0,2.49979552596642,35,0
55,1,10,100,0,100,0,2.05900824680384,50,0
55,1,10,54,42,12,0,1.4057660784656,8,0
55,1,10,96,17,79,0,2.41514490373538,33,0
55,1,10,46,75,-29,0,2.51578683208618,-25,0
55,1,10,0,98,-98,0,1.29973998173136,-48,0
55,1,10,83,14,69,0,1.80913495709092,36,0
55,1,10,57,23,34,0,2.67443626192744,27,0
55,1,10,69,50,19,0,2.77233297681823,0,0
55,1,10,48,100,-52,0,4.24215026948968,-50,0
55,1,10,53,25,28,0,2.14888244212943,25,0
55,1,1.5,32,72,-40,0,0.992153212730045,-22,0
55,1,1.5,48,100,-52,0,0.98186756744326,-50,0
55,1,1.5,1,100,-99,0,1.2989520988267,-50,0
55,1,1.5,28,50,-22,0,1.09125378854878,0,0
55,1,1.5,25,67,-42,NaN,NaN,0,0
55,1,1.5,36,85,-49,0,0.997480629395341,-35,0
55,1,1.5,75,0,75,0,1.0344749013957,50,0
55,1,1.5,78,42,36,1,1.03748908177886,-8,0
55,1,1.5,40,57,-17,0,0.960551259625845,-7,0
55,1,1.5,48,60,-12,0,1.06296607544664,-10,0
55,1,1.5,0,53,-53,0,1.1426165090088,-3,0
55,1,1.5,0,68,-68,0,1.2762281672608,-18,0
55,1,1.5,42,87,-45,0,0.949273063002238,-37,0
55,1,1.5,87,43,44,0,0.994274459154894,7,0
55,1,1.5,66,47,19,1,0.814671570250994,-3,0
55,1,1.5,88,11,77,1,0.977695410500928,-39,0
55,1,1.5,67,50,17,1,0.830739249694489,0,0
55,1,1.5,48,57,-9,0,0.879129447947889,-7,0
55,1,1.5,53,0,53,1,1.27900839773929,-50,0
55,1,1.5,64,2,62,0,1.21528678303184,48,0
55,1,10,27,56,-29,0,1.92469413509662,-6,0
55,1,10,89,49,40,0,2.97146177756076,1,0
55,1,10,1,51,-50,0,1.13588146859593,-1,0
55,1,10,68,15,53,0,1.97417197400318,35,0
55,1,10,69,50,19,0,1.14692873402373,0,0
55,1,10,1,62,-61,0,1.15777465159772,-12,0
55,1,10,13,50,-37,0,1.05944807262449,0,0
55,1,10,96,11,85,1,1.5609947078965,-39,0
55,1,10,96,26,70,1,2.45383478426993,-24,0
55,1,10,62,29,33,0,1.55773208780829,21,0
55,1,10,49,100,-51,0,2.01241418007521,-50,0
55,1,10,75,5,70,1,1.39913699471936,-45,0
55,1,10,87,0,87,1,2.31124277026265,-50,0
55,1,10,57,38,19,0,1.03720562505532,12,0
55,1,10,24,85,-61,0,2.57877188193288,-35,0
55,1,10,96,17,79,0,1.61460666801941,33,0
55,1,10,0,52,-52,0,1.47728199837957,-2,0
55,1,10,30,54,-24,0,1.62082067935444,-4,0
55,1,10,53,17,36,0,1.13429996724153,33,0
55,1,10,53,25,28,0,1.59180032571294,25,0
55,1,1.5,64,2,62,0,1.11824526824512,48,0
55,1,1.5,80,31,49,1,1.37133921799796,-19,0
55,1,1.5,1,100,-99,0,0.783455106215115,-50,0
55,1,1.5,7,96,-89,0,0.850570956698903,-46,0
55,1,1.5,0,52,-52,0,0.690231050127295,-2,0
55,1,1.5,90,45,45,1,0.920739627033072,-5,0
55,1,1.5,8,62,-54,0,0.822501496217228,-12,0
55,1,1.5,57,46,11,0,0.943659170906358,4,0
55,1,1.5,65,39,26,1,0.867981055787823,-11,0
55,1,1.5,70,44,26,1,0.899045980660048,-6,0
55,1,1.5,48,54,-6,0,0.877989583639646,-4,0
55,1,1.5,88,17,71,1,1.061050101197,-33,0
55,1,1.5,53,40,13,1,0.80469051264663,-10,0
55,1,1.5,98,15,83,NaN,NaN,0,0
55,1,1.5,93,14,79,0,0.742399463872061,36,0
55,1,1.5,90,35,55,0,0.89008071844728,15,0
55,1,1.5,16,75,-59,0,0.752484968788849,-25,0
55,1,1.5,80,45,35,1,0.539595083726454,-5,0
55,1,1.5,29,87,-58,0,0.648119463569856,-37,0
55,1,1.5,2,51,-49,0,0.711279900377122,-1,0
56,1,10,53,23,30,1,2.93040673869655,-27,0
56,1,10,75,0,75,0,1.00485623947861,50,0
56,1,10,50,100,-50,1,1.89780317812983,50,0
56,1,10,48,100,-52,1,1.72305376866461,50,0
56,1,10,48,100,-52,1,1.01465677831766,50,0
56,1,10,53,0,53,0,1.53437151036815,50,0
56,1,10,50,100,-50,1,2.31324990924622,50,0
56,1,10,100,15,85,0,1.66858026915179,35,0
56,1,10,5,83,-78,0,1.52592848471795,-33,0
56,1,10,100,0,100,0,3.19807501282594,50,0
56,1,10,98,38,60,0,3.10243297127272,12,0
56,1,10,48,60,-12,1,1.91411356173194,10,0
56,1,10,48,60,-12,1,5.05080037827793,10,0
56,1,10,80,45,35,0,5.74390368602872,5,0
56,1,10,48,80,-32,1,4.02554405219598,30,0
56,1,10,100,0,100,0,4.77635842426753,50,0
56,1,10,0,68,-68,0,5.1282432303542,-18,0
56,1,10,3,100,-97,0,5.57001702343769,-50,0
56,1,10,53,23,30,1,3.65767488302117,-27,0
56,1,10,48,80,-32,1,4.70324681507009,30,0
56,1,1.5,85,15,70,0,1.04573106118551,35,0
56,1,1.5,98,38,60,0,1.12479707279272,12,0
56,1,1.5,80,45,35,0,1.23245176273485,5,0
56,1,1.5,28,85,-57,0,1.19879105046857,-35,0
56,1,1.5,53,0,53,0,0.78248640241145,50,0
56,1,1.5,25,55,-30,1,0.966894773289823,5,0
56,1,1.5,100,15,85,0,1.06337239334061,35,0
56,1,1.5,53,40,13,1,1.08577121000781,-10,0
56,1,1.5,28,85,-57,0,1.3541703134506,-35,0
56,1,1.5,30,100,-70,0,1.29241780226221,-50,0
56,1,1.5,30,100,-70,0,0.832708051080772,-50,0
56,1,1.5,50,43,7,1,0.783194289542735,-7,0
56,1,1.5,3,100,-97,0,0.79164908815801,-50,0
56,1,1.5,75,0,75,0,0.632132685250326,50,0
56,1,1.5,85,15,70,NaN,NaN,0,0
56,1,1.5,25,55,-30,1,0.715794378595092,5,0
56,1,1.5,53,40,13,1,0.823004714653507,-10,0
56,1,1.5,0,68,-68,0,0.709437582348983,-18,0
56,1,1.5,50,43,7,1,0.753275266397395,-7,0
56,1,1.5,5,83,-78,0,0.771134851174793,-33,0
56,1,10,66,40,26,1,1.73345804919336,-10,0
56,1,10,37,86,-49,0,4.63958949885273,-36,0
56,1,10,0,82,-82,0,3.94087078965276,-32,0
56,1,10,24,98,-74,0,3.95834277226459,-48,0
56,1,10,43,87,-44,1,1.77516694004407,37,0
56,1,10,48,70,-22,1,2.51125484483418,20,0
56,1,10,3,87,-84,0,3.23457149980459,-37,0
56,1,10,35,53,-18,1,2.62356740190626,3,0
56,1,10,41,89,-48,1,4.69350302794919,39,0
56,1,10,6,89,-83,0,2.59208378217227,-39,0
56,1,10,86,10,76,0,2.41267439248077,40,0
56,1,10,90,31,59,0,2.11524316243231,19,0
56,1,10,5,97,-92,0,2.31666829469032,-47,0
56,1,10,3,93,-90,0,2.38996344136103,-43,0
56,1,10,74,31,43,0,3.23658135588812,19,0
56,1,10,47,55,-8,1,1.38498559113577,5,0
56,1,10,65,23,42,0,5.03641381756825,27,0
56,1,10,68,38,30,1,5.12815719716309,-12,0
56,1,10,79,33,46,0,2.38458380104203,17,0
56,1,10,2,66,-64,0,1.44731105318533,-16,0
56,1,1.5,84,24,60,0,0.816771685455024,26,0
56,1,1.5,68,17,51,0,0.815218559959249,33,0
56,1,1.5,14,66,-52,0,0.917003069456769,-16,0
56,1,1.5,0,53,-53,0,0.918083163338451,-3,0
56,1,1.5,42,96,-54,0,1.42315625381525,-46,0
56,1,1.5,62,4,58,0,0.980730419709289,46,0
56,1,1.5,100,16,84,0,0.939776507841088,34,0
56,1,1.5,16,54,-38,NaN,NaN,0,0
56,1,1.5,39,65,-26,1,0.984072733701396,15,0
56,1,1.5,83,47,36,NaN,NaN,0,0
56,1,1.5,5,66,-61,0,0.777050010372477,-16,0
56,1,1.5,34,90,-56,0,1.04013528133873,-40,0
56,1,1.5,94,2,92,0,0.76453927509101,48,0
56,1,1.5,74,39,35,0,1.09165286154348,11,0
56,1,1.5,76,32,44,0,1.25400715225987,18,0
56,1,1.5,43,90,-47,1,0.945621331133225,40,0
56,1,1.5,43,61,-18,1,1.10604878024969,11,0
56,1,1.5,53,42,11,1,1.09975235817365,-8,0
56,1,1.5,53,39,14,NaN,NaN,0,0
56,1,1.5,96,15,81,0,0.784609761933098,35,0
56,1,10,78,13,65,0,0.949731906424859,37,0
56,1,10,49,65,-16,1,3.0653043667462,15,0
56,1,10,24,100,-76,0,2.29103161134481,-50,0
56,1,10,54,11,43,0,1.36162078776579,39,0
56,1,10,20,96,-76,0,3.8171478165259,-46,0
56,1,10,4,98,-94,0,3.15661063735752,-48,0
56,1,10,67,11,56,0,3.21101651780191,39,0
56,1,10,38,80,-42,0,2.80735361697407,-30,0
56,1,10,95,12,83,0,2.45991174597839,38,0
56,1,10,9,64,-55,0,1.84649479442123,-14,0
56,1,10,34,80,-46,0,1.63644883458619,-30,0
56,1,10,74,2,72,0,2.62391938331166,48,0
56,1,10,97,27,70,0,2.75582607503384,23,0
56,1,10,86,17,69,0,2.49827802096843,33,0
56,1,10,50,31,19,1,1.72290977627199,-19,0
56,1,10,77,39,38,1,3.51506807734404,-11,0
56,1,10,25,77,-52,0,3.7952878393171,-27,0
56,1,10,46,92,-46,1,4.00013407385632,42,0
56,1,10,86,10,76,0,2.46752673990341,40,0
56,1,10,94,48,46,0,5.94947229749778,2,0
56,1,1.5,95,36,59,0,1.00710457352761,14,0
56,1,1.5,37,89,-52,0,0.988159159323914,-39,0
56,1,1.5,43,81,-38,1,1.30515946874038,31,0
56,1,1.5,31,91,-60,0,0.929493579393238,-41,0
56,1,1.5,1,63,-62,0,0.745191165180586,-13,0
56,1,1.5,78,30,48,0,1.11234490045354,20,0
56,1,1.5,12,56,-44,0,1.00864954851022,-6,0
56,1,1.5,46,82,-36,1,1.2930287888521,32,0
56,1,1.5,46,67,-21,1,1.42994774407816,17,0
56,1,1.5,44,87,-43,0,1.01761752756101,-37,0
56,1,1.5,34,60,-26,0,1.42724871685641,-10,0
56,1,1.5,7,79,-72,0,0.870776983287215,-29,0
56,1,1.5,7,63,-56,0,0.728586155632001,-13,0
56,1,1.5,29,66,-37,0,1.47234701355046,-16,0
56,1,1.5,99,10,89,0,1.20930219327602,40,0
56,1,1.5,23,56,-33,1,1.46955319888366,6,0
56,1,1.5,85,46,39,NaN,NaN,0,0
56,1,1.5,98,29,69,0,0.935662913841952,21,0
56,1,1.5,43,59,-16,1,0.758055994963797,9,0
56,1,1.5,93,20,73,0,0.883821426223221,30,0
56,1,10,11,54,-43,0,4.76425853520595,-4,0
56,1,10,43,70,-27,1,4.38480446862741,20,0
56,1,10,92,30,62,0,4.29213374179744,20,0
56,1,10,15,100,-85,0,4.74744674412977,-50,0
56,1,10,83,41,42,0,3.38469458763939,9,0
56,1,10,7,90,-83,0,4.48424404540492,-40,0
56,1,10,62,49,13,1,3.1395766693422,-1,0
56,1,10,21,89,-68,0,2.67328643561814,-39,0
56,1,10,19,58,-39,0,3.39309806821075,-8,0
56,1,10,44,97,-53,0,4.252719673108,-47,0
56,1,10,88,31,57,0,2.0667252728108,19,0
56,1,10,8,93,-85,0,2.89147988954937,-43,0
56,1,10,87,22,65,0,3.62717928656093,28,0
56,1,10,40,68,-28,0,7.20407982766483,-18,0
56,1,10,83,34,49,1,1.67724516987255,-16,0
56,1,10,99,9,90,0,4.23386089583437,41,0
56,1,10,92,5,87,0,4.89055012734934,45,0
56,1,10,0,88,-88,0,4.32103757329423,-38,0
56,1,10,61,27,34,1,3.23036764642166,-23,0
56,1,10,72,0,72,0,3.44007551091272,50,0
56,1,1.5,82,24,58,1,0.742024540020793,-26,0
56,1,1.5,58,25,33,1,0.731837908371745,-25,0
56,1,1.5,49,71,-22,1,0.977602735889377,21,0
56,1,1.5,100,46,54,0,1.10202514376215,4,0
56,1,1.5,40,60,-20,1,0.89301460092247,10,0
56,1,1.5,89,12,77,0,0.676056704358416,38,0
56,1,1.5,5,69,-64,0,0.675853545280916,-19,0
56,1,1.5,16,51,-35,0,0.988348432341809,-1,0
56,1,1.5,14,76,-62,0,0.704061866350457,-26,0
56,1,1.5,55,41,14,1,0.742441725527897,-9,0
56,1,1.5,90,41,49,0,0.857517306440059,9,0
56,1,1.5,73,39,34,NaN,NaN,0,0
56,1,1.5,37,96,-59,1,1.03515320492079,46,0
56,1,1.5,84,26,58,0,0.988847122978768,24,0
56,1,1.5,11,82,-71,0,0.84787404231065,-32,0
56,1,1.5,60,35,25,1,0.888345564568226,-15,0
56,1,1.5,94,17,77,0,0.679349813402951,33,0
56,1,1.5,63,9,54,0,1.10321692985599,41,0
56,1,1.5,93,40,53,0,1.23747610107057,10,0
56,1,1.5,17,70,-53,0,1.01442645086354,-20,0
57,1,10,53,23,30,0,1.71726418625622,27,0
57,1,10,50,100,-50,1,2.45996728873433,50,0
57,1,10,28,85,-57,1,1.79330092393866,35,0
57,1,10,50,43,7,1,1.39056446473478,-7,0
57,1,10,75,0,75,0,5.3072813174258,50,0
57,1,10,25,55,-30,1,3.46971741514426,5,0
57,1,10,3,100,-97,1,2.26605632554129,50,0
57,1,10,28,85,-57,1,2.63143868269981,35,0
57,1,10,53,0,53,0,1.51056355912078,50,0
57,1,10,50,100,-50,1,3.20285060810784,50,0
57,1,10,3,100,-97,1,2.68192809080574,50,0
57,1,10,25,55,-30,1,2.87049775127525,5,0
57,1,10,48,100,-52,1,2.49160184388893,50,0
57,1,10,80,45,35,1,1.99962662748658,-5,0
57,1,10,0,68,-68,0,2.14361086982899,-18,0
57,1,10,48,60,-12,1,2.13036055097837,10,0
57,1,10,100,0,100,0,5.39420110279752,50,0
57,1,10,53,23,30,1,1.30534240099223,-27,0
57,1,10,48,80,-32,0,3.80214000413616,-30,0
57,1,10,100,15,85,0,1.74566268596027,35,0
57,1,1.5,5,83,-78,1,1.06968602057532,33,0
57,1,1.5,48,80,-32,1,1.01941848753631,30,0
57,1,1.5,98,38,60,1,0.883093916007056,-12,0
57,1,1.5,48,60,-12,1,1.44824473822518,10,0
57,1,1.5,53,40,13,1,1.0778298922196,-10,0
57,1,1.5,48,100,-52,1,1.29156350629273,50,0
57,1,1.5,75,0,75,0,1.17584373299906,50,0
57,1,1.5,50,43,7,1,1.42552412724035,-7,0
57,1,1.5,85,15,70,0,1.20048514816881,35,0
57,1,1.5,30,100,-70,NaN,NaN,0,0
57,1,1.5,5,83,-78,1,1.06874418353982,33,0
57,1,1.5,85,15,70,0,1.00975379057854,35,0
57,1,1.5,98,38,60,1,0.857504022642388,-12,0
57,1,1.5,100,0,100,0,0.887281166491448,50,0
57,1,1.5,80,45,35,0,1.11570623082662,5,0
57,1,1.5,0,68,-68,1,1.28669040524983,18,0
57,1,1.5,53,40,13,NaN,NaN,0,0
57,1,1.5,30,100,-70,0,1.28823145591014,-50,0
57,1,1.5,53,0,53,0,1.22056770984273,50,0
57,1,1.5,100,15,85,0,1.02756024608607,35,0
57,1,10,92,22,70,0,1.50858751257329,28,0
57,1,10,45,81,-36,0,4.12401824453264,-31,0
57,1,10,11,80,-69,0,0.965433716923144,-30,0
57,1,10,93,13,80,0,1.55503094574669,37,0
57,1,10,96,7,89,0,2.89990932953151,43,0
57,1,10,76,27,49,0,2.49509388581646,23,0
57,1,10,35,53,-18,1,1.39499472124953,3,0
57,1,10,51,43,8,0,3.26314598872705,7,0
57,1,10,98,5,93,0,1.01948701222136,45,0
57,1,10,94,43,51,0,1.98232339067545,7,0
57,1,10,46,69,-23,1,1.7558115837528,19,0
57,1,10,68,32,36,1,1.49719309567445,-18,0
57,1,10,97,19,78,0,1.30070657043325,31,0
57,1,10,65,0,65,0,1.30819870292544,50,0
57,1,10,53,23,30,1,0.751180583123642,-27,0
57,1,10,53,49,4,1,1.94083607302309,-1,0
57,1,10,94,17,77,0,1.17424925119485,33,0
57,1,10,76,25,51,0,2.27514233608963,25,0
57,1,10,79,35,44,0,1.46314266814807,15,0
57,1,10,51,5,46,0,2.94392360802522,45,0
57,1,1.5,24,77,-53,0,0.852098119557922,-27,0
57,1,1.5,14,54,-40,0,0.617207585470169,-4,0
57,1,1.5,5,83,-78,0,0.527671485495375,-33,0
57,1,1.5,99,0,99,0,0.657529379794141,50,0
57,1,1.5,96,39,57,0,0.814074769848958,11,0
57,1,1.5,60,40,20,1,0.68520338946837,-10,0
57,1,1.5,37,92,-55,1,0.760417227229482,42,0
57,1,1.5,95,12,83,1,0.912826081097592,-38,0
57,1,1.5,97,22,75,0,0.603259039358818,28,0
57,1,1.5,53,49,4,1,0.713751918978232,-1,0
57,1,1.5,99,9,90,0,0.978225493960053,41,0
57,1,1.5,51,44,7,1,0.874000056814111,-6,0
57,1,1.5,59,33,26,0,0.741063683643006,17,0
57,1,1.5,32,61,-29,1,0.813541062194417,11,0
57,1,1.5,53,49,4,0,0.755328892271791,1,0
57,1,1.5,86,16,70,0,0.89906016684472,34,0
57,1,1.5,51,8,43,1,0.548894213348831,-42,0
57,1,1.5,68,14,54,NaN,NaN,0,0
57,1,1.5,94,13,81,0,1.11992366839695,37,0
57,1,1.5,80,8,72,1,0.984882047952851,-42,0
57,1,10,61,4,57,0,4.8243652450692,46,0
57,1,10,62,39,23,0,3.27489812257772,11,0
57,1,10,51,48,3,1,2.84454199044922,-2,0
57,1,10,80,45,35,0,3.2797310747992,5,0
57,1,10,96,13,83,0,2.9928007239505,37,0
57,1,10,87,17,70,0,2.87780725190532,33,0
57,1,10,100,15,85,0,3.35960791149409,35,0
57,1,10,77,38,39,0,3.13325458676263,12,0
57,1,10,65,13,52,0,2.92367320615813,37,0
57,1,10,25,71,-46,0,2.62672225262213,-21,0
57,1,10,51,48,3,1,2.81264118520994,-2,0
57,1,10,87,17,70,0,2.45643177740567,33,0
57,1,10,55,7,48,0,2.70570434413457,43,0
57,1,10,96,7,89,0,2.06557363405955,43,0
57,1,10,15,87,-72,0,2.05021746419516,-37,0
57,1,10,28,70,-42,0,3.21222490530999,-20,0
57,1,10,25,64,-39,0,2.99992336652576,-14,0
57,1,10,95,13,82,0,1.13178296639671,37,0
57,1,10,45,93,-48,1,2.85391206146232,43,0
57,1,10,95,10,85,0,2.9990494504309,40,0
57,1,1.5,72,44,28,0,1.02470515163805,6,0
57,1,1.5,53,21,32,0,0.995697476573696,29,0
57,1,1.5,91,10,81,0,0.736167338542145,40,0
57,1,1.5,51,48,3,1,0.6791907259867,-2,0
57,1,1.5,48,94,-46,1,0.98369509179247,44,0
57,1,1.5,11,67,-56,0,0.85266956106716,-17,0
57,1,1.5,11,61,-50,0,1.02242300805665,-11,0
57,1,1.5,87,17,70,0,1.00080905558207,33,0
57,1,1.5,93,16,77,0,1.46853136459322,34,0
57,1,1.5,20,65,-45,1,1.0041057870767,15,0
57,1,1.5,87,18,69,0,1.02975726209479,32,0
57,1,1.5,27,55,-28,1,1.20749307982624,5,0
57,1,1.5,79,44,35,0,0.99447671087546,6,0
57,1,1.5,100,7,93,0,1.20606221202252,43,0
57,1,1.5,0,70,-70,0,1.12042749083776,-20,0
57,1,1.5,95,33,62,0,0.982082497739611,17,0
57,1,1.5,97,25,72,NaN,NaN,0,0
57,1,1.5,51,48,3,1,1.08227222356436,-2,0
57,1,1.5,89,15,74,0,0.7853484384068,35,0
57,1,1.5,84,22,62,0,0.701030779720895,28,0
57,1,10,89,38,51,0,1.29183156760337,12,0
57,1,10,44,83,-39,1,5.49602998730916,33,0
57,1,10,17,52,-35,1,2.75832526227532,2,0
57,1,10,95,24,71,0,2.55485887936811,26,0
57,1,10,35,89,-54,0,2.52802588186751,-39,0
57,1,10,96,20,76,0,2.93396639821367,30,0
57,1,10,6,92,-86,0,3.21969711432757,-42,0
57,1,10,68,37,31,1,2.10137823306286,-13,0
57,1,10,5,83,-78,0,0.932719671629457,-33,0
57,1,10,51,48,3,1,1.68832563961405,-2,0
57,1,10,51,48,3,1,3.86632257562451,-2,0
57,1,10,52,45,7,1,3.84175753377713,-5,0
57,1,10,12,62,-50,0,2.77859588948922,-12,0
57,1,10,93,0,93,0,3.49505041641896,50,0
57,1,10,89,17,72,0,2.14266208976187,33,0
57,1,10,47,100,-53,1,5.50445369322551,50,0
57,1,10,91,48,43,0,5.26277046139512,2,0
57,1,10,100,13,87,0,3.31118118686572,37,0
57,1,10,76,23,53,0,1.74218090763679,27,0
57,1,10,96,26,70,0,2.5396204391327,24,0
57,1,1.5,97,47,50,NaN,NaN,0,0
57,1,1.5,26,55,-29,1,1.15728048728488,5,0
57,1,1.5,88,13,75,1,0.938920400643838,-37,0
57,1,1.5,87,7,80,0,0.760631555527652,43,0
57,1,1.5,57,41,16,1,0.814444561634446,-9,0
57,1,1.5,100,26,74,0,0.970257311149908,24,0
57,1,1.5,6,100,-94,0,1.27126993689672,-50,0
57,1,1.5,51,48,3,1,0.936123567269533,-2,0
57,1,1.5,96,25,71,0,0.814564706230158,25,0
57,1,1.5,82,19,63,0,0.858340808626963,31,0
57,1,1.5,99,0,99,0,0.816744213723723,50,0
57,1,1.5,69,17,52,0,1.02715785225155,33,0
57,1,1.5,8,92,-84,0,0.669633796918788,-42,0
57,1,1.5,97,35,62,1,1.39808829366302,-15,0
57,1,1.5,51,48,3,1,1.24893119252738,-2,0
57,1,1.5,89,47,42,NaN,NaN,0,0
57,1,1.5,49,52,-3,1,1.05040945405199,2,0
57,1,1.5,92,17,75,0,0.77144758788927,33,0
57,1,1.5,96,39,57,0,1.03183232227821,11,0
57,1,1.5,3,73,-70,0,1.10551144866622,-23,0
58,1,10,53,0,53,1,3.43769010966253,-50,0
58,1,10,28,85,-57,0,3.67534069079557,-35,0
58,1,10,28,85,-57,0,4.12754625573962,-35,0
58,1,10,25,55,-30,0,3.69033616573961,-5,0
58,1,10,25,55,-30,0,4.9505667473918,-5,0
58,1,10,53,40,13,1,3.64575304145228,-10,0
58,1,10,48,80,-32,0,4.02799894248801,-30,0
58,1,10,5,83,-78,0,5.06672666209488,-33,0
58,1,10,50,100,-50,0,4.16719770264035,-50,0
58,1,10,53,0,53,1,5.71929743137844,-50,0
58,1,10,30,100,-70,0,5.08886351501042,-50,0
58,1,10,53,40,13,0,5.44465096837757,10,0
58,1,10,0,68,-68,0,5.95370802393427,-18,0
58,1,10,85,15,70,1,5.48184789677362,-35,0
58,1,10,75,0,75,1,5.68556236723362,-50,0
58,1,10,5,83,-78,0,6.16786363153187,-33,0
58,1,10,30,100,-70,0,5.59128301640249,-50,0
58,1,10,53,23,30,1,5.79091406885345,-27,0
58,1,10,50,43,7,1,4.82982834514951,-7,0
58,1,10,98,38,60,1,5.54770180417017,-12,0
58,1,1.5,80,45,35,1,0.925459779166886,-5,0
58,1,1.5,98,38,60,1,0.768566207644653,-12,0
58,1,1.5,100,15,85,1,0.746377432802547,-35,0
58,1,1.5,100,0,100,1,0.828870808229112,-50,0
58,1,1.5,0,68,-68,0,0.564628955896296,-18,0
58,1,1.5,3,100,-97,0,1.01456263469208,-50,0
58,1,1.5,48,80,-32,0,1.0622505090505,-30,0
58,1,1.5,48,60,-12,0,1.14797934497892,-10,0
58,1,1.5,85,15,70,1,0.894357941553608,-35,0
58,1,1.5,50,43,7,1,1.08271740791679,-7,0
58,1,1.5,75,0,75,1,0.671794604349998,-50,0
58,1,1.5,80,45,35,1,0.773045983148222,-5,0
58,1,1.5,100,15,85,1,0.662116900652109,-35,0
58,1,1.5,3,100,-97,0,0.787979876273312,-50,0
58,1,1.5,100,0,100,1,0.708467785407265,-50,0
58,1,1.5,53,23,30,1,0.936279463373467,-27,0
58,1,1.5,48,100,-52,1,1.0506752400679,50,0
58,1,1.5,48,100,-52,0,0.960370633446473,-50,0
58,1,1.5,50,100,-50,0,1.1935031013727,-50,0
58,1,1.5,48,60,-12,0,1.1611687217528,-10,0
58,1,10,51,4,47,1,6.2353639469884,-46,0
58,1,10,15,57,-42,0,6.19876895069228,-7,0
58,1,10,21,84,-63,0,5.8509364194324,-34,0
58,1,10,89,7,82,1,6.062412916006,-43,0
58,1,10,78,22,56,1,5.76119178474801,-28,0
58,1,10,49,100,-51,0,5.71277066411494,-50,0
58,1,10,51,0,51,1,6.1703637326591,-50,0
58,1,10,89,18,71,1,6.39314834179368,-32,0
58,1,10,87,28,59,1,6.61517887550781,-22,0
58,1,10,51,2,49,1,7.14128322771194,-48,0
58,1,10,49,98,-49,0,6.84365829359649,-48,0
58,1,10,51,1,50,1,6.33560103699438,-49,0
58,1,10,51,3,48,1,6.95962531230543,-47,0
58,1,10,49,97,-48,0,6.79013886241955,-47,0
58,1,10,0,62,-62,0,6.93940836317688,-12,0
58,1,10,41,78,-37,0,6.97132495241385,-28,0
58,1,10,33,89,-56,0,5.6798847649643,-39,0
58,1,10,53,42,11,1,7.56942569664807,-8,0
58,1,10,0,85,-85,0,7.27909277446452,-35,0
58,1,10,92,33,59,1,7.42548875884677,-17,0
58,1,1.5,51,0,51,NaN,NaN,0,0
58,1,1.5,0,82,-82,0,0.870282166935795,-32,0
58,1,1.5,49,99,-50,0,1.01801876338141,-49,0
58,1,1.5,79,7,72,1,0.791777421814913,-43,0
58,1,1.5,86,2,84,1,0.654234427743177,-48,0
58,1,1.5,84,23,61,1,0.810766357010834,-27,0
58,1,1.5,33,90,-57,0,0.977134472601392,-40,0
58,1,1.5,29,75,-46,0,0.696912741825145,-25,0
58,1,1.5,51,2,49,1,0.652058536784352,-48,0
58,1,1.5,49,96,-47,0,0.976600461625821,-46,0
58,1,1.5,69,41,28,1,0.807657984479192,-9,0
58,1,1.5,49,100,-51,0,0.774104043332954,-50,0
58,1,1.5,51,4,47,1,0.749879445985243,-46,0
58,1,1.5,56,5,51,1,0.750374515515432,-45,0
58,1,1.5,30,72,-42,0,0.686818757101719,-22,0
58,1,1.5,53,36,17,1,0.841210718139337,-14,0
58,1,1.5,51,3,48,1,0.621807071649528,-47,0
58,1,1.5,41,62,-21,0,0.75490983540567,-12,0
58,1,1.5,49,99,-50,0,0.723373906337656,-49,0
58,1,1.5,72,4,68,1,0.724534602889435,-46,0
58,1,10,31,75,-44,0,5.29843037143291,-25,0
58,1,10,66,20,46,1,4.56221820878181,-30,0
58,1,10,49,58,-9,0,4.1760760501702,-8,0
58,1,10,9,87,-78,0,5.74222398056827,-37,0
58,1,10,51,3,48,1,4.7951251785762,-47,0
58,1,10,51,2,49,1,6.38498754320972,-48,0
58,1,10,51,0,51,1,5.30227893328629,-50,0
58,1,10,55,13,42,1,5.11003679357236,-37,0
58,1,10,31,94,-63,0,4.18179682008849,-44,0
58,1,10,49,100,-51,0,5.27515878292979,-50,0
58,1,10,1,51,-50,0,5.53825533416693,-1,0
58,1,10,8,90,-82,0,7.17657655339008,-40,0
58,1,10,51,0,51,1,6.65294271888979,-50,0
58,1,10,12,72,-60,0,6.19016862696571,-22,0
58,1,10,51,4,47,1,6.75368634954884,-46,0
58,1,10,49,98,-49,0,6.92682725780833,-48,0
58,1,10,51,2,49,1,7.77335419411793,-48,0
58,1,10,40,91,-51,0,6.26568001265878,-41,0
58,1,10,18,67,-49,0,7.11509404956996,-17,0
58,1,10,32,80,-48,0,7.01020783405693,-30,0
58,1,1.5,20,64,-44,0,0.644362016821105,-14,0
58,1,1.5,51,3,48,1,0.655430745149715,-47,0
58,1,1.5,49,97,-48,0,0.810676701125885,-47,0
58,1,1.5,78,7,71,1,0.59903870321159,-43,0
58,1,1.5,0,86,-86,0,0.683562467454976,-36,0
58,1,1.5,32,92,-60,0,0.725371391143199,-42,0
58,1,1.5,1,86,-85,0,0.605168811106523,-36,0
58,1,1.5,49,99,-50,0,0.969665563873605,-49,0
58,1,1.5,11,84,-73,0,0.743382865889544,-34,0
58,1,1.5,49,96,-47,0,0.605818137057213,-46,0
58,1,1.5,51,4,47,1,0.696303262934634,-46,0
58,1,1.5,60,36,24,1,1.16951185082144,-14,0
58,1,1.5,51,2,49,1,0.726422508279938,-48,0
58,1,1.5,65,31,34,1,0.781579895109644,-19,0
58,1,1.5,23,87,-64,0,0.761273893840553,-37,0
58,1,1.5,93,30,63,1,0.759030685500875,-20,0
58,1,1.5,95,22,73,1,0.708922404134682,-28,0
58,1,1.5,49,96,-47,0,0.700665006618692,-46,0
58,1,1.5,51,0,51,1,0.740485501651165,-50,0
58,1,1.5,69,22,47,1,1.0909388827049,-28,0
58,1,10,49,96,-47,0,5.50626991819081,-46,0
58,1,10,6,90,-84,0,4.83187171444843,-40,0
58,1,10,2,100,-98,0,6.16169760090906,-50,0
58,1,10,51,0,51,0,5.02917563823667,50,0
58,1,10,49,97,-48,0,5.36690603423813,-47,0
58,1,10,37,92,-55,0,5.89855184459157,-42,0
58,1,10,81,29,52,1,4.49006786220343,-21,0
58,1,10,97,33,64,1,6.74475064640137,-17,0
58,1,10,49,98,-49,0,7.46127896528469,-48,0
58,1,10,61,18,43,1,7.38893149650903,-32,0
58,1,10,49,98,-49,0,6.98862370815914,-48,0
58,1,10,49,97,-48,0,6.8231787161194,-47,0
58,1,10,99,13,86,1,6.7271041344984,-37,0
58,1,10,44,71,-27,0,7.00430714862705,-21,0
58,1,10,87,9,78,0,8.7253834660105,41,0
58,1,10,24,63,-39,0,7.91335381979752,-13,0
58,1,10,63,45,18,1,6.11821902504289,-5,0
58,1,10,51,3,48,0,6.67498840656208,47,0
58,1,10,51,1,50,0,5.80961049040707,49,0
58,1,10,95,5,90,1,5.55521991797923,-45,0
58,1,1.5,51,4,47,1,0.561371458762551,-46,0
58,1,1.5,3,67,-64,0,1.0779366663628,-17,0
58,1,1.5,51,0,51,1,0.72618342592159,-50,0
58,1,1.5,9,75,-66,0,0.908682657658574,-25,0
58,1,1.5,20,71,-51,0,1.02773480478118,-21,0
58,1,1.5,66,0,66,1,0.606059936260863,-50,0
58,1,1.5,51,1,50,1,0.657227485297881,-49,0
58,1,1.5,16,88,-72,0,0.761685948662489,-38,0
58,1,1.5,51,3,48,1,0.606133894818413,-47,0
58,1,1.5,72,25,47,1,0.729365455139487,-25,0
58,1,1.5,49,98,-49,0,0.669052402147827,-48,0
58,1,1.5,15,72,-57,0,0.716869779450462,-22,0
58,1,1.5,72,30,42,1,0.938654891502665,-20,0
58,1,1.5,49,99,-50,0,0.71233053522792,-49,0
58,1,1.5,42,56,-14,0,0.662797319383571,-6,0
58,1,1.5,67,25,42,1,0.671304062895615,-25,0
58,1,1.5,30,74,-44,0,0.615055409996785,-24,0
58,1,1.5,49,100,-51,0,0.584901449410609,-50,0
58,1,1.5,51,3,48,1,0.660054513438808,-47,0
58,1,1.5,7,55,-48,0,0.612547460207679,-5,0
59,1,10,100,15,85,1,4.54929508168243,-35,0
59,1,10,0,68,-68,0,3.95852710205509,-18,0
59,1,10,98,38,60,1,4.02329578081662,-12,0
59,1,10,25,55,-30,0,4.03012774033232,-5,0
59,1,10,0,68,-68,0,5.06897107678742,-18,0
59,1,10,50,43,7,1,4.14541494405239,-7,0
59,1,10,30,100,-70,0,5.20353037132554,-50,0
59,1,10,85,15,70,1,4.89060748685733,-35,0
59,1,10,80,45,35,1,8.10242087221013,-5,0
59,1,10,48,100,-52,0,6.3126442995017,-50,0
59,1,10,28,85,-57,0,4.57137427711132,-35,0
59,1,10,3,100,-97,0,3.82007637988863,-50,0
59,1,10,98,38,60,1,4.57884378958261,-12,0
59,1,10,100,0,100,1,4.05952581427118,-50,0
59,1,10,50,43,7,1,3.41699982462887,-7,0
59,1,10,5,83,-78,0,3.81596971776162,-33,0
59,1,10,30,100,-70,0,5.3741434062631,-50,0
59,1,10,100,0,100,0,4.59782698921481,50,0
59,1,10,5,83,-78,0,3.86112126639273,-33,0
59,1,10,53,0,53,0,3.12261336973097,50,0
59,1,1.5,25,55,-30,0,1.29487492583212,-5,0
59,1,1.5,3,100,-97,0,0.635828707469045,-50,0
59,1,1.5,50,100,-50,0,0.762381459844619,-50,0
59,1,1.5,85,15,70,1,0.604172633478811,-35,0
59,1,1.5,48,80,-32,0,0.756091661838582,-30,0
59,1,1.5,75,0,75,1,0.701855587331011,-50,0
59,1,1.5,48,80,-32,0,0.778363451388941,-30,0
59,1,1.5,53,23,30,1,0.675523020145192,-27,0
59,1,1.5,80,45,35,1,0.584052887026701,-5,0
59,1,1.5,50,100,-50,0,0.584465545593048,-50,0
59,1,1.5,48,100,-52,0,0.768436401694998,-50,0
59,1,1.5,53,40,13,1,0.577572608002811,-10,0
59,1,1.5,75,0,75,1,0.634712687924548,-50,0
59,1,1.5,53,40,13,1,0.497256331020253,-10,0
59,1,1.5,100,15,85,1,0.501829988612371,-35,0
59,1,1.5,53,23,30,1,0.505683984156349,-27,0
59,1,1.5,53,0,53,1,0.605571808644527,-50,0
59,1,1.5,28,85,-57,0,0.605459814256392,-35,0
59,1,1.5,48,60,-12,0,0.645266423194698,-10,0
59,1,1.5,48,60,-12,0,0.68311841310242,-10,0
59,1,10,7,78,-71,0,2.26676765513184,-28,0
59,1,10,49,98,-49,0,2.34275750741472,-48,0
59,1,10,33,99,-66,0,3.79653823870467,-49,0
59,1,10,51,4,47,1,4.86734857696501,-46,0
59,1,10,33,72,-39,0,3.98260348041731,-22,0
59,1,10,56,30,26,1,4.83060988975558,-20,0
59,1,10,51,1,50,0,3.76458783984162,49,0
59,1,10,96,26,70,1,4.6927967205429,-24,0
59,1,10,7,52,-45,0,3.49535182268846,-2,0
59,1,10,49,96,-47,0,4.79424220282272,-46,0
59,1,10,24,53,-29,0,5.03217805267923,-3,0
59,1,10,47,65,-18,0,4.23664448545605,-15,0
59,1,10,24,68,-44,0,4.90477855028439,-18,0
59,1,10,72,13,59,1,6.51453848382334,-37,0
59,1,10,96,22,74,1,5.62794744204621,-28,0
59,1,10,94,41,53,1,4.48817572947519,-9,0
59,1,10,51,2,49,1,5.81020155399165,-48,0
59,1,10,49,96,-47,0,4.62299372802954,-46,0
59,1,10,51,0,51,0,5.05964595919431,50,0
59,1,10,51,3,48,0,2.71143639022375,47,0
59,1,1.5,49,96,-47,0,0.747050303611104,-46,0
59,1,1.5,26,60,-34,0,0.77218776087102,-10,0
59,1,1.5,49,97,-48,0,0.587939182838454,-47,0
59,1,1.5,95,25,70,1,0.707204149484824,-25,0
59,1,1.5,75,14,61,1,0.725056537863566,-36,0
59,1,1.5,49,99,-50,0,0.766807804064229,-49,0
59,1,1.5,78,13,65,1,0.422623391870729,-37,0
59,1,1.5,70,3,67,1,0.980482530099835,-47,0
59,1,1.5,51,1,50,1,0.508316606943481,-49,0
59,1,1.5,42,59,-17,1,0.390857436595979,9,0
59,1,1.5,49,60,-11,1,0.412041884408609,10,0
59,1,1.5,67,7,60,1,0.346592485044312,-43,0
59,1,1.5,49,96,-47,0,0.651864130299145,-46,0
59,1,1.5,49,100,-51,1,1.2723767325333,50,0
59,1,1.5,23,99,-76,0,0.787324209883081,-49,0
59,1,1.5,28,95,-67,0,0.617781309994825,-45,0
59,1,1.5,75,15,60,1,0.567619597344674,-35,0
59,1,1.5,51,1,50,1,0.67151778689913,-49,0
59,1,1.5,49,82,-33,0,0.539306148297328,-32,0
59,1,1.5,49,97,-48,0,0.596578448010405,-47,0
59,1,10,0,83,-83,0,1.04159675048868,-33,0
59,1,10,60,6,54,1,5.58658860901051,-44,0
59,1,10,97,22,75,1,4.21538185288045,-28,0
59,1,10,51,3,48,0,4.17942440953993,47,0
59,1,10,43,92,-49,0,6.29735208471175,-42,0
59,1,10,67,25,42,1,4.1149582061862,-25,0
59,1,10,51,2,49,0,4.56364787185157,48,0
59,1,10,49,99,-50,0,4.2589220105674,-49,0
59,1,10,88,38,50,0,4.35766151524331,12,0
59,1,10,51,1,50,1,3.82836336082619,-49,0
59,1,10,69,36,33,1,3.35047093219146,-14,0
59,1,10,1,64,-63,0,3.65347461562851,-14,0
59,1,10,49,97,-48,0,3.60836472528536,-47,0
59,1,10,93,26,67,1,3.14862414172057,-24,0
59,1,10,45,79,-34,0,4.11565251101456,-29,0
59,1,10,84,44,40,0,4.88302809310153,6,0
59,1,10,9,75,-66,0,3.6035719088668,-25,0
59,1,10,49,99,-50,1,3.95984084754127,49,0
59,1,10,51,0,51,0,3.94200234525852,50,0
59,1,10,51,4,47,0,3.74071552672467,46,0
59,1,1.5,49,80,-31,0,0.843920920809978,-30,0
59,1,1.5,59,6,53,1,0.543625328074995,-44,0
59,1,1.5,51,3,48,1,0.502833711896528,-47,0
59,1,1.5,49,96,-47,0,0.55133905472394,-46,0
59,1,1.5,68,2,66,1,0.469814989213774,-48,0
59,1,1.5,49,98,-49,0,0.615667906471572,-48,0
59,1,1.5,28,93,-65,0,0.499558102465016,-43,0
59,1,1.5,70,25,45,1,0.588718313603749,-25,0
59,1,1.5,49,97,-48,0,0.562555096425058,-47,0
59,1,1.5,53,23,30,1,0.400373035210578,-27,0
59,1,1.5,35,88,-53,0,0.530968151048,-38,0
59,1,1.5,49,97,-48,0,0.466133362389883,-47,0
59,1,1.5,44,55,-11,0,0.451309048681651,-5,0
59,1,1.5,51,2,49,1,0.525229570701413,-48,0
59,1,1.5,53,0,53,1,0.468453246134231,-50,0
59,1,1.5,49,100,-51,0,0.533589906455745,-50,0
59,1,1.5,16,62,-46,0,0.604136710751845,-12,0
59,1,1.5,3,96,-93,0,0.623932247035555,-46,0
59,1,1.5,42,88,-46,1,0.627088013417961,38,0
59,1,1.5,51,1,50,1,0.574314507124654,-49,0
59,1,10,97,47,50,1,2.96113497136685,-3,0
59,1,10,29,77,-48,0,4.03815330040925,-27,0
59,1,10,37,81,-44,0,4.70351708897215,-31,0
59,1,10,49,98,-49,0,4.60612483753539,-48,0
59,1,10,44,95,-51,0,3.57671831119114,-45,0
59,1,10,51,3,48,0,5.12563359573687,47,0
59,1,10,51,4,47,0,5.61076128443165,46,0
59,1,10,20,57,-37,0,4.34096529534145,-7,0
59,1,10,86,36,50,1,3.97025572184248,-14,0
59,1,10,51,0,51,0,4.6777453993418,50,0
59,1,10,49,97,-48,0,4.19490499224958,-47,0
59,1,10,56,33,23,0,5.29295653140252,17,0
59,1,10,49,98,-49,0,3.67470947601032,-48,0
59,1,10,61,39,22,1,5.44215448857722,-11,0
59,1,10,51,2,49,0,3.69844443751936,48,0
59,1,10,62,22,40,1,3.5853285966823,-28,0
59,1,10,39,61,-22,0,3.84423426359717,-11,0
59,1,10,77,44,33,1,5.02105438370745,-6,0
59,1,10,51,0,51,0,4.3022013511345,50,0
59,1,10,49,94,-45,1,7.29216834448744,44,0
59,1,1.5,19,62,-43,0,0.457411988125386,-12,0
59,1,1.5,95,29,66,1,0.49863407329758,-21,0
59,1,1.5,50,74,-24,0,0.753852377829389,-24,0
59,1,1.5,51,2,49,1,0.662886068519583,-48,0
59,1,1.5,51,4,47,1,0.359348977850459,-46,0
59,1,1.5,51,0,51,1,0.363924144799967,-50,0
59,1,1.5,44,50,-6,0,0.608510227430088,0,0
59,1,1.5,49,98,-49,0,0.57901072461209,-48,0
59,1,1.5,34,54,-20,0,0.438802807484535,-4,0
59,1,1.5,29,98,-69,0,0.360681439377004,-48,0
59,1,1.5,82,24,58,0,0.251236357982634,26,0
59,1,1.5,33,97,-64,0,0.90785371693346,-47,0
59,1,1.5,49,100,-51,0,0.514252309487347,-50,0
59,1,1.5,86,42,44,1,0.432058994494582,-8,0
59,1,1.5,51,0,51,1,0.560634287023277,-50,0
59,1,1.5,9,100,-91,0,0.541068475076827,-50,0
59,1,1.5,51,1,50,1,0.722336674163671,-49,0
59,1,1.5,51,3,48,1,0.712019606280592,-47,0
59,1,1.5,12,89,-77,0,0.46248735642439,-39,0
59,1,1.5,1,83,-82,0,0.391063011198639,-33,0
60,1,10,53,0,53,0,3.44555356451383,50,0
60,1,10,50,43,7,1,2.09120573711334,-7,0
60,1,10,0,68,-68,0,4.03642025617955,-18,0
60,1,10,48,80,-32,1,4.74659628962036,30,0
60,1,10,48,60,-12,0,3.86846459750086,-10,0
60,1,10,53,40,13,1,3.21732349241938,-10,0
60,1,10,25,55,-30,1,4.89640221632726,5,0
60,1,10,5,83,-78,0,4.14022878984906,-33,0
60,1,10,25,55,-30,1,4.98237224771219,5,0
60,1,10,100,0,100,0,4.07819235152056,50,0
60,1,10,50,100,-50,0,4.52293927137362,-50,0
60,1,10,53,23,30,1,4.33356008253031,-27,0
60,1,10,85,15,70,0,4.52690405381873,35,0
60,1,10,28,85,-57,0,4.64957322722694,-35,0
60,1,10,50,100,-50,0,4.84681043737874,-50,0
60,1,10,48,100,-52,0,4.7967555872965,-50,0
60,1,10,85,15,70,0,4.50862602639609,35,0
60,1,10,100,15,85,0,4.15196435268081,35,0
60,1,10,100,0,100,0,3.00938432801559,50,0
60,1,10,3,100,-97,0,4.54511536760765,-50,0
60,1,1.5,98,38,60,1,1.35214662279395,-12,0
60,1,1.5,28,85,-57,NaN,NaN,0,0
60,1,1.5,48,100,-52,0,0.782402495256974,-50,0
60,1,1.5,30,100,-70,0,0.702836067492171,-50,0
60,1,1.5,80,45,35,1,0.874694926787924,-5,0
60,1,1.5,5,83,-78,0,0.703109261343343,-33,0
60,1,1.5,98,38,60,1,0.890968828232872,-12,0
60,1,1.5,48,60,-12,0,1.27875045185647,-10,0
60,1,1.5,53,40,13,1,1.12301546378512,-10,0
60,1,1.5,53,0,53,0,0.557426599709288,50,0
60,1,1.5,75,0,75,0,0.575274761882611,50,0
60,1,1.5,100,15,85,0,0.672454495666898,35,0
60,1,1.5,80,45,35,1,0.860929277008836,-5,0
60,1,1.5,30,100,-70,0,0.922030516918312,-50,0
60,1,1.5,48,80,-32,1,1.05253537312456,30,0
60,1,1.5,53,23,30,1,1.03352379755233,-27,0
60,1,1.5,3,100,-97,0,0.77526775845763,-50,0
60,1,1.5,0,68,-68,0,0.615701113347313,-18,0
60,1,1.5,50,43,7,1,0.973665967034322,-7,0
60,1,1.5,75,0,75,0,0.517972878747969,50,0
60,1,10,91,18,73,0,1.71249233830167,32,0
60,1,10,93,38,55,1,3.30382844040287,-12,0
60,1,10,94,43,51,1,3.93018467432194,-7,0
60,1,10,47,83,-36,1,3.6916800982508,33,0
60,1,10,100,10,90,0,3.23858340815059,40,0
60,1,10,27,60,-33,1,4.37894799667265,10,0
60,1,10,8,56,-48,0,2.89834898669142,-6,0
60,1,10,47,88,-41,1,3.22004577109328,38,0
60,1,10,2,75,-73,0,2.31240884060026,-25,0
60,1,10,88,21,67,0,4.55828663208013,29,0
60,1,10,100,16,84,0,4.10621358879507,34,0
60,1,10,22,54,-32,1,3.81892715545473,4,0
60,1,10,49,71,-22,1,3.58315542355922,21,0
60,1,10,35,96,-61,0,3.73329703155832,-46,0
60,1,10,100,37,63,0,3.48551352425784,13,0
60,1,10,57,25,32,1,3.77584282397947,-25,0
60,1,10,26,55,-29,0,4.86271484790268,-5,0
60,1,10,49,54,-5,1,3.40190352554418,4,0
60,1,10,89,19,70,0,4.00751091246275,31,0
60,1,10,39,71,-32,1,4.46102931727728,21,0
60,1,1.5,83,25,58,0,1.16620273348963,25,0
60,1,1.5,59,40,19,1,1.05317685041155,-10,0
60,1,1.5,64,1,63,0,0.848986932080152,49,0
60,1,1.5,17,81,-64,0,0.98936087862603,-31,0
60,1,1.5,90,29,61,0,0.987776957997994,21,0
60,1,1.5,96,8,88,0,0.690165909978532,42,0
60,1,1.5,80,31,49,1,0.91656694165431,-19,0
60,1,1.5,37,92,-55,0,1.08565371345685,-42,0
60,1,1.5,72,42,30,1,1.36802477048332,-8,0
60,1,1.5,94,24,70,0,1.00698927822668,26,0
60,1,1.5,75,36,39,1,1.2747165408,-14,0
60,1,1.5,15,76,-61,0,0.87767077765966,-26,0
60,1,1.5,47,88,-41,0,1.22543538779792,-38,0
60,1,1.5,99,21,78,0,0.886423244708567,29,0
60,1,1.5,96,31,65,0,0.920846274373616,19,0
60,1,1.5,42,57,-15,1,1.04188715202326,7,0
60,1,1.5,69,46,23,1,1.17362575772495,-4,0
60,1,1.5,84,22,62,0,1.39656945322713,28,0
60,1,1.5,85,22,63,0,1.09885124076754,28,0
60,1,1.5,95,11,84,0,1.46717965057178,39,0
60,1,10,64,42,22,1,2.61575877083669,-8,0
60,1,10,90,25,65,0,2.41023125916035,25,0
60,1,10,77,35,42,1,2.87883690790113,-15,0
60,1,10,80,23,57,0,3.4333549305411,27,0
60,1,10,58,2,56,0,3.23625809072109,48,0
60,1,10,24,64,-40,1,3.95934638274775,14,0
60,1,10,3,97,-94,0,3.09349815053793,-47,0
60,1,10,84,20,64,0,3.00652590522077,30,0
60,1,10,78,25,53,0,4.50691682902834,25,0
60,1,10,25,84,-59,0,3.08214777594185,-34,0
60,1,10,32,69,-37,1,3.10457623688853,19,0
60,1,10,68,15,53,0,2.4882629713793,35,0
60,1,10,13,82,-69,0,3.11360702960883,-32,0
60,1,10,70,38,32,1,3.94590373564643,-12,0
60,1,10,49,93,-44,0,3.2647562852253,-43,0
60,1,10,92,10,82,0,2.26708130078623,40,0
60,1,10,67,49,18,1,3.6450617552,-1,0
60,1,10,100,10,90,0,2.38397234865988,40,0
60,1,10,87,17,70,0,1.69260231618318,33,0
60,1,10,49,56,-7,1,2.66659003483801,6,0
60,1,1.5,50,29,21,1,1.23279169839225,-21,0
60,1,1.5,49,91,-42,1,1.16437882489481,41,0
60,1,1.5,28,83,-55,0,1.01807943944368,-33,0
60,1,1.5,28,86,-58,0,0.837745231285226,-36,0
60,1,1.5,11,64,-53,0,0.848198141418834,-14,0
60,1,1.5,100,24,76,0,0.811284972391149,26,0
60,1,1.5,48,58,-10,1,1.15973905740975,8,0
60,1,1.5,62,47,15,1,1.11804182623382,-3,0
60,1,1.5,46,55,-9,1,1.22168402862007,5,0
60,1,1.5,37,94,-57,0,1.42538370736656,-44,0
60,1,1.5,93,28,65,0,0.826223695461522,22,0
60,1,1.5,95,33,62,0,0.909331983468292,17,0
60,1,1.5,14,64,-50,0,0.94965630230945,-14,0
60,1,1.5,52,15,37,0,1.15556326667138,35,0
60,1,1.5,17,97,-80,0,1.1697784033604,-47,0
60,1,1.5,96,23,73,NaN,NaN,0,0
60,1,1.5,72,22,50,0,0.943936739877245,28,0
60,1,1.5,51,12,39,0,0.734384071423847,38,0
60,1,1.5,19,80,-61,0,0.76483839431603,-30,0
60,1,1.5,45,57,-12,1,1.11257704348827,7,0
60,1,10,68,6,62,0,1.16534209737438,44,0
60,1,10,95,21,74,1,4.06134670514803,-29,0
60,1,10,41,67,-26,0,4.06214213698331,-17,0
60,1,10,79,34,45,1,3.23090892482287,-16,0
60,1,10,69,42,27,1,3.38525379387647,-8,0
60,1,10,84,45,39,1,2.84495090792188,-5,0
60,1,10,11,57,-46,0,2.97471406545083,-7,0
60,1,10,91,29,62,0,2.89910940141635,21,0
60,1,10,13,58,-45,0,3.33821192488176,-8,0
60,1,10,43,62,-19,1,2.77521432717549,12,0
60,1,10,94,28,66,0,2.9129716501302,22,0
60,1,10,68,46,22,1,2.92016344066724,-4,0
60,1,10,85,17,68,0,3.11793103933451,33,0
60,1,10,100,18,82,0,3.48423117342463,32,0
60,1,10,74,34,40,0,4.16317103636538,16,0
60,1,10,0,81,-81,0,0.799194106602954,-31,0
60,1,10,94,42,52,1,3.07886250661977,-8,0
60,1,10,88,23,65,0,3.4465654383348,27,0
60,1,10,12,58,-46,0,3.1274454304621,-8,0
60,1,10,2,93,-91,0,2.32517469142476,-43,0
60,1,1.5,35,91,-56,0,0.9757534095952,-41,0
60,1,1.5,24,64,-40,0,0.948228449335147,-14,0
60,1,1.5,59,26,33,1,0.585243167992303,-24,0
60,1,1.5,90,33,57,1,0.949056483314052,-17,0
60,1,1.5,76,40,36,1,0.986103079620079,-10,0
60,1,1.5,50,9,41,0,0.55785103126982,41,0
60,1,1.5,82,20,62,0,0.730313633896003,30,0
60,1,1.5,14,100,-86,0,0.856085142404481,-50,0
60,1,1.5,8,56,-48,0,0.760544571756327,-6,0
60,1,1.5,99,26,73,0,0.644308585397084,24,0
60,1,1.5,74,4,70,0,0.50738352262124,46,0
60,1,1.5,97,25,72,0,0.753899772673321,25,0
60,1,1.5,50,80,-30,1,1.07033553770452,30,0
60,1,1.5,6,70,-64,0,0.942089285290422,-20,0
60,1,1.5,6,100,-94,0,0.547100475672778,-50,0
60,1,1.5,69,44,25,1,0.864278241253487,-6,0
60,1,1.5,76,7,69,0,0.528690530329186,43,0
60,1,1.5,92,43,49,1,0.750477755482279,-7,0
60,1,1.5,99,25,74,0,1.1869174689964,25,0
60,1,1.5,99,30,69,0,0.853903214010643,20,0
