subj,exp,tp,self,other,fair,resp,rt,given,gen
1,1,1.5,50,43,7,1,1.06237186618637,-7,0
1,1,1.5,98,38,60,1,0.646609642957628,-12,0
1,1,1.5,30,100,-70,0,0.74286546888834,-50,0
1,1,1.5,53,40,13,1,0.700342178910432,-10,0
1,1,1.5,80,45,35,1,0.659433562856066,-5,0
1,1,10,53,23,30,1,2.20328982938554,-27,0
1,1,10,28,85,-57,0,1.30262984745787,-35,0
1,1,10,48,80,-32,1,1.05422518561318,30,0
1,1,10,3,100,-97,0,0.919407794053768,-50,0
1,1,10,25,55,-30,0,1.03777787145191,-5,0
1,1,1.5,53,0,53,0,0.614316164517732,50,0
1,1,1.5,5,83,-78,0,0.657097142520797,-33,0
1,1,1.5,48,60,-12,1,0.65763781086207,10,0
1,1,1.5,100,0,100,1,0.826258153554591,-50,0
1,1,1.5,85,15,70,0,0.612904561956384,35,0
1,1,10,100,15,85,1,1.19841135146999,-35,0
1,1,10,50,100,-50,1,1.32087657916418,50,0
1,1,10,75,0,75,0,1.01468895075595,50,0
1,1,10,0,68,-68,0,0.96879225689554,-18,0
1,1,10,48,100,-52,1,1.91681368569152,50,0
1,1,10,82,3,79,0,1.22533516855037,47,0
1,1,10,35,94,-59,0,1.60385579000831,-44,0
1,1,10,45,83,-38,1,0.959258166383734,33,0
1,1,10,20,83,-63,0,0.891844705391122,-33,0
1,1,10,98,28,70,1,0.77089481526491,-22,0
1,1,1.5,12,82,-70,0,0.558242076458555,-32,0
1,1,1.5,55,15,40,0,0.827221093029948,35,0
1,1,1.5,63,17,46,0,0.988296638142856,33,0
1,1,1.5,46,88,-42,1,0.663600191341175,38,0
1,1,1.5,48,54,-6,1,0.639536234859406,4,0
1,1,1.5,48,87,-39,0,0.70287507262401,-37,0
1,1,1.5,38,74,-36,0,0.741419410176604,-24,0
1,1,1.5,4,71,-67,0,0.634768089938007,-21,0
1,1,1.5,12,52,-40,0,0.571952325881284,-2,0
1,1,1.5,42,74,-32,1,0.7198788169826,24,0
1,1,10,32,88,-56,0,1.94924718806578,-38,0
1,1,10,100,48,52,1,1.01779806862396,-2,0
1,1,10,16,97,-81,0,1.27572948988382,-47,0
1,1,10,57,43,14,1,0.778972583533687,-7,0
1,1,10,42,79,-37,0,2.96629858454799,-29,0
1,1,10,49,92,-43,1,1.40848207821909,42,0
1,1,10,37,93,-56,0,1.43500488434256,-43,0
1,1,10,63,17,46,1,1.2683782332424,-33,0
1,1,10,9,71,-62,0,1.32435958293354,-21,0
1,1,10,43,76,-33,0,1.43427214128496,-26,0
1,1,1.5,1,95,-94,0,0.634889786133499,-45,0
1,1,1.5,33,90,-57,0,0.716060415563334,-40,0
1,1,1.5,35,61,-26,0,1.2582576550376,-11,0
1,1,1.5,12,79,-67,0,0.746801534398401,-29,0
1,1,1.5,47,75,-28,1,0.79943293971337,25,0
1,1,10,57,49,8,1,0.928125567013922,-1,0
1,1,10,16,99,-83,0,0.893516195306802,-49,0
1,1,10,50,100,-50,1,1.37993552300941,50,0
1,1,10,22,81,-59,0,0.751234281671714,-31,0
1,1,10,49,79,-30,1,1.66772026736544,29,0
1,1,1.5,53,22,31,0,0.978320115978931,28,0
1,1,1.5,42,74,-32,0,0.869720556942411,-24,0
1,1,1.5,82,23,59,1,0.717753165657996,-27,0
1,1,1.5,64,10,54,0,0.643567971173979,40,0
1,1,1.5,29,63,-34,0,0.796806207972622,-13,0
1,1,1.5,4,64,-60,0,0.637353034431726,-14,0
1,1,1.5,91,4,87,1,0.998685534465039,-46,0
1,1,1.5,31,61,-30,0,0.801362484215133,-11,0
1,1,1.5,48,55,-7,1,0.827975829377465,5,0
1,1,1.5,47,65,-18,1,0.917243654477716,15,0
1,1,10,17,54,-37,0,1.17846270579685,-4,0
1,1,10,50,100,-50,1,1.15764972389297,50,0
1,1,10,74,38,36,1,1.11454141244576,-12,0
1,1,10,49,67,-18,1,0.96038129030967,17,0
1,1,10,26,59,-33,0,0.756679819874989,-9,0
1,1,1.5,3,86,-83,0,0.560201678454177,-36,0
1,1,1.5,67,32,35,1,0.716183944532531,-18,0
1,1,1.5,46,55,-9,1,1.25009924471306,5,0
1,1,1.5,19,58,-39,0,0.61072246119511,-8,0
1,1,1.5,48,90,-42,0,0.708745447847832,-40,0
1,1,10,67,23,44,1,0.82666722871727,-27,0
1,1,10,64,10,54,1,0.804560308344662,-40,0
1,1,10,95,20,75,1,0.815182700078367,-30,0
1,1,10,59,46,13,1,0.833165145770181,-4,0
1,1,10,50,33,17,1,0.938382870161149,-17,0
1,1,1.5,97,2,95,0,0.620339026540023,48,0
1,1,1.5,30,100,-70,0,0.894294757716125,-50,0
1,1,1.5,47,74,-27,1,0.82160913894586,24,0
1,1,1.5,2,58,-56,0,0.703463026533427,-8,0
1,1,1.5,49,89,-40,1,1.02217986477808,39,0
1,1,10,46,63,-17,1,0.927466501472736,13,0
1,1,10,50,61,-11,1,0.797361538503537,11,0
1,1,10,49,54,-5,1,0.815896015732505,4,0
1,1,10,49,56,-7,1,0.713969586948224,6,0
1,1,10,28,85,-57,0,0.799755141388232,-35,0
1,1,10,9,89,-80,0,0.849253602775207,-39,0
1,1,10,93,31,62,1,1.18579050293192,-19,0
1,1,10,84,49,35,1,0.941155857270132,-1,0
1,1,10,50,61,-11,1,0.802312594272735,11,0
1,1,10,68,1,67,0,0.828886718069043,49,0
1,1,1.5,50,100,-50,1,0.805420245922505,50,0
1,1,1.5,88,21,67,1,0.800314870579314,-29,0
1,1,1.5,48,66,-18,1,0.866655059098775,16,0
1,1,1.5,60,48,12,1,0.722710819414715,-2,0
1,1,1.5,4,78,-74,0,0.504718476744529,-28,0
1,1,1.5,35,65,-30,0,0.974117565123379,-15,0
1,1,1.5,4,84,-80,0,0.569860397601587,-34,0
1,1,1.5,97,34,63,1,0.789800612514227,-16,0
1,1,1.5,75,0,75,0,0.600969170909593,50,0
1,1,1.5,49,69,-20,1,0.755832345163071,19,0
1,1,10,91,25,66,1,0.791546879610905,-25,0
1,1,10,93,11,82,1,0.770833967168073,-39,0
1,1,10,59,25,34,0,1.87091442594829,25,0
1,1,10,47,80,-33,1,1.23877893262943,30,0
1,1,10,47,54,-7,1,0.872175007925762,4,0
1,1,10,45,76,-31,1,1.08624704694375,26,0
1,1,10,47,78,-31,1,1.0053927543122,28,0
1,1,10,48,74,-26,1,1.0159297387745,24,0
1,1,10,57,42,15,1,0.777912507033761,-8,0
1,1,10,88,37,51,1,0.781874231381153,-13,0
1,1,1.5,42,74,-32,0,0.743666024585764,-24,0
1,1,1.5,45,60,-15,1,0.917219461860441,10,0
1,1,1.5,5,51,-46,0,0.458487484902435,-1,0
1,1,1.5,32,57,-25,0,0.754869772241364,-7,0
1,1,1.5,61,45,16,1,0.559669807431419,-5,0
1,1,10,81,29,52,1,0.670874104920586,-21,0
1,1,10,63,37,26,1,0.830114676669837,-13,0
1,1,10,46,99,-53,0,1.0394563259124,-49,0
1,1,10,82,31,51,1,0.976695545075927,-19,0
1,1,10,47,61,-14,1,1.14798587297628,11,0
1,1,1.5,93,22,71,0,0.679944503601291,28,0
1,1,1.5,49,86,-37,1,1.04715177751677,36,0
1,1,1.5,49,94,-45,1,0.879103260322154,44,0
1,1,1.5,14,88,-74,0,0.685796184530773,-38,0
1,1,1.5,82,9,73,1,0.741088777742334,-41,0
1,1,1.5,38,76,-38,0,0.792295384526369,-26,0
1,1,1.5,21,65,-44,0,0.83495539944488,-15,0
1,1,1.5,30,58,-28,0,0.891511507072209,-8,0
1,1,1.5,49,61,-12,1,0.818876839417499,11,0
1,1,1.5,21,96,-75,0,0.604809565615142,-46,0
1,1,10,85,15,70,1,0.869520051463041,-35,0
1,1,10,50,52,-2,1,1.02936727141969,2,0
1,1,10,48,62,-14,1,0.66198295153481,12,0
1,1,10,58,30,28,0,0.869841886584254,20,0
1,1,10,37,59,-22,0,1.18117484480899,-9,0
1,1,10,44,75,-31,0,1.32626310204432,-25,0
1,1,10,65,47,18,1,0.771677776330762,-3,0
1,1,10,79,26,53,1,0.975051180215814,-24,0
1,1,10,29,74,-45,0,0.954285850435554,-24,0
1,1,10,48,80,-32,1,0.902114104846987,30,0
1,1,1.5,98,8,90,0,0.643537547124652,42,0
1,1,1.5,29,76,-47,0,0.73209315623717,-26,0
1,1,1.5,52,17,35,1,0.856726555613932,-33,0
1,1,1.5,49,84,-35,1,0.872705779287571,34,0
1,1,1.5,46,74,-28,1,0.935971672644882,24,0
1,1,1.5,53,0,53,0,0.762579886037202,50,0
1,1,1.5,49,83,-34,1,0.6544814074241,33,0
1,1,1.5,63,4,59,0,0.85447334321907,46,0
1,1,1.5,92,46,46,1,1.1104070407855,-4,0
1,1,1.5,76,30,46,0,0.796437820392384,20,0
1,1,10,44,61,-17,1,2.86144155008697,11,0
1,1,10,17,64,-47,0,0.797537484810164,-14,0
1,1,10,45,69,-24,1,1.1041965027016,19,0
1,1,10,42,99,-57,0,1.90198434444574,-49,0
1,1,10,19,58,-39,0,0.820014625536714,-8,0
1,1,10,55,1,54,0,0.661235546285752,49,0
1,1,10,30,60,-30,0,0.861039806019107,-10,0
1,1,10,54,2,52,0,0.693318255713166,48,0
1,1,10,2,65,-63,0,0.644075649581282,-15,0
1,1,10,49,87,-38,1,0.867675547677209,37,0
1,1,1.5,76,19,57,1,0.770327388425358,-31,0
1,1,1.5,76,14,62,1,0.597660280671334,-36,0
1,1,1.5,45,64,-19,1,0.65564008716683,14,0
1,1,1.5,45,83,-38,1,0.543377912506912,33,0
1,1,1.5,70,9,61,0,1.0915540274309,41,0
1,1,10,89,1,88,0,0.608122121400811,49,0
1,1,10,46,77,-31,1,0.738035009650048,27,0
1,1,10,78,40,38,1,0.92671139857157,-10,0
1,1,10,14,79,-65,0,0.748010432149385,-29,0
1,1,10,15,52,-37,0,0.871857938020185,-2,0
1,1,1.5,91,29,62,1,0.709947381057646,-21,0
1,1,1.5,7,55,-48,0,0.579772039565796,-5,0
1,1,1.5,46,69,-23,1,0.81444592491971,19,0
1,1,1.5,49,77,-28,1,0.847708574267017,27,0
1,1,1.5,15,65,-50,0,0.60753233471587,-15,0
1,1,1.5,75,34,41,1,0.568279446722954,-16,0
1,1,1.5,62,32,30,1,0.555532869884701,-18,0
1,1,1.5,45,100,-55,0,0.831628914576868,-50,0
1,1,1.5,52,17,35,0,0.968139789340057,33,0
1,1,1.5,47,56,-9,1,1.43542752203575,6,0
1,1,10,48,77,-29,1,1.09930226292454,27,0
1,1,10,44,63,-19,1,0.737296035158579,13,0
1,1,10,79,7,72,0,0.861901209813368,43,0
1,1,10,76,10,66,0,0.893162836473493,40,0
1,1,10,92,34,58,1,1.62775919548585,-16,0
1,1,1.5,42,86,-44,0,0.882887205587394,-36,0
1,1,1.5,48,56,-8,1,0.801705946068978,6,0
1,1,1.5,26,94,-68,0,0.787596885016683,-44,0
1,1,1.5,48,96,-48,0,0.846305035913247,-46,0
1,1,1.5,99,25,74,1,0.726388463786861,-25,0
1,1,10,30,75,-45,0,0.698124155776895,-25,0
1,1,10,48,59,-11,1,1.32013137324248,9,0
1,1,10,16,69,-53,0,0.717991792836983,-19,0
1,1,10,74,30,44,1,0.787282747547579,-20,0
1,1,10,46,70,-24,0,1.78974086407834,-20,0
2,1,1.5,53,0,53,0,0.955617072251698,50,0
2,1,1.5,53,23,30,NaN,NaN,0,0
2,1,1.5,50,100,-50,0,0.817683964816752,-50,0
2,1,1.5,5,83,-78,0,0.459638954340335,-33,0
2,1,1.5,100,0,100,0,0.749173776684074,50,0
2,1,10,0,68,-68,0,1.09756143157301,-18,0
2,1,10,30,100,-70,0,0.832780684995669,-50,0
2,1,10,48,100,-52,0,0.539028604775012,-50,0
2,1,10,28,85,-57,0,0.728954398630776,-35,0
2,1,10,48,80,-32,0,0.73500591625816,-30,0
2,1,10,80,45,35,0,1.13193217491062,5,0
2,1,10,48,60,-12,0,0.801084720513245,-10,0
2,1,10,53,40,13,1,1.29174663755657,-10,0
2,1,10,75,0,75,0,1.03529153879845,50,0
2,1,10,50,43,7,1,0.981416206879658,-7,0
2,1,1.5,100,15,85,0,0.632343087215304,35,0
2,1,1.5,3,100,-97,0,0.601627300705331,-50,0
2,1,1.5,25,55,-30,0,0.900439357261348,-5,0
2,1,1.5,85,15,70,0,0.731162181698892,35,0
2,1,1.5,98,38,60,0,0.816692423524728,12,0
2,1,10,99,37,62,0,1.24058970497845,13,0
2,1,10,23,73,-50,0,1.01009356044415,-23,0
2,1,10,82,41,41,0,0.701533241743164,9,0
2,1,10,81,36,45,0,0.764338310223138,14,0
2,1,10,70,11,59,0,0.720342835023985,39,0
2,1,1.5,82,48,34,0,0.749142619193663,2,0
2,1,1.5,11,94,-83,0,0.897893973628015,-44,0
2,1,1.5,79,45,34,0,0.664544902707348,5,0
2,1,1.5,36,82,-46,0,0.776699036244281,-32,0
2,1,1.5,65,35,30,0,0.900717575316776,15,0
2,1,1.5,4,56,-52,0,0.673760555057015,-6,0
2,1,1.5,24,59,-35,0,0.745687436859953,-9,0
2,1,1.5,81,22,59,0,0.934425213959912,28,0
2,1,1.5,85,25,60,0,0.683762109267263,25,0
2,1,1.5,35,97,-62,0,0.675128918695918,-47,0
2,1,10,82,25,57,0,0.978673981223437,25,0
2,1,10,84,10,74,0,0.670064543656736,40,0
2,1,10,76,33,43,0,0.822139119291023,17,0
2,1,10,77,36,41,0,0.52825287858559,14,0
2,1,10,91,2,89,0,0.685588671283767,48,0
2,1,10,69,48,21,1,1.28253831638176,-2,0
2,1,10,24,52,-28,0,1.18592297282157,-2,0
2,1,10,85,33,52,0,0.941258601298614,17,0
2,1,10,69,13,56,0,0.914615648538529,37,0
2,1,10,26,80,-54,0,0.672749586155987,-30,0
2,1,1.5,97,13,84,0,0.736165341433662,37,0
2,1,1.5,20,84,-64,0,0.661550484664986,-34,0
2,1,1.5,74,43,31,0,0.830319243306803,7,0
2,1,1.5,95,6,89,0,0.967714242564398,44,0
2,1,1.5,81,8,73,0,0.835932723282895,42,0
2,1,10,100,30,70,0,0.978693775392458,20,0
2,1,10,76,17,59,0,0.806147995877836,33,0
2,1,10,21,79,-58,0,0.920792529239407,-29,0
2,1,10,48,61,-13,0,0.646975010959068,-11,0
2,1,10,18,69,-51,0,0.615584023318661,-19,0
2,1,1.5,96,24,72,0,0.881183295481605,26,0
2,1,1.5,83,40,43,0,0.64860289815806,10,0
2,1,1.5,66,35,31,0,0.713305274486629,15,0
2,1,1.5,35,77,-42,0,0.735234648887854,-27,0
2,1,1.5,58,50,8,0,0.572876268843174,0,0
2,1,1.5,0,81,-81,0,0.998789256604141,-31,0
2,1,1.5,1,93,-92,0,1.02566790661149,-43,0
2,1,1.5,87,36,51,0,0.64378008530548,14,0
2,1,1.5,76,26,50,0,0.861152695160854,24,0
2,1,1.5,95,10,85,0,0.829908330999388,40,0
2,1,10,80,46,34,0,0.982593593433194,4,0
2,1,10,12,78,-66,0,0.738149157134103,-28,0
2,1,10,22,75,-53,0,0.487558264505424,-25,0
2,1,10,27,85,-58,0,0.550891910635983,-35,0
2,1,10,93,21,72,0,0.835661103281382,29,0
2,1,10,92,23,69,0,0.827052105587427,27,0
2,1,10,34,71,-37,0,0.957202805200723,-21,0
2,1,10,5,85,-80,0,0.585806260529353,-35,0
2,1,10,43,61,-18,0,0.525305013497928,-11,0
2,1,10,86,15,71,0,0.859803026014561,35,0
2,1,1.5,17,61,-44,0,0.987170078838972,-11,0
2,1,1.5,49,80,-31,0,0.646328767967134,-30,0
2,1,1.5,90,36,54,0,0.775070415926166,14,0
2,1,1.5,17,97,-80,0,0.698969896733615,-47,0
2,1,1.5,97,39,58,0,0.633902794495953,11,0
2,1,10,36,80,-44,0,0.855350804009504,-30,0
2,1,10,68,20,48,0,0.871965810336405,30,0
2,1,10,50,94,-44,0,0.888190798203141,-44,0
2,1,10,89,43,46,0,0.823589592078861,7,0
2,1,10,6,58,-52,0,0.625512998905833,-8,0
2,1,1.5,94,21,73,0,0.883142918306476,29,0
2,1,1.5,55,49,6,1,1.26657945013176,-1,0
2,1,1.5,63,18,45,0,0.898611329010237,32,0
2,1,1.5,87,31,56,0,0.633321065835844,19,0
2,1,1.5,84,26,58,0,0.610818393623049,24,0
2,1,10,50,20,30,0,0.986928883214205,30,0
2,1,10,69,28,41,0,1.34232404082468,22,0
2,1,10,11,88,-77,0,0.803783692243087,-38,0
2,1,10,41,78,-37,0,0.718483649283371,-28,0
2,1,10,84,18,66,0,0.964571001686636,32,0
2,1,1.5,74,47,27,0,0.784021779450995,3,0
2,1,1.5,37,78,-41,0,0.691449211826693,-28,0
2,1,1.5,68,45,23,0,0.610857615403802,5,0
2,1,1.5,90,20,70,0,0.661440517053052,30,0
2,1,1.5,77,29,48,0,0.725473557187797,21,0
2,1,1.5,96,33,63,0,0.913831946030768,17,0
2,1,1.5,95,29,66,0,0.871884067744759,21,0
2,1,1.5,79,29,50,0,0.73576066062742,21,0
2,1,1.5,92,27,65,0,0.669332159368423,23,0
2,1,1.5,83,9,74,0,0.965355803869897,41,0
2,1,10,96,19,77,0,0.688776265764318,31,0
2,1,10,49,58,-9,0,1.16755544933403,-8,0
2,1,10,100,0,100,0,0.811731784597214,50,0
2,1,10,44,70,-26,0,0.861670276048244,-20,0
2,1,10,71,30,41,0,0.845916316115108,20,0
2,1,1.5,61,18,43,0,0.619997756661178,32,0
2,1,1.5,70,10,60,0,0.701396881906476,40,0
2,1,1.5,81,3,78,0,0.739472067492898,47,0
2,1,1.5,28,56,-28,0,0.728937536930971,-6,0
2,1,1.5,98,24,74,0,0.758290091625895,26,0
2,1,10,96,36,60,0,0.898440146094799,14,0
2,1,10,60,46,14,0,0.985189562166852,4,0
2,1,10,80,38,42,0,0.748567122029272,12,0
2,1,10,84,45,39,0,1.0013254762689,5,0
2,1,10,14,82,-68,0,0.61941712767657,-32,0
2,1,10,54,7,47,0,2.11041591216599,43,0
2,1,10,22,75,-53,0,0.884542439434881,-25,0
2,1,10,43,70,-27,0,1.03582928041578,-20,0
2,1,10,98,38,60,0,0.909337569775744,12,0
2,1,10,13,93,-80,0,0.747928210212194,-43,0
2,1,1.5,3,99,-96,0,0.559542696026256,-49,0
2,1,1.5,80,28,52,0,0.804217697746935,22,0
2,1,1.5,97,49,48,0,0.902326034905855,1,0
2,1,1.5,90,36,54,0,0.693059870765865,14,0
2,1,1.5,96,44,52,0,0.779885897605709,6,0
2,1,10,97,8,89,0,0.645222860359354,42,0
2,1,10,92,35,57,0,0.79724171907219,15,0
2,1,10,74,9,65,0,0.624121175509572,41,0
2,1,10,70,36,34,0,0.633519374094249,14,0
2,1,10,97,34,63,0,0.658894766862431,16,0
2,1,1.5,31,81,-50,0,0.818459236472336,-31,0
2,1,1.5,30,74,-44,0,0.443667625095259,-24,0
2,1,1.5,48,52,-4,0,0.493257519217877,-2,0
2,1,1.5,44,79,-35,0,0.596596282508472,-29,0
2,1,1.5,46,71,-25,0,0.551450912658765,-21,0
2,1,1.5,16,56,-40,0,0.650155274266581,-6,0
2,1,1.5,71,37,34,0,0.426033952133366,13,0
2,1,1.5,8,90,-82,0,0.635601427526126,-40,0
2,1,1.5,76,35,41,0,0.540386704769844,15,0
2,1,1.5,86,1,85,0,0.632934346403999,49,0
2,1,10,47,67,-20,0,0.977220209408188,-17,0
2,1,10,31,85,-54,0,0.780664834850541,-35,0
2,1,10,83,36,47,0,0.735283401194465,14,0
2,1,10,42,95,-53,0,0.66815330658028,-45,0
2,1,10,75,38,37,0,1.12335543437985,12,0
2,1,1.5,70,23,47,0,0.85500220668473,27,0
2,1,1.5,42,89,-47,0,0.630944665763309,-39,0
2,1,1.5,33,54,-21,0,0.775726556004884,-4,0
2,1,1.5,65,31,34,0,0.995212010222531,19,0
2,1,1.5,98,49,49,0,0.613355712963312,1,0
2,1,10,73,44,29,0,1.04677985510534,6,0
2,1,10,85,38,47,0,0.750833921048979,12,0
2,1,10,99,33,66,0,0.802931443258785,17,0
2,1,10,28,60,-32,0,0.773047011887684,-10,0
2,1,10,32,86,-54,0,0.73627934119213,-36,0
2,1,10,32,50,-18,0,0.70597739945697,0,0
2,1,10,39,89,-50,0,0.840103428203292,-39,0
2,1,10,60,27,33,0,0.544829396249042,23,0
2,1,10,84,22,62,0,0.613791551262693,28,0
2,1,10,1,62,-61,0,0.77501983082584,-12,0
2,1,1.5,73,31,42,0,0.505796026211101,19,0
2,1,1.5,26,91,-65,0,0.855716629595918,-41,0
2,1,1.5,77,13,64,0,0.48798897098095,37,0
2,1,1.5,100,45,55,0,0.790680684849576,5,0
2,1,1.5,96,22,74,0,0.873254264177376,28,0
2,1,1.5,3,93,-90,0,0.774827020946759,-43,0
2,1,1.5,31,57,-26,0,1.05818826161703,-7,0
2,1,1.5,92,33,59,0,0.746334779529207,17,0
2,1,1.5,91,45,46,0,0.526969556565746,5,0
2,1,1.5,91,11,80,0,0.564514331712417,39,0
2,1,10,78,14,64,0,1.23928768846599,36,0
2,1,10,56,14,42,0,0.51196557574076,36,0
2,1,10,81,36,45,0,0.429349842159354,14,0
2,1,10,29,66,-37,0,0.398862788280894,-16,0
2,1,10,71,33,38,0,0.328974705982546,17,0
2,1,1.5,88,36,52,0,0.739575070490901,14,0
2,1,1.5,29,61,-32,0,0.512487921891079,-11,0
2,1,1.5,80,23,57,0,0.71780698191651,27,0
2,1,1.5,88,42,46,0,0.59544052291858,8,0
2,1,1.5,93,18,75,0,0.372725319968595,32,0
2,1,10,91,9,82,0,0.559973035940857,41,0
2,1,10,81,24,57,0,0.468200299404998,26,0
2,1,10,68,47,21,0,0.515658288111808,3,0
2,1,10,20,85,-65,0,0.625024009596018,-35,0
2,1,10,62,26,36,0,0.434307548617653,24,0
2,1,1.5,56,14,42,0,0.504491810344916,36,0
2,1,1.5,32,86,-54,0,0.414542703356346,-36,0
2,1,1.5,98,46,52,0,0.776029700051367,4,0
2,1,1.5,5,86,-81,0,0.475431402937829,-36,0
2,1,1.5,97,47,50,0,0.515529259448158,3,0
2,1,10,73,2,71,0,0.544306683539617,48,0
2,1,10,19,53,-34,0,0.484989421116552,-3,0
2,1,10,16,55,-39,0,0.555785102760638,-5,0
2,1,10,14,75,-61,0,0.631137842201497,-25,0
2,1,10,20,92,-72,0,0.839882393305743,-42,0
3,1,1.5,0,68,-68,0,1.10221819829894,-18,0
3,1,1.5,98,38,60,NaN,NaN,0,0
3,1,1.5,28,85,-57,0,0.901323441241402,-35,0
3,1,1.5,48,60,-12,1,1.1886027532164,10,0
3,1,1.5,50,43,7,1,1.05675530538429,-7,0
3,1,10,100,0,100,0,1.15329962264514,50,0
3,1,10,48,100,-52,0,1.04659187758807,-50,0
3,1,10,75,0,75,0,1.09590284869773,50,0
3,1,10,25,55,-30,1,1.36716340773273,5,0
3,1,10,53,40,13,1,0.978946635324974,-10,0
3,1,10,85,15,70,0,1.41370836639544,35,0
3,1,10,80,45,35,0,1.64764241973171,5,0
3,1,10,30,100,-70,0,2.7530118781724,-50,0
3,1,10,5,83,-78,0,1.24625428178115,-33,0
3,1,10,50,100,-50,1,1.43151956569636,50,0
3,1,1.5,48,80,-32,1,1.04859765811125,30,0
3,1,1.5,53,23,30,0,0.914122388523538,27,0
3,1,1.5,3,100,-97,0,1.11269502935465,-50,0
3,1,1.5,100,15,85,0,0.983364704239648,35,0
3,1,1.5,53,0,53,0,0.7306752098375,50,0
3,1,1.5,79,36,43,0,0.798349776363466,14,0
3,1,1.5,43,74,-31,0,1.07317286840407,-24,0
3,1,1.5,28,79,-51,0,1.16916442307411,-29,0
3,1,1.5,38,72,-34,NaN,NaN,0,0
3,1,1.5,50,74,-24,0,0.909796324616764,-24,0
3,1,10,67,21,46,0,1.10768461006228,29,0
3,1,10,24,89,-65,0,1.07413177232957,-39,0
3,1,10,79,16,63,1,1.2981633839081,-34,0
3,1,10,94,40,54,1,2.28884779417422,-10,0
3,1,10,88,18,70,0,2.25610284024151,32,0
3,1,1.5,47,95,-48,0,1.2393817708944,-45,0
3,1,1.5,11,68,-57,NaN,NaN,0,0
3,1,1.5,5,71,-66,0,1.47326267405879,-21,0
3,1,1.5,26,68,-42,0,1.36905445699813,-18,0
3,1,1.5,99,3,96,0,0.629154562775511,47,0
3,1,10,95,16,79,0,1.15771219320595,34,0
3,1,10,69,25,44,0,0.610328376875259,25,0
3,1,10,4,79,-75,0,0.973063452227507,-29,0
3,1,10,40,72,-32,0,0.769017801678274,-22,0
3,1,10,89,12,77,0,2.07690841477597,38,0
3,1,1.5,3,67,-64,0,1.0604149751598,-17,0
3,1,1.5,9,75,-66,NaN,NaN,0,0
3,1,1.5,90,41,49,0,0.829680566966999,9,0
3,1,1.5,89,18,71,0,1.23878758779028,32,0
3,1,1.5,92,10,82,0,0.992224301386159,40,0
3,1,10,92,11,81,0,1.05884722602786,39,0
3,1,10,88,16,72,1,1.24339259893168,-34,0
3,1,10,90,15,75,1,0.676587680529337,-35,0
3,1,10,87,34,53,1,0.852659070456866,-16,0
3,1,10,9,97,-88,0,1.17329804645851,-47,0
3,1,10,15,83,-68,0,1.17590790707618,-33,0
3,1,10,20,87,-67,0,1.17166615044698,-37,0
3,1,10,71,19,52,0,1.07162014796631,31,0
3,1,10,58,46,12,0,3.61568738851929,4,0
3,1,10,20,100,-80,0,1.30570338864345,-50,0
3,1,1.5,5,63,-58,0,0.887618740380276,-13,0
3,1,1.5,80,45,35,0,0.742918095435016,5,0
3,1,1.5,99,3,96,0,0.708223077119328,47,0
3,1,1.5,8,72,-64,0,0.834883060306311,-22,0
3,1,1.5,89,12,77,0,0.620143579028081,38,0
3,1,10,88,15,73,1,1.53279682120774,-35,0
3,1,10,92,11,81,0,1.35386154905427,39,0
3,1,10,8,52,-44,0,1.11064049723791,-2,0
3,1,10,49,52,-3,1,1.34929062740412,2,0
3,1,10,97,44,53,1,1.25779191858601,-6,0
3,1,1.5,83,48,35,NaN,NaN,0,0
3,1,1.5,53,23,30,0,0.786433123226743,27,0
3,1,1.5,90,5,85,0,0.81376811460359,45,0
3,1,1.5,52,19,33,0,0.759672887681518,31,0
3,1,1.5,64,42,22,1,0.756250378035475,-8,0
3,1,1.5,85,25,60,0,0.727567569585517,25,0
3,1,1.5,25,55,-30,0,0.669582477246877,-5,0
3,1,1.5,89,12,77,0,0.76549192389939,38,0
3,1,1.5,25,94,-69,0,0.785454058903269,-44,0
3,1,1.5,48,54,-6,NaN,NaN,0,0
3,1,10,64,26,38,0,1.21261713677086,24,0
3,1,10,84,20,64,0,1.3506263482268,30,0
3,1,10,21,52,-31,0,1.41124476055847,-2,0
3,1,10,50,75,-25,1,1.3337000089814,25,0
3,1,10,89,11,78,0,1.07514199364232,39,0
3,1,1.5,10,73,-63,0,1.07123233441962,-23,0
3,1,1.5,36,96,-60,1,0.975206690316554,46,0
3,1,1.5,82,43,39,1,1.30704130872618,-7,0
3,1,1.5,49,74,-25,0,1.11355789616937,-24,0
3,1,1.5,27,83,-56,0,0.90371923474595,-33,0
3,1,10,94,5,89,0,1.05369898263598,45,0
3,1,10,48,80,-32,0,2.28621190821286,-30,0
3,1,10,93,40,53,0,2.58945938863326,10,0
3,1,10,100,1,99,0,1.26459991605952,49,0
3,1,10,48,55,-7,0,1.36072672891896,-5,0
3,1,10,64,26,38,0,0.963353084458504,24,0
3,1,10,56,35,21,0,1.27933609834872,15,0
3,1,10,66,28,38,0,1.03046022617491,22,0
3,1,10,100,2,98,0,1.65588730684249,48,0
3,1,10,25,68,-43,0,1.22453342325753,-18,0
3,1,1.5,75,12,63,NaN,NaN,0,0
3,1,1.5,38,74,-36,0,1.21848455804866,-24,0
3,1,1.5,50,64,-14,0,0.66036145837279,-14,0
3,1,1.5,98,4,94,0,0.437042426725384,46,0
3,1,1.5,12,55,-43,0,0.59831018850673,-5,0
3,1,1.5,52,21,31,0,0.334857951384038,29,0
3,1,1.5,32,95,-63,0,0.260204573452938,-45,0
3,1,1.5,96,6,90,0,0.32478322944371,44,0
3,1,1.5,15,54,-39,0,0.610605124733411,-4,0
3,1,1.5,83,36,47,0,0.509364158089738,14,0
3,1,10,88,18,70,0,0.179388332238887,32,0
3,1,10,73,46,27,0,1.01463281421456,4,0
3,1,10,49,52,-3,0,0.664600649208296,-2,0
3,1,10,76,42,34,0,0.992533672542777,8,0
3,1,10,67,38,29,0,0.987756014685147,12,0
3,1,1.5,10,69,-59,0,0.452440604567528,-19,0
3,1,1.5,50,11,39,NaN,NaN,0,0
3,1,1.5,86,5,81,0,0.221079756505787,45,0
3,1,1.5,27,66,-39,NaN,NaN,0,0
3,1,1.5,84,26,58,0,0.262910104589537,24,0
3,1,10,67,21,46,0,0.302240191493183,29,0
3,1,10,100,1,99,0,0.644788434496149,49,0
3,1,10,97,7,90,0,1.0612844399875,43,0
3,1,10,25,73,-48,0,2.25401018653065,-23,0
3,1,10,92,4,88,0,0.909991697582882,46,0
3,1,1.5,60,40,20,NaN,NaN,0,0
3,1,1.5,39,61,-22,0,0.504542513808701,-11,0
3,1,1.5,84,26,58,0,0.471057855000254,24,0
3,1,1.5,94,13,81,0,0.678495224739891,37,0
3,1,1.5,54,24,30,NaN,NaN,0,0
3,1,10,3,96,-93,0,1.28499201830709,-46,0
3,1,10,77,47,30,1,1.17146784497891,-3,0
3,1,10,53,39,14,0,1.90280761627946,11,0
3,1,10,97,12,85,0,1.17285268404521,38,0
3,1,10,7,52,-45,0,1.21598576306133,-2,0
3,1,10,98,7,91,0,0.776053795358166,43,0
3,1,10,97,10,87,0,0.779977017082274,40,0
3,1,10,88,40,48,1,0.390642623184249,-10,0
3,1,10,89,14,75,1,1.25793487444753,-36,0
3,1,10,54,30,24,1,1.20973382721422,-20,0
3,1,1.5,92,8,84,0,0.731091247987933,42,0
3,1,1.5,99,5,94,1,1.17649255983997,-45,0
3,1,1.5,94,11,83,0,1.40425311983563,39,0
3,1,1.5,21,51,-30,0,1.49435196100967,-1,0
3,1,1.5,9,54,-45,NaN,NaN,0,0
3,1,10,69,25,44,1,1.30025897000451,-25,0
3,1,10,93,25,68,1,0.962851272721309,-25,0
3,1,10,73,46,27,1,1.75020517827943,-4,0
3,1,10,3,70,-67,0,1.05804520699894,-20,0
3,1,10,22,67,-45,0,1.47463358397363,-17,0
3,1,1.5,64,20,44,NaN,NaN,0,0
3,1,1.5,92,4,88,0,1.02594685339136,46,0
3,1,1.5,15,84,-69,0,0.995140967308544,-34,0
3,1,1.5,88,25,63,1,0.877833595674019,-25,0
3,1,1.5,71,27,44,0,0.685067894868553,23,0
3,1,1.5,96,7,89,1,0.674407787038945,-43,0
3,1,1.5,49,52,-3,NaN,NaN,0,0
3,1,1.5,15,82,-67,NaN,NaN,0,0
3,1,1.5,36,85,-49,1,0.602786539471708,35,0
3,1,1.5,23,92,-69,0,1.33341519697569,-42,0
3,1,10,88,12,76,1,0.833326674299315,-38,0
3,1,10,99,14,85,1,0.682007173425518,-36,0
3,1,10,92,11,81,1,1.82529951998731,-39,0
3,1,10,93,40,53,1,1.21859305782709,-10,0
3,1,10,50,50,0,1,1.1558629310457,0,0
3,1,10,67,28,39,1,1.82877884543268,-22,0
3,1,10,44,94,-50,0,1.40583149902523,-44,0
3,1,10,70,31,39,1,1.39179616695037,-19,0
3,1,10,90,41,49,0,3.33856563968584,9,0
3,1,10,19,64,-45,0,2.32720541470917,-14,0
3,1,1.5,4,79,-75,0,1.09966405376326,-29,0
3,1,1.5,34,58,-24,0,1.02570859366097,-8,0
3,1,1.5,94,5,89,1,0.778914012073074,-45,0
3,1,1.5,92,4,88,0,0.829617519746535,46,0
3,1,1.5,87,26,61,0,1.22225712629734,24,0
3,1,1.5,71,19,52,1,0.189609675551765,-31,0
3,1,1.5,5,66,-61,1,0.608128689578734,16,0
3,1,1.5,34,66,-32,0,0.194038374524098,-16,0
3,1,1.5,98,4,94,1,0.27681311086053,-46,0
3,1,1.5,55,18,37,1,0.548118022910785,-32,0
3,1,10,20,68,-48,1,1.11125704011647,18,0
3,1,10,64,47,17,0,0.573316374153364,3,0
3,1,10,73,16,57,1,0.225265797052998,-34,0
3,1,10,14,62,-48,0,1.68249725544592,-12,0
3,1,10,48,60,-12,1,0.20917996490607,10,0
3,1,1.5,90,5,85,0,1.08160653046798,45,0
3,1,1.5,89,11,78,NaN,NaN,0,0
3,1,1.5,13,52,-39,1,0.284206860815175,2,0
3,1,1.5,24,57,-33,0,0.770787521789316,-7,0
3,1,1.5,33,72,-39,1,0.270219913742039,22,0
3,1,10,44,89,-45,1,0.500672442314681,39,0
3,1,10,65,4,61,0,0.498740705603268,46,0
3,1,10,45,65,-20,0,1.60060078109382,-15,0
3,1,10,31,78,-47,0,0.810588263324462,-28,0
3,1,10,88,18,70,0,0.324425106693525,32,0
3,1,1.5,3,72,-69,0,0.512563436641358,-22,0
3,1,1.5,55,33,22,0,0.525894252990838,17,0
3,1,1.5,98,42,56,0,0.659863678738475,8,0
3,1,1.5,44,89,-45,0,0.619800851505715,-39,0
3,1,1.5,48,60,-12,1,0.453125326428562,10,0
3,1,10,54,47,7,0,0.77238716109423,3,0
3,1,10,29,63,-34,0,0.695636364282109,-13,0
3,1,10,42,58,-16,0,0.685454608756118,-8,0
3,1,10,0,55,-55,0,0.660246360581368,-5,0
3,1,10,67,38,29,0,0.972206450242084,12,0
4,1,10,98,38,60,1,2.03485899553016,-12,0
4,1,10,0,68,-68,0,0.812096308611217,-18,0
4,1,10,48,60,-12,0,2.37411939789672,-10,0
4,1,10,5,83,-78,0,2.47478671092176,-33,0
4,1,10,53,0,53,1,3.73132888946566,-50,0
4,1,1.5,30,100,-70,0,0.768600548732138,-50,0
4,1,1.5,53,23,30,1,1.1163763858076,-27,0
4,1,1.5,25,55,-30,0,0.546421050508798,-5,0
4,1,1.5,3,100,-97,0,0.887105151745345,-50,0
4,1,1.5,50,100,-50,0,1.28639183609266,-50,0
4,1,10,85,15,70,0,1.32417813830398,35,0
4,1,10,100,0,100,0,1.58628498536564,50,0
4,1,10,48,80,-32,0,2.15015990953543,-30,0
4,1,10,53,40,13,1,1.13088535815041,-10,0
4,1,10,28,85,-57,0,1.16077753605532,-35,0
4,1,1.5,50,43,7,1,0.835276134899686,-7,0
4,1,1.5,100,15,85,NaN,NaN,0,0
4,1,1.5,48,100,-52,0,0.861243977045888,-50,0
4,1,1.5,75,0,75,1,0.701700631025233,-50,0
4,1,1.5,80,45,35,1,0.87635299961039,-5,0
4,1,10,49,100,-51,0,0.857074416124306,-50,0
4,1,10,51,2,49,0,1.19368755968026,48,0
4,1,10,44,76,-32,0,2.47676280788255,-26,0
4,1,10,49,97,-48,0,3.09274569710396,-47,0
4,1,10,91,10,81,1,2.06816709767554,-40,0
4,1,1.5,60,50,10,1,0.810682140167046,0,0
4,1,1.5,3,55,-52,0,0.797339911769086,-5,0
4,1,1.5,49,96,-47,0,1.03195844734728,-46,0
4,1,1.5,49,79,-30,0,0.889219439866793,-29,0
4,1,1.5,81,35,46,NaN,NaN,0,0
4,1,1.5,26,62,-36,0,0.976473412863925,-12,0
4,1,1.5,76,31,45,1,1.1803358008583,-19,0
4,1,1.5,49,100,-51,0,1.11966474897417,-50,0
4,1,1.5,91,29,62,NaN,NaN,0,0
4,1,1.5,51,0,51,0,1.1822294229878,50,0
4,1,10,49,97,-48,0,0.952105949001634,-47,0
4,1,10,66,9,57,1,1.67676390754787,-41,0
4,1,10,51,2,49,0,0.932677811155372,48,0
4,1,10,28,55,-27,0,0.985897903490695,-5,0
4,1,10,35,66,-31,1,1.47717591514993,16,0
4,1,10,77,26,51,1,1.35656435511009,-24,0
4,1,10,51,2,49,0,0.873194396843246,48,0
4,1,10,51,3,48,0,0.993114634517042,47,0
4,1,10,57,49,8,1,0.83658583522265,-1,0
4,1,10,49,97,-48,1,1.66177951361897,47,0
4,1,1.5,82,5,77,0,0.805118204762039,45,0
4,1,1.5,49,99,-50,0,0.847778219680549,-49,0
4,1,1.5,54,25,29,1,0.736362053512494,-25,0
4,1,1.5,80,8,72,0,0.653628800942897,42,0
4,1,1.5,88,30,58,1,0.854279435725402,-20,0
4,1,10,43,92,-49,1,2.7015034245378,42,0
4,1,10,49,96,-47,1,1.42809862523609,46,0
4,1,10,49,100,-51,0,0.805411815161278,-50,0
4,1,10,97,21,76,1,0.944005454335638,-29,0
4,1,10,51,2,49,0,0.773466563787224,48,0
4,1,1.5,51,1,50,0,0.679924343088715,49,0
4,1,1.5,62,7,55,0,0.663128068750666,43,0
4,1,1.5,30,83,-53,NaN,NaN,0,0
4,1,1.5,3,100,-97,0,0.535746607994952,-50,0
4,1,1.5,70,31,39,1,0.66093570445264,-19,0
4,1,1.5,0,100,-100,0,0.547622983718611,-50,0
4,1,1.5,6,71,-65,0,0.696188379844898,-21,0
4,1,1.5,51,3,48,0,0.758842126679156,47,0
4,1,1.5,80,16,64,0,0.899348815386475,34,0
4,1,1.5,49,76,-27,1,0.769947271091951,26,0
4,1,10,100,0,100,0,1.02930312432909,50,0
4,1,10,11,54,-43,0,0.95051840013366,-4,0
4,1,10,51,0,51,0,0.779252631404233,50,0
4,1,10,27,85,-58,0,1.0545506862818,-35,0
4,1,10,82,36,46,1,0.967125165636389,-14,0
4,1,10,85,15,70,0,1.24895229472531,35,0
4,1,10,51,8,43,0,0.641712104188628,42,0
4,1,10,82,5,77,0,0.778933362169482,45,0
4,1,10,97,43,54,1,0.910115263159241,-7,0
4,1,10,30,56,-26,1,1.50892615936573,6,0
4,1,1.5,53,40,13,1,0.706812970909596,-10,0
4,1,1.5,49,97,-48,1,0.593262722657528,47,0
4,1,1.5,5,70,-65,0,0.772738219386156,-20,0
4,1,1.5,79,20,59,1,0.968738739893524,-30,0
4,1,1.5,84,28,56,0,1.22062090718646,22,0
4,1,1.5,10,61,-51,0,0.561167550369646,-11,0
4,1,1.5,38,57,-19,1,0.861148672796844,7,0
4,1,1.5,85,15,70,1,0.588976597309738,-35,0
4,1,1.5,51,1,50,0,0.632509745775678,49,0
4,1,1.5,43,54,-11,0,0.905498138816256,-4,0
4,1,10,4,57,-53,0,1.07944745528403,-7,0
4,1,10,51,8,43,0,0.726899807741574,42,0
4,1,10,62,42,20,1,0.660827937339491,-8,0
4,1,10,44,93,-49,0,1.04540880941204,-43,0
4,1,10,16,61,-45,0,0.71004598430045,-11,0
4,1,10,65,2,63,1,1.52325625296726,-48,0
4,1,10,37,84,-47,0,1.25803882181935,-34,0
4,1,10,64,33,31,1,0.817822627794158,-17,0
4,1,10,49,97,-48,0,1.12374413741418,-47,0
4,1,10,84,28,56,1,1.96983693809489,-22,0
4,1,1.5,26,76,-50,0,0.661006816088047,-26,0
4,1,1.5,49,96,-47,0,0.981638170085716,-46,0
4,1,1.5,5,98,-93,0,0.768905888886366,-48,0
4,1,1.5,94,38,56,1,1.07686617633954,-12,0
4,1,1.5,51,4,47,1,0.96482613389162,-46,0
4,1,10,81,38,43,1,0.96741071183169,-12,0
4,1,10,62,7,55,0,1.32322252992344,43,0
4,1,10,27,51,-24,0,0.985174324301624,-1,0
4,1,10,51,2,49,0,0.91693721466072,48,0
4,1,10,85,31,54,1,1.04256177823117,-19,0
4,1,1.5,55,34,21,1,0.947130334059693,-16,0
4,1,1.5,92,5,87,0,0.759012208107379,45,0
4,1,1.5,91,46,45,1,0.87506089391718,-4,0
4,1,1.5,53,38,15,1,0.874098687550941,-12,0
4,1,1.5,49,76,-27,1,1.13757095126493,26,0
4,1,1.5,5,97,-92,0,0.573437605957224,-47,0
4,1,1.5,22,68,-46,0,0.721382058241943,-18,0
4,1,1.5,6,80,-74,0,0.855424919496727,-30,0
4,1,1.5,80,8,72,0,0.959369232488825,42,0
4,1,1.5,63,17,46,0,0.96402044642673,33,0
4,1,10,80,16,64,1,0.911285672656959,-34,0
4,1,10,51,3,48,0,0.853185269628739,47,0
4,1,10,90,28,62,1,0.637878307468782,-22,0
4,1,10,61,1,60,0,1.15907415587026,49,0
4,1,10,36,68,-32,1,0.675066392239387,18,0
4,1,10,51,3,48,0,0.705172638148724,47,0
4,1,10,38,57,-19,1,0.935812954414359,7,0
4,1,10,62,7,55,0,0.684557595839578,43,0
4,1,10,85,49,36,1,0.843841421059551,-1,0
4,1,10,79,49,30,1,0.684408774588519,-1,0
4,1,1.5,34,50,-16,1,1.09903541102722,0,0
4,1,1.5,40,81,-41,0,0.817025737645963,-31,0
4,1,1.5,16,86,-70,0,0.642297125659752,-36,0
4,1,1.5,55,14,41,1,0.555679858363874,-36,0
4,1,1.5,63,47,16,1,0.879655658414777,-3,0
4,1,1.5,30,56,-26,0,0.644081147902398,-6,0
4,1,1.5,36,62,-26,0,1.1815589942471,-12,0
4,1,1.5,25,85,-60,0,0.584703667931535,-35,0
4,1,1.5,6,86,-80,0,0.643319447015529,-36,0
4,1,1.5,32,93,-61,0,0.652449227578472,-43,0
4,1,10,54,11,43,1,0.739814266680696,-39,0
4,1,10,51,5,46,0,1.11249310418862,45,0
4,1,10,69,10,59,0,0.934296883735442,40,0
4,1,10,51,1,50,1,1.06693693974375,-49,0
4,1,10,85,15,70,1,0.730316831646633,-35,0
4,1,1.5,42,51,-9,1,1.3008766158182,1,0
4,1,1.5,74,45,29,1,0.970869889539244,-5,0
4,1,1.5,79,30,49,1,0.685956735535001,-20,0
4,1,1.5,69,10,59,0,0.868734524514366,40,0
4,1,1.5,9,88,-79,0,0.852038319639178,-38,0
4,1,10,47,51,-4,1,0.995352085055856,1,0
4,1,10,50,35,15,0,1.02115497753948,15,0
4,1,10,13,72,-59,0,0.726568075642717,-22,0
4,1,10,49,96,-47,0,0.931865159149311,-46,0
4,1,10,35,66,-31,0,0.560512516929521,-16,0
4,1,1.5,49,97,-48,0,0.578978448409543,-47,0
4,1,1.5,3,79,-76,0,0.549686687279973,-29,0
4,1,1.5,83,15,68,1,0.785624453603305,-35,0
4,1,1.5,39,97,-58,0,0.796890882133084,-47,0
4,1,1.5,47,51,-4,1,1.23886140746072,1,0
4,1,10,47,59,-12,1,1.3508164091927,9,0
4,1,10,69,9,60,1,0.70741705322871,-41,0
4,1,10,56,12,44,1,0.705188033452941,-38,0
4,1,10,80,8,72,0,0.592037329941377,42,0
4,1,10,30,73,-43,0,0.706663416547599,-23,0
4,1,1.5,80,8,72,1,0.581819248158354,-42,0
4,1,1.5,97,21,76,1,0.536461756420977,-29,0
4,1,1.5,83,37,46,1,0.861775481516815,-13,0
4,1,1.5,46,69,-23,0,1.10971901741323,-19,0
4,1,1.5,51,2,49,1,0.611609890382169,-48,0
4,1,10,2,90,-88,0,0.948247226555395,-40,0
4,1,10,100,0,100,0,1.40880208056478,50,0
4,1,10,72,14,58,1,1.0827886023435,-36,0
4,1,10,34,95,-61,0,1.1052815049261,-45,0
4,1,10,97,31,66,1,1.76732420489679,-19,0
4,1,10,84,28,56,1,2.32056134203049,-22,0
4,1,10,10,76,-66,0,0.862537182403685,-26,0
4,1,10,82,5,77,0,0.790493401098502,45,0
4,1,10,94,46,48,1,0.825004169560998,-4,0
4,1,10,64,38,26,1,0.947115305312764,-12,0
4,1,1.5,35,96,-61,0,0.694329213869423,-46,0
4,1,1.5,82,4,78,0,0.772321813126837,46,0
4,1,1.5,49,96,-47,0,0.74351903610841,-46,0
4,1,1.5,50,85,-35,0,1.26819385617455,-35,0
4,1,1.5,43,86,-43,NaN,NaN,0,0
4,1,10,80,8,72,0,1.42603162268279,42,0
4,1,10,71,29,42,1,0.883227735002947,-21,0
4,1,10,50,62,-12,0,0.825830384093933,-12,0
4,1,10,24,69,-45,0,0.587430469135143,-19,0
4,1,10,51,2,49,0,0.717712478075555,48,0
4,1,1.5,99,41,58,1,1.03443782405702,-9,0
4,1,1.5,50,35,15,1,0.595048577675698,-15,0
4,1,1.5,76,0,76,0,0.756947404883249,50,0
4,1,1.5,21,62,-41,0,0.976923542166332,-12,0
4,1,1.5,80,1,79,0,0.901006742777099,49,0
4,1,1.5,51,5,46,0,0.608223657080089,45,0
4,1,1.5,50,35,15,1,0.86599599355759,-15,0
4,1,1.5,62,18,44,1,1.07339856787075,-32,0
4,1,1.5,17,63,-46,0,0.864751539987992,-13,0
4,1,1.5,72,7,65,0,0.631963945668758,43,0
4,1,10,72,20,52,0,0.799899563982763,30,0
4,1,10,85,40,45,1,0.809874253372982,-10,0
4,1,10,100,8,92,0,0.755845174580827,42,0
4,1,10,85,15,70,0,0.855747854280708,35,0
4,1,10,12,67,-55,0,1.18371433650827,-17,0
5,1,10,53,23,30,1,1.76279583120231,-27,0
5,1,10,28,85,-57,0,1.04635134798446,-35,0
5,1,10,5,83,-78,0,0.808033573845023,-33,0
5,1,10,75,0,75,1,0.59390317571706,-50,0
5,1,10,48,60,-12,1,1.24595135912568,10,0
5,1,1.5,50,100,-50,0,1.1667262935498,-50,0
5,1,1.5,0,68,-68,0,0.898831630791392,-18,0
5,1,1.5,48,80,-32,1,0.905540021612978,30,0
5,1,1.5,85,15,70,0,0.720295548950162,35,0
5,1,1.5,25,55,-30,1,1.11826649990689,5,0
5,1,10,48,100,-52,0,1.09988248127956,-50,0
5,1,10,100,0,100,0,1.09856103715538,50,0
5,1,10,53,40,13,1,1.32133195702772,-10,0
5,1,10,50,43,7,1,0.703440080114888,-7,0
5,1,10,100,15,85,1,1.2541835344764,-35,0
5,1,1.5,98,38,60,1,1.38227270794596,-12,0
5,1,1.5,3,100,-97,0,0.794419583618946,-50,0
5,1,1.5,80,45,35,1,0.886502062259751,-5,0
5,1,1.5,30,100,-70,0,0.965911873423465,-50,0
5,1,1.5,53,0,53,0,0.825933734982755,50,0
5,1,10,17,88,-71,0,1.15396748477724,-38,0
5,1,10,86,43,43,1,1.1675657129781,-7,0
5,1,10,38,70,-32,0,1.1554982339203,-20,0
5,1,10,66,20,46,1,1.48837532385369,-30,0
5,1,10,12,74,-62,0,1.25582058564396,-24,0
5,1,1.5,50,59,-9,1,0.839879094277421,9,0
5,1,1.5,26,82,-56,0,1.19334102129142,-32,0
5,1,1.5,48,60,-12,0,0.900590746006856,-10,0
5,1,1.5,7,92,-85,0,0.827553557892315,-42,0
5,1,1.5,41,68,-27,1,1.06153310978152,18,0
5,1,10,100,0,100,0,0.852359318436356,50,0
5,1,10,57,25,32,1,0.949089761428695,-25,0
5,1,10,56,23,33,1,1.3458697631595,-27,0
5,1,10,19,72,-53,0,0.934574036793492,-22,0
5,1,10,9,85,-76,0,0.852065338354805,-35,0
5,1,1.5,28,56,-28,0,1.10818576901875,-6,0
5,1,1.5,50,59,-9,1,1.13875163301964,9,0
5,1,1.5,59,34,25,1,1.10431784158573,-16,0
5,1,1.5,48,80,-32,1,1.28707448032947,30,0
5,1,1.5,55,47,8,NaN,NaN,0,0
5,1,1.5,18,77,-59,1,0.792219864842991,27,0
5,1,1.5,46,56,-10,1,0.595783988421317,6,0
5,1,1.5,76,21,55,1,0.526367667176601,-29,0
5,1,1.5,48,58,-10,1,0.65249061976283,8,0
5,1,1.5,94,5,89,1,0.40525483894271,-45,0
5,1,10,38,77,-39,0,0.734654386460534,-27,0
5,1,10,80,13,67,1,0.492092229102127,-37,0
5,1,10,92,26,66,1,0.491503169267162,-24,0
5,1,10,38,56,-18,0,0.64285892328553,-6,0
5,1,10,49,56,-7,1,0.708293683899683,6,0
5,1,10,91,25,66,1,0.593778179201763,-25,0
5,1,10,15,75,-60,1,0.421214804866395,25,0
5,1,10,14,98,-84,0,0.719222998186524,-48,0
5,1,10,100,0,100,1,0.485399600305755,-50,0
5,1,10,13,75,-62,0,0.588768787965819,-25,0
5,1,1.5,24,86,-62,0,0.663545297125893,-36,0
5,1,1.5,41,68,-27,0,0.375600972993198,-18,0
5,1,1.5,85,15,70,0,0.875626998660664,35,0
5,1,1.5,88,21,67,0,0.683758443679835,29,0
5,1,1.5,83,6,77,1,0.539201253923238,-44,0
5,1,1.5,50,59,-9,1,0.66337704667967,9,0
5,1,1.5,100,0,100,1,1.02338021374817,-50,0
5,1,1.5,30,96,-66,0,0.753378571565918,-46,0
5,1,1.5,48,60,-12,1,0.854206041181897,10,0
5,1,1.5,23,96,-73,0,0.526909440939562,-46,0
5,1,10,83,29,54,1,0.676366787436564,-21,0
5,1,10,42,76,-34,1,0.364460520893772,26,0
5,1,10,14,87,-73,0,0.672534049637761,-37,0
5,1,10,9,81,-72,0,0.800548445131426,-31,0
5,1,10,50,15,35,1,0.755335261919754,-35,0
5,1,1.5,49,100,-51,0,0.766813314585306,-50,0
5,1,1.5,89,31,58,1,0.74689268187467,-19,0
5,1,1.5,72,19,53,1,1.08762329202,-31,0
5,1,1.5,25,55,-30,0,0.911031804100276,-5,0
5,1,1.5,88,21,67,1,0.645790293232494,-29,0
5,1,10,100,0,100,1,0.789838699507527,-50,0
5,1,10,59,46,13,1,0.633347824619705,-4,0
5,1,10,55,38,17,1,0.882733838792774,-12,0
5,1,10,32,83,-51,0,1.27416721528243,-33,0
5,1,10,93,45,48,1,0.65020182722219,-5,0
5,1,10,48,58,-10,0,0.818806734123427,-8,0
5,1,10,74,26,48,1,0.820857630065802,-24,0
5,1,10,84,17,67,1,0.486964439407529,-33,0
5,1,10,50,94,-44,1,0.670336530212808,44,0
5,1,10,48,80,-32,1,1.02244805496775,30,0
5,1,1.5,17,52,-35,0,0.487884868309266,-2,0
5,1,1.5,26,96,-70,0,0.263295817272592,-46,0
5,1,1.5,13,85,-72,0,0.567348930162552,-35,0
5,1,1.5,53,0,53,0,0.179470439972647,50,0
5,1,1.5,17,87,-70,1,0.414842181815402,37,0
5,1,10,97,16,81,1,0.565529699319086,-34,0
5,1,10,28,97,-69,0,0.593739323978298,-47,0
5,1,10,48,80,-32,0,0.853111863452796,-30,0
5,1,10,69,32,37,1,0.557176193038686,-18,0
5,1,10,53,0,53,1,0.697923005078337,-50,0
5,1,1.5,13,79,-66,0,0.688175842607961,-29,0
5,1,1.5,21,89,-68,0,0.838694009989922,-39,0
5,1,1.5,18,77,-59,0,0.488205607174677,-27,0
5,1,1.5,75,4,71,0,0.327608175139176,46,0
5,1,1.5,28,100,-72,0,0.636980787923676,-50,0
5,1,10,78,25,53,1,0.540479810679244,-25,0
5,1,10,28,91,-63,0,0.673730863803939,-41,0
5,1,10,97,14,83,1,0.697132704513933,-36,0
5,1,10,71,49,22,1,0.543361328642277,-1,0
5,1,10,53,0,53,1,0.9961053137813,-50,0
5,1,1.5,90,28,62,1,0.886256101370236,-22,0
5,1,1.5,48,60,-12,0,0.669640801796049,-10,0
5,1,1.5,48,58,-10,1,1.35703697404279,8,0
5,1,1.5,68,37,31,1,0.489018634378226,-13,0
5,1,1.5,100,48,52,1,0.951760141579143,-2,0
5,1,1.5,31,94,-63,0,0.60271598005238,-44,0
5,1,1.5,51,1,50,1,0.493405242375957,-49,0
5,1,1.5,43,100,-57,1,0.844783649721649,50,0
5,1,1.5,59,5,54,1,0.43830267192061,-45,0
5,1,1.5,49,55,-6,0,0.614939979677729,-5,0
5,1,10,49,99,-50,0,0.71179908477643,-49,0
5,1,10,61,50,11,0,0.742521835902153,0,0
5,1,10,49,98,-49,0,1.20391697298692,-48,0
5,1,10,73,48,25,0,0.55065034845029,2,0
5,1,10,49,100,-51,1,0.466765588642374,50,0
5,1,10,18,77,-59,1,0.559551493432082,27,0
5,1,10,42,76,-34,0,0.635617189549521,-26,0
5,1,10,82,39,43,0,0.580275622820409,11,0
5,1,10,35,58,-23,0,0.983021000880399,-8,0
5,1,10,65,30,35,1,0.666393824805709,-20,0
5,1,1.5,60,12,48,1,0.586006035022365,-38,0
5,1,1.5,17,93,-76,0,0.684692068696677,-43,0
5,1,1.5,11,60,-49,0,0.643423423687636,-10,0
5,1,1.5,41,68,-27,0,0.716163332694123,-18,0
5,1,1.5,96,38,58,0,0.825617028265697,12,0
5,1,10,2,83,-81,0,1.03358777394715,-33,0
5,1,10,93,48,45,0,0.642421985310648,2,0
5,1,10,71,30,41,1,0.891871047580935,-20,0
5,1,10,41,68,-27,1,0.954539389664205,18,0
5,1,10,25,55,-30,0,1.56736505874505,-5,0
5,1,1.5,85,15,70,1,0.657520171725992,-35,0
5,1,1.5,92,39,53,1,0.817393650324448,-11,0
5,1,1.5,74,29,45,1,0.586837023602129,-21,0
5,1,1.5,42,83,-41,0,0.637594773752426,-33,0
5,1,1.5,78,8,70,1,0.646466960597536,-42,0
5,1,1.5,17,87,-70,0,0.565318194947395,-37,0
5,1,1.5,10,76,-66,0,0.728723833206459,-26,0
5,1,1.5,1,57,-56,0,0.646785133552839,-7,0
5,1,1.5,75,4,71,1,0.830874946299446,-46,0
5,1,1.5,49,56,-7,0,1.04763796902989,-6,0
5,1,10,10,77,-67,0,0.879658411275159,-27,0
5,1,10,68,38,30,1,1.01508462374295,-12,0
5,1,10,81,42,39,1,0.689174715074842,-8,0
5,1,10,56,43,13,1,0.824629885677496,-7,0
5,1,10,92,7,85,1,0.858045377033704,-43,0
5,1,10,50,0,50,1,0.609478255004433,-50,0
5,1,10,49,98,-49,1,1.49151856473145,48,0
5,1,10,49,97,-48,0,0.514360670304086,-47,0
5,1,10,11,91,-80,0,0.847938987037196,-41,0
5,1,10,26,86,-60,0,0.887817641445508,-36,0
5,1,1.5,5,99,-94,0,0.813956062807847,-49,0
5,1,1.5,39,66,-27,0,1.05605012470187,-16,0
5,1,1.5,49,99,-50,0,0.632723575150521,-49,0
5,1,1.5,49,100,-51,0,1.08148380030616,-50,0
5,1,1.5,18,51,-33,0,0.784268473458724,-1,0
5,1,1.5,3,82,-79,0,0.885870115056605,-32,0
5,1,1.5,11,66,-55,0,0.612590338392693,-16,0
5,1,1.5,49,99,-50,0,0.414692625865428,-49,0
5,1,1.5,81,4,77,0,0.631910914506079,46,0
5,1,1.5,51,4,47,0,0.56082858395348,46,0
5,1,10,51,2,49,0,0.588268068777325,48,0
5,1,10,80,14,66,0,0.534995725924091,36,0
5,1,10,49,96,-47,0,1.29953381064115,-46,0
5,1,10,88,9,79,0,0.585854646278676,41,0
5,1,10,98,9,89,0,0.796591077374615,41,0
5,1,1.5,22,100,-78,0,0.516014949729652,-50,0
5,1,1.5,45,71,-26,0,0.569486700516791,-21,0
5,1,1.5,46,84,-38,0,0.613525063085035,-34,0
5,1,1.5,50,94,-44,0,0.551078489015708,-44,0
5,1,1.5,7,97,-90,0,0.554920390779444,-47,0
5,1,10,49,98,-49,0,1.45436747363237,-48,0
5,1,10,40,60,-20,0,0.526704168065407,-10,0
5,1,10,34,78,-44,0,0.619703410022339,-28,0
5,1,10,73,48,25,0,0.71002567377036,2,0
5,1,10,0,78,-78,0,0.532745788606917,-28,0
5,1,1.5,76,46,30,0,0.624887283200223,4,0
5,1,1.5,37,52,-15,0,0.722222548052741,-2,0
5,1,1.5,12,70,-58,0,0.607536960113066,-20,0
5,1,1.5,18,88,-70,0,0.553675190865761,-38,0
5,1,1.5,50,86,-36,0,0.741821708779753,-36,0
5,1,10,85,23,62,0,1.11398106210981,27,0
5,1,10,51,1,50,1,0.7834118257706,-49,0
5,1,10,49,98,-49,0,0.786158816690659,-48,0
5,1,10,49,97,-48,0,0.636870087197167,-47,0
5,1,10,51,0,51,0,0.948935073656685,50,0
5,1,10,49,99,-50,0,0.60695963015678,-49,0
5,1,10,49,96,-47,0,0.552538125772116,-46,0
5,1,10,61,2,59,0,0.772629868082731,48,0
5,1,10,51,0,51,1,0.487997401831308,-50,0
5,1,10,18,69,-51,0,0.550660978653468,-19,0
5,1,1.5,78,49,29,1,0.706191836297876,-1,0
5,1,1.5,40,88,-48,0,0.82422703766315,-38,0
5,1,1.5,11,92,-81,0,0.689651241387764,-42,0
5,1,1.5,51,4,47,1,1.23239271926286,-46,0
5,1,1.5,51,49,2,1,0.44852746037941,-1,0
6,1,1.5,28,85,-57,0,0.619406215692607,-35,0
6,1,1.5,53,40,13,1,0.516700481471389,-10,0
6,1,1.5,3,100,-97,0,0.474729069185514,-50,0
6,1,1.5,50,43,7,1,0.65860536381615,-7,0
6,1,1.5,50,100,-50,1,1.17997173852086,50,0
6,1,10,48,100,-52,1,2.31114605613084,50,0
6,1,10,25,55,-30,0,1.71773563603892,-5,0
6,1,10,53,0,53,0,1.20365309859062,50,0
6,1,10,5,83,-78,0,0.87020943185621,-33,0
6,1,10,0,68,-68,0,0.710291247188934,-18,0
6,1,1.5,48,60,-12,1,0.755707920728582,10,0
6,1,1.5,48,80,-32,1,0.936034485602477,30,0
6,1,1.5,85,15,70,0,0.918168905408265,35,0
6,1,1.5,80,45,35,1,1.31661654011327,-5,0
6,1,1.5,100,0,100,0,0.594733687793223,50,0
6,1,10,30,100,-70,0,0.86033404261957,-50,0
6,1,10,53,23,30,0,0.94917222457434,27,0
6,1,10,100,15,85,0,1.15373035029938,35,0
6,1,10,75,0,75,0,0.710474158707711,50,0
6,1,10,98,38,60,1,3.20485320342596,-12,0
6,1,1.5,40,78,-38,1,0.868862338005101,28,0
6,1,1.5,3,68,-65,0,0.540919579413412,-18,0
6,1,1.5,100,23,77,0,0.698110952881052,27,0
6,1,1.5,45,63,-18,1,0.87371994010482,13,0
6,1,1.5,12,94,-82,0,0.625397575964143,-44,0
6,1,10,48,60,-12,1,1.38603201134856,10,0
6,1,10,50,23,27,0,1.04525025704766,27,0
6,1,10,96,17,79,0,0.805997591726054,33,0
6,1,10,95,20,75,0,0.968726895507643,30,0
6,1,10,4,50,-46,0,0.940469081905121,0,0
6,1,1.5,44,57,-13,1,0.855642490455693,7,0
6,1,1.5,44,74,-30,0,0.896266442334309,-24,0
6,1,1.5,94,24,70,0,0.935087671067095,26,0
6,1,1.5,4,61,-57,0,0.540082365166882,-11,0
6,1,1.5,40,72,-32,0,1.16136314901064,-22,0
6,1,10,76,30,46,0,1.10030075932104,20,0
6,1,10,16,100,-84,0,1.1308612786579,-50,0
6,1,10,99,23,76,0,0.855992551578993,27,0
6,1,10,45,87,-42,1,1.37736185873291,37,0
6,1,10,19,98,-79,0,0.845239993475388,-48,0
6,1,10,66,28,38,0,1.35824522239864,22,0
6,1,10,96,8,88,0,0.659148233474298,42,0
6,1,10,80,26,54,0,0.731695193898986,24,0
6,1,10,23,74,-51,0,1.34572842954503,-24,0
6,1,10,91,42,49,1,2.23020019464138,-8,0
6,1,1.5,86,18,68,0,0.621989703437748,32,0
6,1,1.5,33,61,-28,0,1.10418698762305,-11,0
6,1,1.5,2,87,-85,0,0.630925975818172,-37,0
6,1,1.5,61,33,28,NaN,NaN,0,0
6,1,1.5,75,2,73,0,0.528676237447826,48,0
6,1,1.5,75,6,69,0,0.64407031280075,44,0
6,1,1.5,6,99,-93,0,0.460738720609015,-49,0
6,1,1.5,56,41,15,1,0.572510488087801,-9,0
6,1,1.5,83,6,77,0,0.488461362232556,44,0
6,1,1.5,91,18,73,0,0.495597843916585,32,0
6,1,10,98,10,88,0,0.637593998742659,40,0
6,1,10,22,97,-75,0,1.09496076932805,-47,0
6,1,10,87,15,72,0,0.885770840091709,35,0
6,1,10,59,34,25,0,1.61277668116395,16,0
6,1,10,82,26,56,0,0.606588480239907,24,0
6,1,10,2,69,-67,0,0.695921146441151,-19,0
6,1,10,47,59,-12,1,1.86264371292054,9,0
6,1,10,46,83,-37,1,2.22254723534184,33,0
6,1,10,68,37,31,0,2.36851869161455,13,0
6,1,10,36,84,-48,0,1.14036424684627,-34,0
6,1,1.5,21,79,-58,0,0.889033556382628,-29,0
6,1,1.5,0,61,-61,0,0.560520436421712,-11,0
6,1,1.5,95,32,63,0,0.604354687061914,18,0
6,1,1.5,55,21,34,0,0.75888962811041,29,0
6,1,1.5,25,66,-41,0,0.571538747734166,-16,0
6,1,10,78,34,44,0,0.908660072321481,16,0
6,1,10,20,88,-68,0,0.819453867992024,-38,0
6,1,10,74,32,42,0,1.15720237015194,18,0
6,1,10,77,50,27,1,1.8101682676006,0,0
6,1,10,9,91,-82,0,0.684563037577391,-41,0
6,1,1.5,61,35,26,0,0.555165417626768,15,0
6,1,1.5,48,96,-48,1,0.487813657515517,46,0
6,1,1.5,74,6,68,0,0.615113843176232,44,0
6,1,1.5,63,21,42,0,0.537040682234192,29,0
6,1,1.5,92,49,43,0,0.558374250163752,1,0
6,1,10,42,89,-47,1,1.61872258847302,39,0
6,1,10,77,27,50,0,0.652855197491363,23,0
6,1,10,37,51,-14,0,0.933262221440373,-1,0
6,1,10,73,9,64,0,0.722853126449081,41,0
6,1,10,32,54,-22,0,1.00896193131098,-4,0
6,1,1.5,67,40,27,1,1.05746794008269,-10,0
6,1,1.5,49,94,-45,1,0.761843704123294,44,0
6,1,1.5,73,29,44,0,0.677900146439242,21,0
6,1,1.5,51,29,22,0,0.741887654205584,21,0
6,1,1.5,93,2,91,0,0.427142383238106,48,0
6,1,1.5,21,87,-66,0,0.515346789609566,-37,0
6,1,1.5,45,88,-43,1,0.712945113714795,38,0
6,1,1.5,27,91,-64,0,0.47906506188383,-41,0
6,1,1.5,34,63,-29,0,0.51817623653119,-13,0
6,1,1.5,85,6,79,0,0.571963586311995,44,0
6,1,10,60,29,31,0,0.951465766404908,21,0
6,1,10,88,6,82,0,0.476036574972568,44,0
6,1,10,83,19,64,0,0.468062145929707,31,0
6,1,10,19,93,-74,0,0.779981635536842,-43,0
6,1,10,50,23,27,0,1.29538414168132,27,0
6,1,1.5,71,32,39,0,0.475187997485364,18,0
6,1,1.5,22,66,-44,0,0.539260912834607,-16,0
6,1,1.5,99,42,57,1,0.768434017143818,-8,0
6,1,1.5,49,64,-15,1,0.5726189887082,14,0
6,1,1.5,21,98,-77,0,0.688328668906252,-48,0
6,1,10,38,92,-54,0,0.806866696357702,-42,0
6,1,10,75,1,74,0,0.665436870783424,49,0
6,1,10,47,84,-37,1,1.18491364853503,34,0
6,1,10,46,85,-39,1,1.59543344348344,35,0
6,1,10,34,74,-40,0,0.70143854961043,-24,0
6,1,10,23,92,-69,0,0.721492836576317,-42,0
6,1,10,88,22,66,0,0.774677934602778,28,0
6,1,10,100,11,89,0,0.810533357526083,39,0
6,1,10,67,47,20,1,1.47684189883421,-3,0
6,1,10,68,16,52,0,0.595776540039878,34,0
6,1,1.5,57,22,35,0,0.517699713536331,28,0
6,1,1.5,17,53,-36,0,0.48366754090307,-3,0
6,1,1.5,49,92,-43,1,0.674900617463663,42,0
6,1,1.5,71,30,41,0,0.610300227814605,20,0
6,1,1.5,76,4,72,0,0.628170206682626,46,0
6,1,10,95,7,88,0,0.582840040394558,43,0
6,1,10,93,48,45,0,0.5933561697816,2,0
6,1,10,70,31,39,0,0.90861755180822,19,0
6,1,10,47,91,-44,1,1.16318419996378,41,0
6,1,10,3,71,-68,0,0.567205320929133,-21,0
6,1,1.5,27,53,-26,0,0.538632635593785,-3,0
6,1,1.5,78,16,62,0,0.735240524981691,34,0
6,1,1.5,1,79,-78,0,0.595854983055915,-29,0
6,1,1.5,81,26,55,0,0.518332389451416,24,0
6,1,1.5,88,48,40,1,0.63592983382182,-2,0
6,1,1.5,87,23,64,0,0.74625590384494,27,0
6,1,1.5,80,46,34,1,0.559137786623978,-4,0
6,1,1.5,78,27,51,0,0.547471037482183,23,0
6,1,1.5,30,75,-45,0,0.503617725922368,-25,0
6,1,1.5,17,58,-41,0,0.574096209992831,-8,0
6,1,10,60,38,22,0,0.553198843881773,12,0
6,1,10,66,4,62,0,0.957906157959997,46,0
6,1,10,80,27,53,0,1.08986930440483,23,0
6,1,10,8,99,-91,0,0.576652206026438,-49,0
6,1,10,26,92,-66,0,0.803296072900821,-42,0
6,1,10,79,27,52,0,0.604292739072434,23,0
6,1,10,94,32,62,0,0.830323357507723,18,0
6,1,10,26,91,-65,0,1.21500204355061,-41,0
6,1,10,97,27,70,0,0.584213892844673,23,0
6,1,10,97,11,86,0,0.690899327186116,39,0
6,1,1.5,38,93,-55,0,0.59268903758857,-43,0
6,1,1.5,92,46,46,1,0.795866712852558,-4,0
6,1,1.5,90,43,47,0,0.558027121489431,7,0
6,1,1.5,50,24,26,0,0.730526246336694,26,0
6,1,1.5,98,3,95,0,0.591424052314778,47,0
6,1,10,60,48,12,1,1.68838365232887,-2,0
6,1,10,10,74,-64,0,0.711021793595819,-24,0
6,1,10,5,60,-55,0,0.476896515700446,-10,0
6,1,10,96,23,73,1,1.62042340900871,-27,0
6,1,10,56,8,48,0,0.550142865259431,42,0
6,1,1.5,41,62,-21,1,0.801600750707166,12,0
6,1,1.5,72,32,40,0,0.619487957714227,18,0
6,1,1.5,87,11,76,0,0.50077178397396,39,0
6,1,1.5,47,93,-46,1,0.475520463913654,43,0
6,1,1.5,29,70,-41,0,0.402138855135263,-20,0
6,1,1.5,21,85,-64,0,0.40934021725775,-35,0
6,1,1.5,80,27,53,0,0.435359105896168,23,0
6,1,1.5,82,21,61,0,0.492338793187173,29,0
6,1,1.5,53,0,53,0,0.610420458231829,50,0
6,1,1.5,25,85,-60,0,0.70827958703785,-35,0
6,1,10,9,84,-75,0,0.49707249930816,-34,0
6,1,10,94,30,64,0,0.97503129473148,20,0
6,1,10,49,64,-15,1,1.33809379805325,14,0
6,1,10,29,100,-71,0,0.847044915957895,-50,0
6,1,10,38,95,-57,1,1.24677476407533,45,0
6,1,1.5,86,44,42,1,0.828739101827523,-6,0
6,1,1.5,93,9,84,0,0.749326911269691,41,0
6,1,1.5,64,25,39,0,0.641322241344369,25,0
6,1,1.5,79,28,51,0,0.521712037153975,22,0
6,1,1.5,87,15,72,0,0.535084738618025,35,0
6,1,10,34,51,-17,0,0.739216926096788,-1,0
6,1,10,99,5,94,0,0.599799493785895,45,0
6,1,10,1,86,-85,0,0.553887236331548,-36,0
6,1,10,100,37,63,1,1.58183017820124,-13,0
6,1,10,81,1,80,0,0.568234977154361,49,0
6,1,10,49,66,-17,1,1.14624673994126,16,0
6,1,10,82,45,37,1,1.21417545943223,-5,0
6,1,10,96,49,47,1,0.855501366337649,-1,0
6,1,10,71,26,45,0,0.727418216740716,24,0
6,1,10,98,10,88,0,0.996687065516653,40,0
6,1,1.5,3,72,-69,0,0.437291589918914,-22,0
6,1,1.5,96,27,69,0,0.63801187275385,23,0
6,1,1.5,47,65,-18,1,0.94243785498702,15,0
6,1,1.5,48,60,-12,1,0.787039674205062,10,0
6,1,1.5,15,91,-76,0,0.685782203332565,-41,0
6,1,1.5,12,64,-52,0,0.474995188950288,-14,0
6,1,1.5,19,83,-64,0,0.530554104604107,-33,0
6,1,1.5,80,38,42,1,1.39893588749692,-12,0
6,1,1.5,40,97,-57,1,0.920689712051626,47,0
6,1,1.5,91,14,77,0,0.694320029178016,36,0
6,1,10,91,12,79,0,0.770703366268663,38,0
6,1,10,48,80,-32,1,0.91806700279858,30,0
6,1,10,9,55,-46,0,0.595985110488982,-5,0
6,1,10,38,72,-34,0,0.57370362835627,-22,0
6,1,10,49,83,-34,1,0.945868453994535,33,0
7,1,10,25,55,-30,0,1.38637249205954,-5,0
7,1,10,53,40,13,0,1.02154038455546,10,0
7,1,10,0,68,-68,0,0.735799654336347,-18,0
7,1,10,30,100,-70,0,0.685199691358548,-50,0
7,1,10,5,83,-78,0,0.804596264412567,-33,0
7,1,1.5,98,38,60,1,0.654092522776978,-12,0
7,1,1.5,53,23,30,0,0.591458477283481,27,0
7,1,1.5,50,100,-50,0,0.771715324119214,-50,0
7,1,1.5,85,15,70,0,0.800267586970335,35,0
7,1,1.5,80,45,35,0,1.09165073668896,5,0
7,1,1.5,48,100,-52,0,0.930438750991925,-50,0
7,1,1.5,3,100,-97,0,0.679921996565326,-50,0
7,1,1.5,53,0,53,0,1.03922165181802,50,0
7,1,1.5,48,80,-32,0,1.44064499456579,-30,0
7,1,1.5,48,60,-12,NaN,NaN,0,0
7,1,10,50,43,7,0,2.05765399538507,7,0
7,1,10,28,85,-57,0,1.65013296873076,-35,0
7,1,10,75,0,75,0,1.39510755713252,50,0
7,1,10,100,0,100,0,1.24652421020596,50,0
7,1,10,100,15,85,0,1.35124235498529,35,0
7,1,1.5,34,88,-54,0,1.15005250936099,-38,0
7,1,1.5,59,15,44,0,0.698709167786319,35,0
7,1,1.5,83,18,65,0,0.769596255248644,32,0
7,1,1.5,100,6,94,0,0.669648489691326,44,0
7,1,1.5,96,5,91,0,0.614362455715309,45,0
7,1,10,86,22,64,0,3.53579232318634,28,0
7,1,10,73,11,62,0,0.773301418394112,39,0
7,1,10,4,54,-50,0,1.033301015181,-4,0
7,1,10,94,39,55,0,1.83472655727383,11,0
7,1,10,34,69,-35,0,1.78883099316931,-19,0
7,1,10,77,25,52,0,1.42238786548069,25,0
7,1,10,69,40,29,0,1.28837041367842,10,0
7,1,10,17,85,-68,0,1.92786991607682,-35,0
7,1,10,90,16,74,0,0.981920651299333,34,0
7,1,10,67,15,52,0,2.07328950527562,35,0
7,1,1.5,93,46,47,NaN,NaN,0,0
7,1,1.5,31,81,-50,0,0.680945058529915,-31,0
7,1,1.5,80,30,50,0,0.608299594770642,20,0
7,1,1.5,84,36,48,0,0.635754384485836,14,0
7,1,1.5,7,69,-62,0,0.85319005822771,-19,0
7,1,10,19,51,-32,0,0.840142810799534,-1,0
7,1,10,90,27,63,0,1.12955424775987,23,0
7,1,10,25,57,-32,0,0.798871736034471,-7,0
7,1,10,29,74,-45,0,1.40154467327807,-24,0
7,1,10,73,23,50,0,0.988420448776424,27,0
7,1,1.5,83,28,55,0,0.839180963936315,22,0
7,1,1.5,5,55,-50,0,0.71322777699379,-5,0
7,1,1.5,25,77,-52,0,0.711333774424247,-27,0
7,1,1.5,78,47,31,0,1.39007838832003,3,0
7,1,1.5,48,76,-28,0,1.41749872163086,-26,0
7,1,1.5,85,0,85,0,0.6896940527879,50,0
7,1,1.5,93,12,81,0,0.913017372992499,38,0
7,1,1.5,29,70,-41,0,1.31108268254093,-20,0
7,1,1.5,86,26,60,0,0.853894215172886,24,0
7,1,1.5,88,35,53,0,1.06259812285907,15,0
7,1,10,71,39,32,0,1.74145197088819,11,0
7,1,10,86,28,58,0,1.18684681745617,22,0
7,1,10,41,62,-21,0,2.02238273367584,-12,0
7,1,10,12,93,-81,0,1.05703927846821,-43,0
7,1,10,48,86,-38,0,1.56978246645531,-36,0
7,1,10,84,24,60,0,1.43526649646174,26,0
7,1,10,30,90,-60,0,1.18867520623439,-40,0
7,1,10,92,47,45,0,1.89613300172095,3,0
7,1,10,87,47,40,0,2.76688299668081,3,0
7,1,10,23,70,-47,0,1.36317270173049,-20,0
7,1,1.5,78,25,53,0,0.510417747247629,25,0
7,1,1.5,16,66,-50,0,1.16507916725459,-16,0
7,1,1.5,60,50,10,1,1.30523022559782,0,0
7,1,1.5,88,34,54,0,0.696041362347614,16,0
7,1,1.5,51,6,45,0,1.21461391415573,44,0
7,1,10,89,18,71,0,0.830909594092418,32,0
7,1,10,84,18,66,0,0.968180243650977,32,0
7,1,10,48,68,-20,0,1.33225027812546,-18,0
7,1,10,82,33,49,0,0.969793096622652,17,0
7,1,10,63,25,38,0,1.37367347425015,25,0
7,1,1.5,91,38,53,0,0.657315296261004,12,0
7,1,1.5,94,24,70,0,0.674106561928966,26,0
7,1,1.5,42,95,-53,0,1.21814826150944,-45,0
7,1,1.5,81,12,69,0,0.780261612083223,38,0
7,1,1.5,24,87,-63,0,0.559587769442714,-37,0
7,1,10,76,26,50,0,1.00246033389726,24,0
7,1,10,21,57,-36,0,1.1652177259873,-7,0
7,1,10,80,49,31,1,1.5212154313374,-1,0
7,1,10,62,43,19,0,1.11939803928385,7,0
7,1,10,98,16,82,0,0.909399083972858,34,0
7,1,1.5,5,74,-69,0,0.763797315699549,-24,0
7,1,1.5,57,3,54,0,0.687712442977499,47,0
7,1,1.5,31,60,-29,0,1.06287084163432,-10,0
7,1,1.5,80,48,32,0,1.35916512865265,2,0
7,1,1.5,93,26,67,0,0.723956181717313,24,0
7,1,1.5,41,99,-58,0,0.776069294028503,-49,0
7,1,1.5,27,71,-44,0,0.820100913278111,-21,0
7,1,1.5,26,95,-69,0,0.646211170106426,-45,0
7,1,1.5,63,40,23,NaN,NaN,0,0
7,1,1.5,64,10,54,0,0.591678411779867,40,0
7,1,10,47,91,-44,1,1.53118506204896,41,0
7,1,10,91,39,52,0,1.38459652100278,11,0
7,1,10,55,7,48,0,1.94807749758547,43,0
7,1,10,91,13,78,0,1.33675526972229,37,0
7,1,10,100,25,75,0,1.12622004079776,25,0
7,1,1.5,83,34,49,0,0.48164628301538,16,0
7,1,1.5,20,72,-52,0,0.673034381260095,-22,0
7,1,1.5,48,87,-39,1,0.92915286730431,37,0
7,1,1.5,93,42,51,0,0.758607961262214,8,0
7,1,1.5,15,59,-44,0,0.731346347346289,-9,0
7,1,10,35,81,-46,0,1.00811191733396,-31,0
7,1,10,91,36,55,0,0.930092354160479,14,0
7,1,10,95,13,82,0,0.815656037110102,37,0
7,1,10,14,91,-77,0,0.873572487660795,-41,0
7,1,10,2,71,-69,0,0.945701838469176,-21,0
7,1,10,56,35,21,0,1.27653683811172,15,0
7,1,10,64,44,20,0,0.932648726120988,6,0
7,1,10,49,79,-30,1,1.41804635852623,29,0
7,1,10,49,62,-13,1,0.884086822807831,12,0
7,1,10,53,0,53,0,1.04289235855913,50,0
7,1,1.5,57,43,14,0,1.02766189469912,7,0
7,1,1.5,13,100,-87,0,0.629102465648884,-50,0
7,1,1.5,80,36,44,0,0.830335198500052,14,0
7,1,1.5,98,20,78,0,0.727858186236972,30,0
7,1,1.5,54,48,6,0,1.01398416838174,2,0
7,1,1.5,68,33,35,0,1.13347238080928,17,0
7,1,1.5,80,9,71,0,0.762169067312925,41,0
7,1,1.5,28,73,-45,0,1.03827043512206,-23,0
7,1,1.5,90,41,49,0,1.37567634439552,9,0
7,1,1.5,22,96,-74,0,1.27513328946861,-46,0
7,1,10,24,91,-67,0,0.921908225000379,-41,0
7,1,10,56,44,12,0,1.14333094460039,6,0
7,1,10,9,62,-53,0,1.54792537622552,-12,0
7,1,10,62,43,19,0,1.03215185743852,7,0
7,1,10,73,29,44,0,1.48092233196553,21,0
7,1,10,67,39,28,0,1.42170533542776,11,0
7,1,10,70,44,26,0,1.27979113554011,6,0
7,1,10,62,38,24,0,0.831237663049251,12,0
7,1,10,34,59,-25,0,0.607986554671243,-9,0
7,1,10,80,36,44,0,1.45803081648864,14,0
7,1,1.5,20,98,-78,0,0.664781339291039,-48,0
7,1,1.5,55,40,15,0,0.744279961951406,10,0
7,1,1.5,27,83,-56,0,1.24502828907453,-33,0
7,1,1.5,84,38,46,NaN,NaN,0,0
7,1,1.5,47,57,-10,0,0.709858013954772,-7,0
7,1,1.5,84,35,49,0,0.522638040970151,15,0
7,1,1.5,6,97,-91,0,0.528085818440559,-47,0
7,1,1.5,64,18,46,0,0.277369290179649,32,0
7,1,1.5,72,31,41,0,0.357431311707614,19,0
7,1,1.5,16,100,-84,0,0.601642177571421,-50,0
7,1,10,83,33,50,0,1.13103990528157,17,0
7,1,10,8,91,-83,0,0.919815914826586,-41,0
7,1,10,62,3,59,0,0.949073434295542,47,0
7,1,10,15,87,-72,0,1.28930366905729,-37,0
7,1,10,89,25,64,0,1.55205904508102,25,0
7,1,10,75,37,38,0,1.25869685145449,13,0
7,1,10,80,7,73,0,0.81957050458459,43,0
7,1,10,23,93,-70,0,0.90903802484172,-43,0
7,1,10,55,30,25,0,0.859023454181397,20,0
7,1,10,34,100,-66,0,0.747809177499903,-50,0
7,1,1.5,46,51,-5,0,0.606659249986706,-1,0
7,1,1.5,59,26,33,0,1.44124248328035,24,0
7,1,1.5,91,21,70,0,0.610803915567203,29,0
7,1,1.5,79,38,41,0,0.628874100330449,12,0
7,1,1.5,90,22,68,0,0.717582846575624,28,0
7,1,1.5,65,1,64,0,0.741759879182837,49,0
7,1,1.5,13,94,-81,0,0.770419543379376,-44,0
7,1,1.5,11,88,-77,0,0.613835346039423,-38,0
7,1,1.5,98,26,72,0,1.1193756792768,24,0
7,1,1.5,33,74,-41,0,0.572742784773936,-24,0
7,1,10,8,67,-59,0,0.927703865532067,-17,0
7,1,10,83,30,53,0,1.78810264342951,20,0
7,1,10,89,46,43,0,1.35086663355446,4,0
7,1,10,71,39,32,0,1.62711315813112,11,0
7,1,10,50,94,-44,1,1.3805075721616,44,0
7,1,10,25,75,-50,0,0.701358278792668,-25,0
7,1,10,56,14,42,0,0.899423954898793,36,0
7,1,10,8,57,-49,0,1.0894085045004,-7,0
7,1,10,6,55,-49,0,0.600911995044271,-5,0
7,1,10,59,26,33,0,1.05085325420578,24,0
7,1,1.5,44,94,-50,0,0.569766337925557,-44,0
7,1,1.5,75,39,36,0,0.485156071016945,11,0
7,1,1.5,49,57,-8,0,0.811798752604773,-7,0
7,1,1.5,83,24,59,0,0.829950313131576,26,0
7,1,1.5,71,43,28,0,0.74260039551541,7,0
7,1,1.5,84,32,52,0,0.993622266168359,18,0
7,1,1.5,64,40,24,0,1.35566780360568,10,0
7,1,1.5,31,86,-55,0,1.37572253063968,-36,0
7,1,1.5,57,46,11,NaN,NaN,0,0
7,1,1.5,47,83,-36,0,0.531258740105159,-33,0
7,1,10,51,38,13,1,1.05536411072239,-12,0
7,1,10,94,5,89,0,1.05543155730106,45,0
7,1,10,32,76,-44,0,1.00749573418716,-26,0
7,1,10,62,13,49,0,0.961545186458579,37,0
7,1,10,59,0,59,0,0.629577157603308,50,0
7,1,10,85,34,51,0,0.676470491205237,16,0
7,1,10,100,7,93,0,0.435905772730621,43,0
7,1,10,19,56,-37,0,0.65195512603168,-6,0
7,1,10,36,100,-64,0,0.555888471217031,-50,0
7,1,10,49,77,-28,0,1.02403517485709,-27,0
7,1,1.5,79,39,40,0,0.808978092691405,11,0
7,1,1.5,93,40,53,0,0.378928075921294,10,0
7,1,1.5,17,90,-73,0,0.565680688101565,-40,0
7,1,1.5,87,42,45,0,0.561122179110953,8,0
7,1,1.5,10,68,-58,0,0.757136232925177,-18,0
8,1,1.5,0,68,-68,1,1.36136718112812,18,0
8,1,1.5,100,0,100,NaN,NaN,0,0
8,1,1.5,48,80,-32,0,1.21321764821187,-30,0
8,1,1.5,48,100,-52,0,1.37490483286001,-50,0
8,1,1.5,53,23,30,1,0.81079031338777,-27,0
8,1,10,75,0,75,1,1.6520612368704,-50,0
8,1,10,53,40,13,1,1.48508794598365,-10,0
8,1,10,25,55,-30,1,1.27613957725134,5,0
8,1,10,100,15,85,0,0.724711566130281,35,0
8,1,10,53,0,53,1,1.12265958480202,-50,0
8,1,10,50,43,7,1,2.47185050373901,-7,0
8,1,10,3,100,-97,0,1.04786160305957,-50,0
8,1,10,28,85,-57,0,1.01644590822525,-35,0
8,1,10,80,45,35,1,1.38649130620524,-5,0
8,1,10,5,83,-78,1,1.03776774635753,33,0
8,1,1.5,50,100,-50,0,0.853688379619598,-50,0
8,1,1.5,98,38,60,1,0.862859981049041,-12,0
8,1,1.5,48,60,-12,0,1.00661963751281,-10,0
8,1,1.5,30,100,-70,0,0.937468086704939,-50,0
8,1,1.5,85,15,70,1,0.999399947582788,-35,0
8,1,1.5,49,97,-48,0,1.02200070012168,-47,0
8,1,1.5,49,96,-47,1,0.760014955490988,46,0
8,1,1.5,86,26,60,1,1.02862693564566,-24,0
8,1,1.5,51,36,15,1,1.38984822742623,-14,0
8,1,1.5,16,63,-47,0,0.857769249238117,-13,0
8,1,10,51,4,47,1,0.769699735529684,-46,0
8,1,10,11,65,-54,0,0.965623997697548,-15,0
8,1,10,51,2,49,1,1.23361136617314,-48,0
8,1,10,65,6,59,1,1.12310238463124,-44,0
8,1,10,100,35,65,1,0.696894719575539,-15,0
8,1,10,51,4,47,1,1.25393837091451,-46,0
8,1,10,49,100,-51,0,1.2467018194011,-50,0
8,1,10,27,70,-43,0,1.01509844781776,-20,0
8,1,10,51,24,27,1,0.785245748406851,-26,0
8,1,10,14,93,-79,0,0.788554284215934,-43,0
8,1,1.5,49,96,-47,0,0.751198913527332,-46,0
8,1,1.5,68,16,52,1,0.707642145892351,-34,0
8,1,1.5,30,93,-63,0,0.658615260832448,-43,0
8,1,1.5,50,8,42,1,0.603130756077007,-42,0
8,1,1.5,51,2,49,1,0.59766027209389,-48,0
8,1,10,67,38,29,1,0.740929109873832,-12,0
8,1,10,84,26,58,1,0.906115806084017,-24,0
8,1,10,70,20,50,1,1.47281051429673,-30,0
8,1,10,53,21,32,1,0.952783535763956,-29,0
8,1,10,51,2,49,1,0.565240946521044,-48,0
8,1,1.5,37,86,-49,0,0.591990015011106,-36,0
8,1,1.5,49,98,-49,0,1.25914530102455,-48,0
8,1,1.5,49,100,-51,0,0.76368711500163,-50,0
8,1,1.5,49,99,-50,0,1.00776769137428,-49,0
8,1,1.5,66,7,59,1,0.706374961282563,-43,0
8,1,10,41,65,-24,0,0.831618033829727,-15,0
8,1,10,73,9,64,1,1.07271337691691,-41,0
8,1,10,49,100,-51,0,1.20090649335907,-50,0
8,1,10,3,78,-75,0,0.955422740044014,-28,0
8,1,10,97,20,77,1,0.967934401111052,-30,0
8,1,1.5,51,0,51,1,0.786652957466686,-50,0
8,1,1.5,97,25,72,1,0.677966493101849,-25,0
8,1,1.5,51,3,48,1,0.797933722982634,-47,0
8,1,1.5,51,4,47,1,0.456408959365035,-46,0
8,1,1.5,34,85,-51,0,0.745284163491306,-35,0
8,1,10,49,99,-50,0,0.787813107681359,-49,0
8,1,10,49,96,-47,1,0.791121643491351,46,0
8,1,10,86,21,65,1,1.07405277308862,-29,0
8,1,10,10,98,-88,0,0.754255625261976,-48,0
8,1,10,40,93,-53,0,1.07088646106604,-43,0
8,1,1.5,49,98,-49,0,1.25341492873304,-48,0
8,1,1.5,49,100,-51,0,1.14208779386354,-50,0
8,1,1.5,2,54,-52,0,1.19534437033872,-4,0
8,1,1.5,92,12,80,1,1.23784069103203,-38,0
8,1,1.5,81,6,75,1,1.44718677318815,-44,0
8,1,1.5,72,29,43,1,0.734561296435459,-21,0
8,1,1.5,84,24,60,1,0.491778695389257,-26,0
8,1,1.5,49,98,-49,1,0.955084775273463,48,0
8,1,1.5,44,75,-31,0,0.943707238934621,-25,0
8,1,1.5,51,3,48,1,0.893115892225069,-47,0
8,1,10,51,4,47,1,0.626992095216337,-46,0
8,1,10,93,24,69,1,0.660806533496725,-26,0
8,1,10,92,41,51,1,1.39741724536725,-9,0
8,1,10,49,99,-50,0,1.03193913701671,-49,0
8,1,10,41,81,-40,0,0.79317509104385,-31,0
8,1,1.5,51,3,48,1,0.998538540629852,-47,0
8,1,1.5,56,33,23,1,0.681005610141256,-17,0
8,1,1.5,51,4,47,1,0.536548397325532,-46,0
8,1,1.5,19,72,-53,0,0.757866936452047,-22,0
8,1,1.5,3,68,-65,0,1.01819034894379,-18,0
8,1,10,7,88,-81,0,0.731588892615946,-38,0
8,1,10,49,99,-50,0,0.753008967795722,-49,0
8,1,10,49,97,-48,0,0.597406981794848,-47,0
8,1,10,52,47,5,0,0.944091023223336,3,0
8,1,10,94,28,66,1,0.940745831798267,-22,0
8,1,1.5,51,2,49,1,0.67266315872439,-48,0
8,1,1.5,15,61,-46,0,0.496575815725009,-11,0
8,1,1.5,75,6,69,1,0.887202608412736,-44,0
8,1,1.5,42,84,-42,0,0.574434174762246,-34,0
8,1,1.5,100,26,74,1,0.562617870712529,-24,0
8,1,10,49,100,-51,0,0.74977850844607,-50,0
8,1,10,49,97,-48,0,1.4822687626347,-47,0
8,1,10,13,69,-56,0,0.777697990722118,-19,0
8,1,10,51,3,48,1,1.37282206081545,-47,0
8,1,10,91,48,43,1,1.72086859145384,-2,0
8,1,1.5,49,98,-49,0,0.693215228941881,-48,0
8,1,1.5,51,1,50,1,1.14067655268627,-49,0
8,1,1.5,6,98,-92,0,0.810234980820496,-48,0
8,1,1.5,51,3,48,NaN,NaN,0,0
8,1,1.5,51,4,47,1,0.525373566536473,-46,0
8,1,10,3,63,-60,0,0.577795861215236,-13,0
8,1,10,95,10,85,1,0.901296692380129,-40,0
8,1,10,12,76,-64,0,0.883052826239691,-26,0
8,1,10,55,46,9,1,0.810360709579072,-4,0
8,1,10,79,31,48,1,0.556252623166984,-19,0
8,1,10,67,20,47,1,0.751558138554174,-30,0
8,1,10,51,3,48,1,0.764106821793575,-47,0
8,1,10,14,54,-40,0,0.519443054586191,-4,0
8,1,10,5,56,-51,0,0.580781094499798,-6,0
8,1,10,51,0,51,1,1.15201999930377,-50,0
8,1,1.5,51,4,47,1,0.611903177858039,-46,0
8,1,1.5,49,96,-47,1,0.678150504289079,46,0
8,1,1.5,4,74,-70,0,0.685449370347669,-24,0
8,1,1.5,64,27,37,1,0.875968762084085,-23,0
8,1,1.5,78,3,75,1,0.803070274311722,-47,0
8,1,1.5,92,4,88,1,0.598383487378669,-46,0
8,1,1.5,2,54,-52,0,0.449154446600915,-4,0
8,1,1.5,62,32,30,1,0.857649018820666,-18,0
8,1,1.5,23,56,-33,0,1.12153425742144,-6,0
8,1,1.5,51,1,50,1,0.758938013522311,-49,0
8,1,10,49,98,-49,0,1.20216707995951,-48,0
8,1,10,51,2,49,1,0.787968160932905,-48,0
8,1,10,16,98,-82,0,0.687537274178794,-48,0
8,1,10,51,0,51,1,1.42247722311731,-50,0
8,1,10,11,84,-73,0,0.775893434796671,-34,0
8,1,10,49,98,-49,0,0.72177288547573,-48,0
8,1,10,84,44,40,1,0.847038317947408,-6,0
8,1,10,49,96,-47,0,0.759734540036334,-46,0
8,1,10,5,53,-48,0,0.603455524826131,-3,0
8,1,10,18,61,-43,0,0.7423040619924,-11,0
8,1,1.5,51,2,49,1,0.602185774321697,-48,0
8,1,1.5,53,27,26,1,0.676823937583322,-23,0
8,1,1.5,2,97,-95,0,0.572103610761587,-47,0
8,1,1.5,51,4,47,1,0.607351283588287,-46,0
8,1,1.5,56,11,45,1,0.649375479959417,-39,0
8,1,1.5,51,1,50,1,0.544747891844054,-49,0
8,1,1.5,31,65,-34,0,0.708451135315954,-15,0
8,1,1.5,51,2,49,1,0.546522023610123,-48,0
8,1,1.5,51,4,47,1,0.582499509731861,-46,0
8,1,1.5,7,62,-55,0,0.641292183740006,-12,0
8,1,10,32,65,-33,0,0.576921624796341,-15,0
8,1,10,24,79,-55,0,0.540465782900355,-29,0
8,1,10,80,32,48,1,0.568871685186423,-18,0
8,1,10,49,98,-49,0,0.756191408290761,-48,0
8,1,10,96,5,91,1,0.760100729629812,-45,0
8,1,1.5,16,82,-66,0,0.810514296606925,-32,0
8,1,1.5,51,2,49,1,0.956024625242208,-48,0
8,1,1.5,53,48,5,1,1.13583617872609,-2,0
8,1,1.5,36,60,-24,0,0.660527950823052,-10,0
8,1,1.5,56,2,54,1,1.11653773054059,-48,0
8,1,10,49,97,-48,0,0.760699315822421,-47,0
8,1,10,63,22,41,1,0.955860408086664,-28,0
8,1,10,51,1,50,1,0.799734613347027,-49,0
8,1,10,51,3,48,1,0.801654634461556,-47,0
8,1,10,46,57,-11,0,0.859567573709683,-7,0
8,1,10,35,54,-19,0,0.645463592726628,-4,0
8,1,10,49,99,-50,0,0.653480175727054,-49,0
8,1,10,78,37,41,1,0.725363669519538,-13,0
8,1,10,5,78,-73,0,0.850780123126242,-28,0
8,1,10,28,91,-63,0,0.874636330479007,-41,0
8,1,1.5,49,96,-47,0,0.665897998420405,-46,0
8,1,1.5,9,74,-65,0,0.593741786850842,-24,0
8,1,1.5,49,100,-51,0,0.676586042641247,-50,0
8,1,1.5,50,75,-25,1,0.707181751368807,25,0
8,1,1.5,51,1,50,1,1.27301835163325,-49,0
8,1,1.5,33,62,-29,0,0.638962352851195,-12,0
8,1,1.5,49,100,-51,0,1.38276343015968,-50,0
8,1,1.5,92,10,82,1,0.497408264741352,-40,0
8,1,1.5,43,96,-53,NaN,NaN,0,0
8,1,1.5,46,54,-8,NaN,NaN,0,0
8,1,10,49,96,-47,0,0.758443895831988,-46,0
8,1,10,49,98,-49,0,0.738529266758633,-48,0
8,1,10,57,40,17,0,0.967096087196296,10,0
8,1,10,51,0,51,1,1.32245211402096,-50,0
8,1,10,14,73,-59,0,0.767813071025557,-23,0
8,1,10,99,36,63,1,0.793669575289641,-14,0
8,1,10,93,29,64,1,1.21232288465035,-21,0
8,1,10,51,2,49,1,0.605662559405573,-48,0
8,1,10,18,59,-41,0,0.727601128260176,-9,0
8,1,10,49,98,-49,0,0.844977539271895,-48,0
8,1,1.5,49,100,-51,0,0.611917840104979,-50,0
8,1,1.5,21,85,-64,0,0.853445719449155,-35,0
8,1,1.5,97,29,68,1,1.02125219246409,-21,0
8,1,1.5,49,99,-50,0,0.734033822135643,-49,0
8,1,1.5,85,10,75,1,0.666678763019263,-40,0
8,1,1.5,51,2,49,1,0.616537180706473,-48,0
8,1,1.5,51,42,9,1,0.697785817576005,-8,0
8,1,1.5,51,1,50,1,0.519594442275775,-49,0
8,1,1.5,49,100,-51,0,0.628992392126747,-50,0
8,1,1.5,36,73,-37,0,0.725890777263885,-23,0
8,1,10,51,4,47,1,0.618200612515466,-46,0
8,1,10,59,30,29,1,0.771517487478377,-20,0
8,1,10,95,6,89,1,0.614911504181691,-44,0
8,1,10,33,85,-52,0,0.656064396584043,-35,0
8,1,10,87,30,57,1,0.687944884617536,-20,0
9,1,1.5,80,45,35,0,1.14097068089904,5,0
9,1,1.5,85,15,70,0,0.810424528561271,35,0
9,1,1.5,50,43,7,1,1.44500886152764,-7,0
9,1,1.5,100,15,85,0,0.693957849553954,35,0
9,1,1.5,53,0,53,0,0.58929542151418,50,0
9,1,10,3,100,-97,0,1.2560796309499,-50,0
9,1,10,75,0,75,0,0.833341703062615,50,0
9,1,10,30,100,-70,0,0.723352461524883,-50,0
9,1,10,48,80,-32,0,1.1703462318801,-30,0
9,1,10,48,100,-52,0,0.663106904659799,-50,0
9,1,1.5,25,55,-30,NaN,NaN,0,0
9,1,1.5,53,23,30,0,0.743320314432822,27,0
9,1,1.5,50,100,-50,0,0.43676608316764,-50,0
9,1,1.5,100,0,100,0,0.654831869242116,50,0
9,1,1.5,0,68,-68,0,0.448084278898932,-18,0
9,1,10,5,83,-78,0,1.00029581189756,-33,0
9,1,10,28,85,-57,0,0.635128670844097,-35,0
9,1,10,53,40,13,0,1.16449377493791,10,0
9,1,10,98,38,60,0,0.888380677288296,12,0
9,1,10,48,60,-12,1,0.831761840265244,10,0
9,1,1.5,99,22,77,0,0.559346208054194,28,0
9,1,1.5,93,47,46,0,0.444050680238433,3,0
9,1,1.5,9,77,-68,0,0.501588476899087,-27,0
9,1,1.5,52,44,8,0,0.684195323826316,6,0
9,1,1.5,40,77,-37,0,0.771708726084398,-27,0
9,1,10,90,43,47,0,0.903188866916025,7,0
9,1,10,15,72,-57,0,0.646564531531112,-22,0
9,1,10,78,37,41,0,0.599319669291617,13,0
9,1,10,79,49,30,0,0.818070184763201,1,0
9,1,10,7,82,-75,0,0.444145985187788,-32,0
9,1,10,92,8,84,0,0.619602395086076,42,0
9,1,10,52,21,31,0,0.845680028297465,29,0
9,1,10,70,19,51,0,0.774450576136587,31,0
9,1,10,77,29,48,0,0.682465905571007,21,0
9,1,10,26,77,-51,0,0.689887228586485,-27,0
9,1,1.5,16,96,-80,0,0.744744390296546,-46,0
9,1,1.5,61,44,17,1,1.20539316040413,-6,0
9,1,1.5,95,6,89,0,0.680162458281302,44,0
9,1,1.5,61,36,25,0,0.91146500200648,14,0
9,1,1.5,16,95,-79,0,0.717669354144164,-45,0
9,1,1.5,77,25,52,0,0.729334313264189,25,0
9,1,1.5,96,45,51,0,0.454710905269167,5,0
9,1,1.5,11,51,-40,0,0.495465500524915,-1,0
9,1,1.5,75,36,39,0,0.542229439332004,14,0
9,1,1.5,0,94,-94,0,0.403466534216932,-44,0
9,1,10,100,2,98,0,0.781066572339114,48,0
9,1,10,79,47,32,0,1.23236189488216,3,0
9,1,10,77,29,48,0,0.473751734275538,21,0
9,1,10,53,49,4,0,0.730026740369794,1,0
9,1,10,40,76,-36,1,0.919284773019172,26,0
9,1,10,6,62,-56,0,0.692151087667298,-12,0
9,1,10,41,98,-57,0,0.828260116528327,-48,0
9,1,10,14,58,-44,0,0.637573975884152,-8,0
9,1,10,41,89,-48,0,0.567087902319145,-39,0
9,1,10,70,31,39,0,0.52317871327341,19,0
9,1,1.5,89,33,56,0,0.720595582615715,17,0
9,1,1.5,31,52,-21,0,1.10268228445966,-2,0
9,1,1.5,100,0,100,0,0.501234748917341,50,0
9,1,1.5,71,4,67,0,0.756209942138412,46,0
9,1,1.5,21,84,-63,0,0.720944545349994,-34,0
9,1,10,100,32,68,0,0.717044007059485,18,0
9,1,10,13,53,-40,0,0.83504949442613,-3,0
9,1,10,15,60,-45,0,0.70052069491885,-10,0
9,1,10,64,45,19,1,1.10726535280264,-5,0
9,1,10,73,36,37,0,0.721848476128798,14,0
9,1,1.5,6,96,-90,0,0.68731179563747,-46,0
9,1,1.5,2,90,-88,0,0.598902526864549,-40,0
9,1,1.5,74,40,34,0,0.73757562539322,10,0
9,1,1.5,72,33,39,0,0.582978902783907,17,0
9,1,1.5,80,23,57,0,0.858388210044723,27,0
9,1,10,53,40,13,0,0.993212088333166,10,0
9,1,10,18,75,-57,0,0.604628521471568,-25,0
9,1,10,76,46,30,0,0.783363055036716,4,0
9,1,10,77,40,37,0,0.506678494254629,10,0
9,1,10,94,42,52,0,0.769421773881731,8,0
9,1,1.5,63,43,20,0,0.756286919212471,7,0
9,1,1.5,57,5,52,0,0.561000848580989,45,0
9,1,1.5,21,81,-60,0,0.541606658150158,-31,0
9,1,1.5,24,82,-58,0,0.44317900652004,-32,0
9,1,1.5,49,90,-41,0,0.468559080820341,-40,0
9,1,1.5,21,82,-61,0,0.601575097549357,-32,0
9,1,1.5,15,55,-40,0,0.756332005784316,-5,0
9,1,1.5,83,20,63,0,0.633035994113015,30,0
9,1,1.5,79,47,32,0,0.786328505159872,3,0
9,1,1.5,76,4,72,0,0.669875755337671,46,0
9,1,10,17,74,-57,0,0.869265803667986,-24,0
9,1,10,46,51,-5,1,0.989394025479669,1,0
9,1,10,54,15,39,0,0.712672442391522,35,0
9,1,10,79,30,49,0,0.65490664697063,20,0
9,1,10,19,91,-72,0,0.871484576176954,-41,0
9,1,10,18,54,-36,0,1.16638557816168,-4,0
9,1,10,47,66,-19,1,0.826457753331852,16,0
9,1,10,70,43,27,0,0.972614856208565,7,0
9,1,10,96,34,62,0,1.04863154923623,16,0
9,1,10,23,88,-65,0,0.72137818286501,-38,0
9,1,1.5,55,2,53,0,0.814864639481129,48,0
9,1,1.5,71,19,52,0,0.640970131063114,31,0
9,1,1.5,98,4,94,0,0.618322742876444,46,0
9,1,1.5,80,30,50,0,0.660455960866784,20,0
9,1,1.5,64,37,27,0,0.853137640506247,13,0
9,1,1.5,71,38,33,0,0.531901315391224,12,0
9,1,1.5,87,35,52,0,0.465370763740793,15,0
9,1,1.5,92,26,66,0,0.505319665626303,24,0
9,1,1.5,79,43,36,0,0.464202911565735,7,0
9,1,1.5,3,53,-50,0,0.800109234132833,-3,0
9,1,10,48,78,-30,0,0.978379705910811,-28,0
9,1,10,10,54,-44,0,0.653782415137357,-4,0
9,1,10,14,69,-55,0,0.566571789368936,-19,0
9,1,10,57,32,25,0,0.617894970281668,18,0
9,1,10,66,28,38,0,0.9559350240188,22,0
9,1,1.5,0,65,-65,0,0.695679936658962,-15,0
9,1,1.5,38,73,-35,0,0.542209645226649,-23,0
9,1,1.5,95,17,78,0,0.627589316315607,33,0
9,1,1.5,86,29,57,0,0.917035209679852,21,0
9,1,1.5,81,36,45,0,0.523075344060089,14,0
9,1,10,71,25,46,0,0.575828099197679,25,0
9,1,10,25,82,-57,0,0.843906989702191,-32,0
9,1,10,78,21,57,0,0.509369026258355,29,0
9,1,10,56,49,7,1,1.27606397894488,-1,0
9,1,10,19,71,-52,0,1.00418058821469,-21,0
9,1,10,15,94,-79,0,0.93590962158396,-44,0
9,1,10,96,27,69,0,1.17350009255551,23,0
9,1,10,30,94,-64,0,0.952765767929122,-44,0
9,1,10,78,28,50,0,0.532768223863968,22,0
9,1,10,56,33,23,0,1.45023670450155,17,0
9,1,1.5,97,24,73,0,0.865728890411447,26,0
9,1,1.5,29,93,-64,0,0.889119290637609,-43,0
9,1,1.5,23,76,-53,0,1.44773311682002,-26,0
9,1,1.5,100,49,51,0,0.479946189360817,1,0
9,1,1.5,97,40,57,0,0.759320915587523,10,0
9,1,10,62,48,14,0,0.99415597387906,2,0
9,1,10,25,84,-59,0,0.661524842517792,-34,0
9,1,10,74,31,43,0,0.541015034355951,19,0
9,1,10,82,38,44,0,0.778361744593894,12,0
9,1,10,94,8,86,0,0.965784057314522,42,0
9,1,1.5,80,43,37,0,0.537248289550917,7,0
9,1,1.5,91,34,57,0,0.358014504679886,16,0
9,1,1.5,70,33,37,0,0.506082838327529,17,0
9,1,1.5,2,73,-71,0,0.63196967836393,-23,0
9,1,1.5,0,52,-52,0,0.488892758106886,-2,0
9,1,1.5,59,48,11,0,0.942204879979727,2,0
9,1,1.5,3,78,-75,0,0.467087352483759,-28,0
9,1,1.5,62,26,36,0,0.786999671930971,24,0
9,1,1.5,68,33,35,0,1.00585062415576,17,0
9,1,1.5,78,42,36,0,0.752634540345753,8,0
9,1,10,49,67,-18,0,1.01986668304016,-17,0
9,1,10,100,27,73,0,0.54942936162206,23,0
9,1,10,35,99,-64,0,0.585640110187342,-49,0
9,1,10,53,18,35,0,0.844283077690307,32,0
9,1,10,44,58,-14,1,0.828933849202258,8,0
9,1,10,12,91,-79,0,0.95631184512149,-41,0
9,1,10,77,2,75,0,0.70465766279267,48,0
9,1,10,99,26,73,0,0.734682387095745,24,0
9,1,10,76,36,40,0,0.563920845575012,14,0
9,1,10,93,32,61,0,0.719995161441148,18,0
9,1,1.5,40,56,-16,1,1.03695925896773,6,0
9,1,1.5,97,41,56,0,0.877685995854335,9,0
9,1,1.5,78,25,53,0,1.22106532604357,25,0
9,1,1.5,72,7,65,0,0.999174145967118,43,0
9,1,1.5,50,21,29,NaN,NaN,0,0
9,1,10,27,95,-68,0,0.43011966269296,-45,0
9,1,10,78,25,53,0,0.463539075944936,25,0
9,1,10,71,25,46,0,0.607006013376122,25,0
9,1,10,25,94,-69,0,0.537052181291983,-44,0
9,1,10,23,85,-62,0,0.533743266797501,-35,0
9,1,1.5,53,23,30,0,0.738454630262822,27,0
9,1,1.5,19,60,-41,0,0.599188808266263,-10,0
9,1,1.5,53,28,25,0,0.466036432149849,22,0
9,1,1.5,95,19,76,0,0.313344708833938,31,0
9,1,1.5,22,61,-39,0,0.254869258105828,-11,0
9,1,1.5,86,9,77,0,0.421533419962543,41,0
9,1,1.5,80,4,76,0,0.247037757255384,46,0
9,1,1.5,100,26,74,0,0.198989400990286,24,0
9,1,1.5,15,95,-80,0,0.233195813179918,-45,0
9,1,1.5,44,91,-47,0,0.345907477223591,-41,0
9,1,10,6,86,-80,0,0.565281873548884,-36,0
9,1,10,87,44,43,0,0.320761999717433,6,0
9,1,10,96,49,47,0,0.550029782796628,1,0
9,1,10,3,93,-90,0,0.890235091648719,-43,0
9,1,10,89,23,66,0,0.536974837660637,27,0
9,1,1.5,41,78,-37,0,0.595750865533773,-28,0
9,1,1.5,44,50,-6,0,0.477863776238337,0,0
9,1,1.5,47,56,-9,1,1.3332113918741,6,0
9,1,1.5,76,32,44,0,0.809872126417758,18,0
9,1,1.5,6,76,-70,0,0.947838868656618,-26,0
9,1,10,83,48,35,0,0.815402012767663,2,0
9,1,10,67,9,58,0,0.592949266610049,41,0
9,1,10,12,72,-60,0,0.659707450464339,-22,0
9,1,10,40,100,-60,0,0.619721159714572,-50,0
9,1,10,48,57,-9,1,1.05300861226806,7,0
9,1,1.5,16,82,-66,0,0.643977368740707,-32,0
9,1,1.5,13,64,-51,0,0.732678783834672,-14,0
9,1,1.5,0,63,-63,0,0.441434192849556,-13,0
9,1,1.5,64,39,25,0,1.05803411550551,11,0
9,1,1.5,74,42,32,0,0.633493091308083,8,0
9,1,10,12,79,-67,0,0.577826570653087,-29,0
9,1,10,85,50,35,0,0.748350582917737,0,0
9,1,10,14,51,-37,0,0.672417098441656,-1,0
9,1,10,94,47,47,0,0.623877188577353,3,0
9,1,10,75,6,69,0,0.53736008958731,44,0
10,1,10,5,83,-78,0,2.80224634504327,-33,0
10,1,10,85,15,70,0,1.57286197305359,35,0
10,1,10,80,45,35,1,1.36087227775181,-5,0
10,1,10,100,0,100,0,1.43673600002353,50,0
10,1,10,100,15,85,0,0.878867011036391,35,0
10,1,1.5,30,100,-70,0,0.829958549541857,-50,0
10,1,1.5,50,43,7,1,1.11195949086459,-7,0
10,1,1.5,75,0,75,0,0.942611936031199,50,0
10,1,1.5,53,0,53,0,1.48449310063211,50,0
10,1,1.5,50,100,-50,NaN,NaN,0,0
10,1,1.5,53,40,13,1,1.16441367469236,-10,0
10,1,1.5,48,80,-32,0,1.46433823691132,-30,0
10,1,1.5,98,38,60,1,1.39237469923864,-12,0
10,1,1.5,3,100,-97,0,0.931669425631981,-50,0
10,1,1.5,28,85,-57,0,0.952739952992488,-35,0
10,1,10,48,60,-12,1,2.54066712217696,10,0
10,1,10,25,55,-30,0,1.6423560047449,-5,0
10,1,10,53,23,30,0,1.39518620448985,27,0
10,1,10,0,68,-68,0,1.40664226363197,-18,0
10,1,10,48,100,-52,0,1.67337090315664,-50,0
10,1,10,24,53,-29,0,0.889287541842805,-3,0
10,1,10,15,76,-61,0,0.873128167983623,-26,0
10,1,10,27,72,-45,0,1.36101413596998,-22,0
10,1,10,100,23,77,0,0.637686413428355,27,0
10,1,10,84,20,64,0,0.862955064301786,30,0
10,1,1.5,94,22,72,0,0.958428210944248,28,0
10,1,1.5,40,84,-44,1,1.22680416527965,34,0
10,1,1.5,94,14,80,NaN,NaN,0,0
10,1,1.5,58,39,19,1,1.47788954559928,-11,0
10,1,1.5,67,18,49,NaN,NaN,0,0
10,1,10,76,31,45,0,1.96392475869447,19,0
10,1,10,28,99,-71,0,1.1758832965063,-49,0
10,1,10,71,48,23,1,1.26051950165606,-2,0
10,1,10,86,24,62,0,1.15710266136261,26,0
10,1,10,100,14,86,0,0.794406020946781,36,0
10,1,1.5,14,88,-74,0,0.533028771925729,-38,0
10,1,1.5,95,24,71,0,0.722379801735769,26,0
10,1,1.5,55,21,34,0,1.16829736414957,29,0
10,1,1.5,78,50,28,1,0.924906784121731,0,0
10,1,1.5,47,87,-40,0,1.10703770716077,-37,0
10,1,1.5,23,78,-55,0,0.52691054061529,-28,0
10,1,1.5,93,14,79,0,0.741401265947161,36,0
10,1,1.5,3,65,-62,0,0.666769547475951,-15,0
10,1,1.5,66,9,57,0,0.930867395189807,41,0
10,1,1.5,13,59,-46,0,0.584054109929639,-9,0
10,1,10,88,23,65,0,1.99398770415496,27,0
10,1,10,75,28,47,0,1.23733246434495,22,0
10,1,10,88,20,68,0,1.07864260379847,30,0
10,1,10,94,50,44,1,1.10190038693941,0,0
10,1,10,87,37,50,1,1.46053079166404,-13,0
10,1,1.5,41,81,-40,0,1.25912144676317,-31,0
10,1,1.5,73,5,68,0,0.579695360393089,45,0
10,1,1.5,91,20,71,0,0.607050170156526,30,0
10,1,1.5,36,55,-19,0,0.641673838998713,-5,0
10,1,1.5,81,0,81,0,0.867620256913597,50,0
10,1,10,82,33,49,0,1.53116702027364,17,0
10,1,10,42,94,-52,0,1.74419334358731,-44,0
10,1,10,99,12,87,0,1.44543810363075,38,0
10,1,10,78,1,77,0,0.830654277960093,49,0
10,1,10,27,83,-56,0,0.736004055605463,-33,0
10,1,10,3,87,-84,0,0.764008040831641,-37,0
10,1,10,90,32,58,1,1.60794640618519,-18,0
10,1,10,83,34,49,1,1.98646848548196,-16,0
10,1,10,62,0,62,0,0.685597835250974,50,0
10,1,10,35,52,-17,0,1.2531197811204,-2,0
10,1,1.5,29,59,-30,0,1.08440673940163,-9,0
10,1,1.5,12,76,-64,0,0.587589935177675,-26,0
10,1,1.5,92,34,58,0,0.734964861682784,16,0
10,1,1.5,66,41,25,1,1.36428383959969,-9,0
10,1,1.5,55,46,9,NaN,NaN,0,0
10,1,1.5,46,74,-28,0,0.647444939217394,-24,0
10,1,1.5,29,57,-28,0,0.663950711050575,-7,0
10,1,1.5,86,23,63,0,0.887997621767227,27,0
10,1,1.5,5,51,-46,0,0.711206359353582,-1,0
10,1,1.5,79,27,52,0,1.00596684256607,23,0
10,1,10,83,22,61,0,0.879876513704176,28,0
10,1,10,93,32,61,0,0.9271915445172,18,0
10,1,10,54,33,21,0,0.797128818991951,17,0
10,1,10,16,94,-78,0,0.607745898574649,-44,0
10,1,10,25,53,-28,0,0.618366936991606,-3,0
10,1,1.5,79,22,57,0,0.64105692070143,28,0
10,1,1.5,35,68,-33,0,0.650346984468115,-18,0
10,1,1.5,99,25,74,0,1.01090878699847,25,0
10,1,1.5,42,77,-35,0,0.581626391639929,-27,0
10,1,1.5,49,72,-23,0,0.560912892456145,-22,0
10,1,10,95,27,68,1,1.82012487921884,-23,0
10,1,10,81,37,44,1,2.63735724371327,-13,0
10,1,10,18,63,-45,0,0.806713962514095,-13,0
10,1,10,90,41,49,0,1.49666908106678,9,0
10,1,10,93,17,76,0,0.82329597855778,33,0
10,1,1.5,65,34,31,0,0.751171888173303,16,0
10,1,1.5,50,28,22,0,0.643744895670125,22,0
10,1,1.5,96,14,82,0,0.908477623057479,36,0
10,1,1.5,91,23,68,0,0.747114083332008,27,0
10,1,1.5,59,46,13,0,0.83101167269524,4,0
10,1,10,11,78,-67,0,2.71897337170958,-28,0
10,1,10,100,15,85,0,0.828806822097249,35,0
10,1,10,71,17,54,0,0.846837478134603,33,0
10,1,10,33,53,-20,0,1.17545955464584,-3,0
10,1,10,18,76,-58,0,0.603358557459615,-26,0
10,1,10,84,20,64,0,1.4920042550134,30,0
10,1,10,99,17,82,0,0.779318098176191,33,0
10,1,10,87,15,72,0,0.806518220166936,35,0
10,1,10,75,24,51,0,0.825251569237707,26,0
10,1,10,93,15,78,0,0.843251434344211,35,0
10,1,1.5,100,25,75,0,0.539724333192908,25,0
10,1,1.5,2,95,-93,0,0.568411950400105,-45,0
10,1,1.5,92,2,90,0,0.716410026700032,48,0
10,1,1.5,44,60,-16,0,0.666313915008232,-10,0
10,1,1.5,32,92,-60,0,0.626517003192021,-42,0
10,1,10,83,12,71,0,1.01827368445743,38,0
10,1,10,24,94,-70,0,1.18753656423064,-44,0
10,1,10,94,24,70,0,1.09409268656736,26,0
10,1,10,75,26,49,0,0.99668410997333,24,0
10,1,10,8,92,-84,0,0.678572004592297,-42,0
10,1,1.5,32,58,-26,0,0.509356044333117,-8,0
10,1,1.5,33,88,-55,0,0.643927075345346,-38,0
10,1,1.5,97,6,91,0,0.71728133673696,44,0
10,1,1.5,3,64,-61,0,0.610953287225129,-14,0
10,1,1.5,44,64,-20,1,1.2771777619098,14,0
10,1,10,34,64,-30,0,1.00181409902052,-14,0
10,1,10,21,88,-67,0,0.572446662043149,-38,0
10,1,10,80,40,40,1,1.03242175071364,-10,0
10,1,10,0,64,-64,0,0.705088494602023,-14,0
10,1,10,75,16,59,0,0.791636669946001,34,0
10,1,1.5,100,1,99,0,0.665608656063796,49,0
10,1,1.5,2,86,-84,0,0.472890784567653,-36,0
10,1,1.5,87,21,66,NaN,NaN,0,0
10,1,1.5,87,15,72,0,0.552148107310813,35,0
10,1,1.5,68,31,37,1,1.02031688266743,-19,0
10,1,1.5,98,7,91,0,0.595330188748221,43,0
10,1,1.5,48,86,-38,0,0.614646732715528,-36,0
10,1,1.5,26,76,-50,0,0.672637419192142,-26,0
10,1,1.5,99,8,91,0,0.752562978450669,42,0
10,1,1.5,81,27,54,0,0.636565843473591,23,0
10,1,10,6,91,-85,0,1.28442572714266,-41,0
10,1,10,8,97,-89,0,0.659040290666326,-47,0
10,1,10,24,80,-56,0,0.715720529780128,-30,0
10,1,10,64,12,52,0,1.04170704921717,38,0
10,1,10,91,11,80,0,0.954284264807939,39,0
10,1,1.5,8,57,-49,0,0.477578703819063,-7,0
10,1,1.5,35,63,-28,0,0.740747325221264,-13,0
10,1,1.5,88,15,73,0,0.673404259998506,35,0
10,1,1.5,35,65,-30,0,0.744783136540264,-15,0
10,1,1.5,64,31,33,0,0.709988651342428,19,0
10,1,10,0,86,-86,0,0.987218831146947,-36,0
10,1,10,62,20,42,0,0.789968461289163,30,0
10,1,10,94,25,69,1,1.28919172339783,-25,0
10,1,10,75,28,47,0,1.94452793837104,22,0
10,1,10,21,94,-73,0,1.12510355283348,-44,0
10,1,1.5,59,46,13,0,0.68103601219309,4,0
10,1,1.5,98,6,92,0,0.759678249433136,44,0
10,1,1.5,47,83,-36,0,0.923621995868189,-33,0
10,1,1.5,98,18,80,0,0.705787888607347,32,0
10,1,1.5,29,96,-67,0,0.879628353462294,-46,0
10,1,10,52,1,51,0,0.852880931469599,49,0
10,1,10,96,21,75,0,1.02879355267214,29,0
10,1,10,28,54,-26,0,0.925383310435564,-4,0
10,1,10,22,63,-41,0,1.05861603562357,-13,0
10,1,10,24,72,-48,0,1.90663309966453,-22,0
10,1,10,6,84,-78,0,0.621980839243406,-34,0
10,1,10,79,16,63,0,2.49587548147497,34,0
10,1,10,89,16,73,0,2.39763041792094,34,0
10,1,10,96,11,85,0,1.48785517705505,39,0
10,1,10,95,5,90,0,1.29508268831205,45,0
10,1,1.5,75,26,49,0,0.692998288904164,24,0
10,1,1.5,55,2,53,0,0.715588568646808,48,0
10,1,1.5,76,5,71,0,0.673037701295698,45,0
10,1,1.5,29,77,-48,0,0.848909634482425,-27,0
10,1,1.5,45,73,-28,1,1.16099258231793,23,0
10,1,1.5,25,94,-69,0,0.651644602276519,-44,0
10,1,1.5,35,68,-33,0,0.611511922688351,-18,0
10,1,1.5,90,41,49,1,0.853404743856117,-9,0
10,1,1.5,27,79,-52,0,1.06198324386878,-29,0
10,1,1.5,94,21,73,0,1.07734608566625,29,0
10,1,10,90,11,79,0,0.827958971817679,39,0
10,1,10,90,23,67,0,1.98051703838155,27,0
10,1,10,49,73,-24,0,1.59114812050711,-23,0
10,1,10,49,71,-22,1,1.17044503159013,21,0
10,1,10,93,2,91,0,0.83835750910157,48,0
10,1,10,96,11,85,0,1.49361271460157,39,0
10,1,10,69,8,61,0,1.45287301380176,42,0
10,1,10,30,82,-52,0,1.47694309102826,-32,0
10,1,10,48,60,-12,1,1.23617963722427,10,0
10,1,10,26,62,-36,0,0.765372738882434,-12,0
10,1,1.5,73,20,53,0,0.776028600376321,30,0
10,1,1.5,91,21,70,1,0.876186367241644,-29,0
10,1,1.5,96,33,63,0,1.37124625560273,17,0
10,1,1.5,16,81,-65,0,0.830438008325018,-31,0
10,1,1.5,21,73,-52,0,0.735110752046239,-23,0
10,1,1.5,99,10,89,0,0.922516088261546,40,0
10,1,1.5,54,24,30,0,0.695756643143341,26,0
10,1,1.5,5,79,-74,0,0.589663924318756,-29,0
10,1,1.5,91,17,74,0,0.801113312092184,33,0
10,1,1.5,38,71,-33,0,0.746976623818227,-21,0
10,1,10,97,4,93,0,0.686223917515235,46,0
10,1,10,36,53,-17,0,0.956857506902452,-3,0
10,1,10,57,36,21,1,1.12937542795726,-14,0
10,1,10,82,18,64,0,1.16604559403777,32,0
10,1,10,98,21,77,1,1.00934468101332,-29,0
11,1,1.5,80,45,35,1,1.13466429871369,-5,0
11,1,1.5,5,83,-78,0,0.723694006257574,-33,0
11,1,1.5,100,0,100,1,0.433208887521687,-50,0
11,1,1.5,48,100,-52,0,0.714555394881245,-50,0
11,1,1.5,28,85,-57,0,0.78511268852526,-35,0
11,1,10,30,100,-70,0,1.42048205799438,-50,0
11,1,10,0,68,-68,0,1.47831362177567,-18,0
11,1,10,48,60,-12,0,1.38957917521293,-10,0
11,1,10,3,100,-97,0,1.72089095137744,-50,0
11,1,10,53,40,13,1,1.31087443802426,-10,0
11,1,1.5,25,55,-30,0,0.620074080998165,-5,0
11,1,1.5,98,38,60,1,0.781979733110347,-12,0
11,1,1.5,48,80,-32,0,0.673197231035374,-30,0
11,1,1.5,53,0,53,1,0.553234766384776,-50,0
11,1,1.5,50,100,-50,0,0.789820369158406,-50,0
11,1,10,75,0,75,1,0.968444647272918,-50,0
11,1,10,53,23,30,1,0.956191774846957,-27,0
11,1,10,100,15,85,1,0.729062954185792,-35,0
11,1,10,85,15,70,1,0.710265954814531,-35,0
11,1,10,50,43,7,1,0.701519925076354,-7,0
11,1,1.5,49,99,-50,0,0.608956432968625,-49,0
11,1,1.5,34,87,-53,0,0.643447900458341,-37,0
11,1,1.5,76,47,29,0,1.11743432688309,3,0
11,1,1.5,51,4,47,NaN,NaN,0,0
11,1,1.5,94,33,61,1,0.531275120551072,-17,0
11,1,10,64,12,52,1,0.904542547088568,-38,0
11,1,10,49,98,-49,0,3.33507190915225,-48,0
11,1,10,96,44,52,1,0.812418555806289,-6,0
11,1,10,51,2,49,1,0.710447766665311,-48,0
11,1,10,16,67,-51,0,0.964984723772432,-17,0
11,1,1.5,88,12,76,1,0.486926958190452,-38,0
11,1,1.5,24,72,-48,0,0.878224915188184,-22,0
11,1,1.5,94,0,94,1,0.677539821743267,-50,0
11,1,1.5,77,46,31,1,0.604744336249496,-4,0
11,1,1.5,51,2,49,1,0.567447981100486,-48,0
11,1,10,51,1,50,1,0.658651549891147,-49,0
11,1,10,49,100,-51,0,0.675294298767767,-50,0
11,1,10,84,36,48,1,0.603190138173886,-14,0
11,1,10,53,36,17,1,0.678089655968506,-14,0
11,1,10,51,4,47,1,0.796860080019542,-46,0
11,1,10,62,44,18,1,1.50475624932369,-6,0
11,1,10,7,95,-88,0,0.663607755594057,-45,0
11,1,10,51,0,51,1,0.711409243445814,-50,0
11,1,10,46,70,-24,0,0.957387114451194,-20,0
11,1,10,20,99,-79,0,0.729983743234698,-49,0
11,1,1.5,32,89,-57,0,0.598790731261033,-39,0
11,1,1.5,49,99,-50,0,0.721159270480712,-49,0
11,1,1.5,49,98,-49,0,0.703110778766131,-48,0
11,1,1.5,51,3,48,1,1.03751555572489,-47,0
11,1,1.5,6,53,-47,0,0.639069020689931,-3,0
11,1,10,49,98,-49,0,0.703629455718328,-48,0
11,1,10,6,72,-66,0,0.622223199705331,-22,0
11,1,10,51,1,50,1,1.28043891433481,-49,0
11,1,10,86,49,37,1,0.679293792922181,-1,0
11,1,10,51,27,24,1,0.751591861719135,-23,0
11,1,1.5,90,31,59,1,0.571300486235486,-19,0
11,1,1.5,49,100,-51,0,0.567251507003675,-50,0
11,1,1.5,51,2,49,1,0.539193466504003,-48,0
11,1,1.5,63,15,48,1,0.504605961301422,-35,0
11,1,1.5,5,72,-67,0,0.527252899917585,-22,0
11,1,1.5,49,80,-31,0,0.746884547641457,-30,0
11,1,1.5,49,98,-49,0,0.623812953726883,-48,0
11,1,1.5,83,32,51,1,0.609843498850751,-18,0
11,1,1.5,51,4,47,1,0.628264411614509,-46,0
11,1,1.5,72,29,43,1,1.101702836595,-21,0
11,1,10,49,96,-47,1,1.74751209177157,46,0
11,1,10,69,40,29,1,1.9760972400145,-10,0
11,1,10,51,0,51,1,0.708094109626472,-50,0
11,1,10,68,9,59,1,1.12286998803211,-41,0
11,1,10,99,40,59,1,0.71274644028199,-10,0
11,1,1.5,99,40,59,1,0.564486573965041,-10,0
11,1,1.5,57,8,49,1,0.648534233596365,-42,0
11,1,1.5,49,98,-49,0,0.737151015635391,-48,0
11,1,1.5,51,1,50,1,0.686466930221286,-49,0
11,1,1.5,51,3,48,1,0.66967975821899,-47,0
11,1,10,20,59,-39,0,1.08498457714995,-9,0
11,1,10,49,97,-48,0,0.988235013810481,-47,0
11,1,10,19,90,-71,0,0.655498433889079,-40,0
11,1,10,28,86,-58,0,0.888188277900554,-36,0
11,1,10,49,75,-26,0,1.69544132444025,-25,0
11,1,1.5,63,33,30,1,0.535862570768586,-17,0
11,1,1.5,34,58,-24,0,0.72509461730624,-8,0
11,1,1.5,21,56,-35,0,0.699113483951805,-6,0
11,1,1.5,8,56,-48,0,0.56165126214546,-6,0
11,1,1.5,5,100,-95,0,0.493772394291227,-50,0
11,1,10,49,98,-49,0,0.602968738257914,-48,0
11,1,10,49,100,-51,0,0.541515233157043,-50,0
11,1,10,49,99,-50,0,0.739001391080819,-49,0
11,1,10,65,24,41,1,0.792072123587786,-26,0
11,1,10,51,3,48,1,0.851395570902241,-47,0
11,1,10,63,8,55,1,0.666643940185168,-42,0
11,1,10,51,0,51,1,0.618581097800416,-50,0
11,1,10,12,54,-42,0,0.788689176879416,-4,0
11,1,10,3,61,-58,0,0.86382439028057,-11,0
11,1,10,80,29,51,1,0.895785887221791,-21,0
11,1,1.5,49,99,-50,0,0.557738641799006,-49,0
11,1,1.5,49,96,-47,0,0.682294788120998,-46,0
11,1,1.5,48,92,-44,0,0.521637992813339,-42,0
11,1,1.5,51,3,48,1,0.575571231940557,-47,0
11,1,1.5,19,53,-34,0,1.16363433091465,-3,0
11,1,1.5,12,93,-81,0,0.526272362214513,-43,0
11,1,1.5,9,92,-83,0,0.59538285873532,-42,0
11,1,1.5,49,100,-51,0,0.582026652298737,-50,0
11,1,1.5,89,14,75,1,0.616723757786531,-36,0
11,1,1.5,2,54,-52,0,0.458640553206351,-4,0
11,1,10,49,99,-50,0,0.96981226826756,-49,0
11,1,10,51,3,48,1,0.886033294294975,-47,0
11,1,10,49,97,-48,0,0.933091406273888,-47,0
11,1,10,86,30,56,1,2.51453046906317,-20,0
11,1,10,81,43,38,1,0.840294784455182,-7,0
11,1,1.5,49,98,-49,0,0.584267776597699,-48,0
11,1,1.5,61,32,29,1,0.602932082643747,-18,0
11,1,1.5,11,66,-55,0,0.549490761868583,-16,0
11,1,1.5,48,68,-20,0,0.649318297200807,-18,0
11,1,1.5,49,99,-50,0,1.10604396107738,-49,0
11,1,10,49,96,-47,0,0.736010292896026,-46,0
11,1,10,62,19,43,1,1.0287020796568,-31,0
11,1,10,14,98,-84,0,0.573884340537916,-48,0
11,1,10,51,2,49,1,0.665164886120692,-48,0
11,1,10,87,40,47,1,0.864256926535745,-10,0
11,1,1.5,51,4,47,1,0.517789886349419,-46,0
11,1,1.5,72,7,65,1,0.474818875443816,-43,0
11,1,1.5,59,20,39,1,0.650613706633521,-30,0
11,1,1.5,51,3,48,1,0.458790108115863,-47,0
11,1,1.5,54,18,36,1,0.602688689359638,-32,0
11,1,10,49,98,-49,0,0.948778909825705,-48,0
11,1,10,37,78,-41,0,0.63312531271913,-28,0
11,1,10,4,78,-74,0,0.633871621039361,-28,0
11,1,10,97,38,59,1,1.0191745522061,-12,0
11,1,10,51,0,51,1,0.725066759037873,-50,0
11,1,10,51,3,48,1,0.62576303244532,-47,0
11,1,10,25,52,-27,0,0.81879333381039,-2,0
11,1,10,51,2,49,1,0.604252417897442,-48,0
11,1,10,91,24,67,1,0.734270617407674,-26,0
11,1,10,12,98,-86,0,0.658709465762513,-48,0
11,1,1.5,35,89,-54,0,0.706143664350748,-39,0
11,1,1.5,13,94,-81,0,0.616054792812065,-44,0
11,1,1.5,49,99,-50,0,0.697592642483869,-49,0
11,1,1.5,89,30,59,1,0.711467892431756,-20,0
11,1,1.5,49,96,-47,0,0.604383644997142,-46,0
11,1,10,41,81,-40,0,0.965798478426223,-31,0
11,1,10,51,0,51,1,0.745071560924771,-50,0
11,1,10,92,14,78,1,0.765897448585747,-36,0
11,1,10,34,68,-34,0,1.96112891963094,-18,0
11,1,10,18,72,-54,0,0.8209523495334,-22,0
11,1,1.5,51,4,47,1,0.524912805454733,-46,0
11,1,1.5,49,99,-50,0,0.49820809026096,-49,0
11,1,1.5,49,98,-49,0,0.552166621762808,-48,0
11,1,1.5,22,87,-65,0,0.676396899667452,-37,0
11,1,1.5,70,28,42,1,0.555395981444235,-22,0
11,1,10,5,59,-54,0,0.613960657528878,-9,0
11,1,10,49,82,-33,0,0.728005439694243,-32,0
11,1,10,51,0,51,1,0.492669426836073,-50,0
11,1,10,22,97,-75,0,0.587209756258744,-47,0
11,1,10,49,98,-49,0,0.621873871694334,-48,0
11,1,1.5,4,70,-66,0,0.501545950563013,-20,0
11,1,1.5,51,2,49,1,0.547875715472401,-48,0
11,1,1.5,73,23,50,1,0.512371819895634,-27,0
11,1,1.5,86,18,68,1,0.565542255677428,-32,0
11,1,1.5,49,97,-48,0,0.64886523379937,-47,0
11,1,10,49,97,-48,0,0.861417582598733,-47,0
11,1,10,51,0,51,1,0.700706536978032,-50,0
11,1,10,51,2,49,1,1.13051158409144,-48,0
11,1,10,84,23,61,1,0.663306079883114,-27,0
11,1,10,56,17,39,1,0.718414864586521,-33,0
11,1,1.5,69,15,54,1,0.547013941963087,-35,0
11,1,1.5,51,3,48,1,0.438678638391139,-47,0
11,1,1.5,4,55,-51,0,0.567530822789195,-5,0
11,1,1.5,8,54,-46,0,0.482909136228045,-4,0
11,1,1.5,53,1,52,1,0.489437134703621,-49,0
11,1,10,41,54,-13,1,0.703389361440713,4,0
11,1,10,29,67,-38,0,0.861353435271667,-17,0
11,1,10,16,86,-70,0,1.35674344185281,-36,0
11,1,10,51,3,48,1,0.66463044725424,-47,0
11,1,10,49,96,-47,0,1.1437897140695,-46,0
11,1,1.5,23,94,-71,0,0.578927420050604,-44,0
11,1,1.5,49,99,-50,0,0.661923063529684,-49,0
11,1,1.5,38,94,-56,0,0.685114338026324,-44,0
11,1,1.5,51,4,47,1,0.843643274885835,-46,0
11,1,1.5,23,90,-67,0,0.620771637351936,-40,0
11,1,10,54,32,22,1,0.660914301004595,-18,0
11,1,10,92,48,44,1,0.764205058841981,-2,0
11,1,10,51,0,51,1,0.840132766637907,-50,0
11,1,10,7,59,-52,0,1.13679032438449,-9,0
11,1,10,51,1,50,1,0.645394680170284,-49,0
11,1,1.5,14,78,-64,0,0.707919995455086,-28,0
11,1,1.5,58,26,32,1,0.633976456099845,-24,0
11,1,1.5,23,80,-57,0,0.570413420353361,-30,0
11,1,1.5,51,2,49,1,0.597825588918568,-48,0
11,1,1.5,51,4,47,1,0.647881030534336,-46,0
11,1,10,63,9,54,1,1.0301232178499,-41,0
11,1,10,88,32,56,1,0.711194074987361,-18,0
11,1,10,52,10,42,1,0.644296844502605,-40,0
11,1,10,49,99,-50,0,0.612269367451518,-49,0
11,1,10,49,97,-48,0,0.941470146752181,-47,0
11,1,1.5,88,33,55,1,0.56209332886101,-17,0
11,1,1.5,49,100,-51,0,0.645519675817923,-50,0
11,1,1.5,49,98,-49,0,0.789283730953684,-48,0
11,1,1.5,49,65,-16,0,0.607985792283216,-15,0
11,1,1.5,66,23,43,1,0.577897030712847,-27,0
12,1,10,48,60,-12,0,1.01620733958225,-10,0
12,1,10,53,40,13,1,0.857640432757762,-10,0
12,1,10,30,100,-70,0,0.62643612644024,-50,0
12,1,10,75,0,75,1,0.732947837035681,-50,0
12,1,10,5,83,-78,0,0.739277185277388,-33,0
12,1,1.5,48,100,-52,0,0.680335839975669,-50,0
12,1,1.5,85,15,70,1,0.6161860792472,-35,0
12,1,1.5,3,100,-97,0,0.530083923336861,-50,0
12,1,1.5,25,55,-30,0,0.608417992840259,-5,0
12,1,1.5,50,43,7,1,0.955899467940981,-7,0
12,1,10,0,68,-68,0,0.575884549050897,-18,0
12,1,10,48,80,-32,0,0.740039991422236,-30,0
12,1,10,53,23,30,1,0.617313610096971,-27,0
12,1,10,53,0,53,1,0.716043305103085,-50,0
12,1,10,100,0,100,1,0.682114010378427,-50,0
12,1,1.5,100,15,85,1,0.633509219836924,-35,0
12,1,1.5,80,45,35,1,0.690968206636171,-5,0
12,1,1.5,50,100,-50,0,0.85028325730309,-50,0
12,1,1.5,98,38,60,1,0.763262874874272,-12,0
12,1,1.5,28,85,-57,0,0.631113766616181,-35,0
12,1,10,23,73,-50,0,0.636657582150292,-23,0
12,1,10,84,26,58,1,0.614152051713972,-24,0
12,1,10,24,76,-52,0,0.632264757146913,-26,0
12,1,10,49,96,-47,0,1.05768368654208,-46,0
12,1,10,49,97,-48,0,0.658351187737935,-47,0
12,1,1.5,77,3,74,1,0.618306247788496,-47,0
12,1,1.5,51,2,49,0,0.612478350198217,48,0
12,1,1.5,4,59,-55,0,0.567261650572618,-9,0
12,1,1.5,50,49,1,1,0.619136867069756,-1,0
12,1,1.5,51,4,47,1,0.61334672490193,-46,0
12,1,10,49,96,-47,0,0.606977421892225,-46,0
12,1,10,61,28,33,1,0.737535304069752,-22,0
12,1,10,6,59,-53,0,0.598887131449374,-9,0
12,1,10,79,35,44,1,0.673832376924111,-15,0
12,1,10,51,1,50,0,0.577760223746736,49,0
12,1,1.5,49,98,-49,0,0.525201377524354,-48,0
12,1,1.5,22,73,-51,0,0.467407357175034,-23,0
12,1,1.5,11,65,-54,0,0.443431931191299,-15,0
12,1,1.5,51,3,48,1,0.629449962152648,-47,0
12,1,1.5,43,96,-53,0,0.558879213807813,-46,0
12,1,1.5,15,54,-39,0,0.476489185637547,-4,0
12,1,1.5,49,97,-48,1,0.660361022475627,47,0
12,1,1.5,88,12,76,1,0.716995621471142,-38,0
12,1,1.5,78,21,57,1,0.644044815318921,-29,0
12,1,1.5,49,100,-51,0,0.621439581245795,-50,0
12,1,10,62,35,27,1,0.718835006973677,-15,0
12,1,10,33,90,-57,0,0.589146232614439,-40,0
12,1,10,51,2,49,1,0.904366249586019,-48,0
12,1,10,49,99,-50,0,0.575067125841088,-49,0
12,1,10,13,73,-60,0,0.627188668973758,-23,0
12,1,10,6,87,-81,0,0.604709897235807,-37,0
12,1,10,49,96,-47,0,0.591562213054203,-46,0
12,1,10,21,77,-56,0,0.594758594399536,-27,0
12,1,10,92,43,49,1,0.861961045935459,-7,0
12,1,10,51,2,49,1,1.19030418773582,-48,0
12,1,1.5,49,100,-51,0,0.521086403099616,-50,0
12,1,1.5,43,79,-36,0,0.471216256091793,-29,0
12,1,1.5,51,3,48,1,0.551410238316748,-47,0
12,1,1.5,7,71,-64,0,0.532137378417247,-21,0
12,1,1.5,97,1,96,1,0.577491903661212,-49,0
12,1,10,49,96,-47,0,0.619482897343914,-46,0
12,1,10,44,87,-43,0,0.917592010513545,-37,0
12,1,10,26,70,-44,0,0.643607145671922,-20,0
12,1,10,45,69,-24,0,0.653013377514071,-19,0
12,1,10,49,98,-49,0,0.525757445240743,-48,0
12,1,1.5,51,3,48,1,0.50720743671809,-47,0
12,1,1.5,71,18,53,1,0.489997928951198,-32,0
12,1,1.5,49,100,-51,0,0.465500891650663,-50,0
12,1,1.5,31,88,-57,0,0.498058894792848,-38,0
12,1,1.5,7,71,-64,0,0.504806485134395,-21,0
12,1,10,7,91,-84,0,0.526519518269197,-41,0
12,1,10,51,3,48,1,0.876353925923468,-47,0
12,1,10,51,2,49,1,0.620775745623177,-48,0
12,1,10,31,88,-57,0,0.598502979195473,-38,0
12,1,10,57,16,41,1,0.793193760458962,-34,0
12,1,1.5,76,43,33,1,0.595394571650104,-7,0
12,1,1.5,49,96,-47,0,0.478247928493147,-46,0
12,1,1.5,26,60,-34,0,0.517524197377497,-10,0
12,1,1.5,75,31,44,1,0.563669020575617,-19,0
12,1,1.5,49,97,-48,0,0.551647767571922,-47,0
12,1,10,17,75,-58,0,0.533249513851842,-25,0
12,1,10,49,98,-49,0,0.538541504387467,-48,0
12,1,10,51,2,49,1,0.616111301516867,-48,0
12,1,10,49,96,-47,0,0.474131121280152,-46,0
12,1,10,49,99,-50,0,0.466147499069848,-49,0
12,1,1.5,89,47,42,1,0.657644464890836,-3,0
12,1,1.5,66,49,17,1,0.674328695771692,-1,0
12,1,1.5,22,84,-62,0,0.41053742826989,-34,0
12,1,1.5,60,24,36,1,0.413364686217392,-26,0
12,1,1.5,27,77,-50,0,0.439190127874099,-27,0
12,1,1.5,28,78,-50,0,0.63137402243774,-28,0
12,1,1.5,52,31,21,1,0.456599042920061,-19,0
12,1,1.5,70,49,21,1,0.561508530709034,-1,0
12,1,1.5,55,6,49,1,0.654191493300459,-44,0
12,1,1.5,98,43,55,1,0.51898272964354,-7,0
12,1,10,51,1,50,0,0.708395082998322,49,0
12,1,10,51,2,49,0,0.795196264047263,48,0
12,1,10,2,78,-76,0,0.710612755834518,-28,0
12,1,10,51,4,47,0,0.445298808504958,46,0
12,1,10,49,98,-49,0,0.686840769258197,-48,0
12,1,10,51,0,51,0,0.628835611792965,50,0
12,1,10,78,47,31,0,0.750241653027842,3,0
12,1,10,88,4,84,1,1.16300775085801,-46,0
12,1,10,51,1,50,0,0.60720285474963,49,0
12,1,10,51,4,47,0,0.681944660815134,46,0
12,1,1.5,51,19,32,1,0.639767455926631,-31,0
12,1,1.5,8,71,-63,0,0.529342010971959,-21,0
12,1,1.5,27,84,-57,0,0.566621274630961,-34,0
12,1,1.5,91,0,91,1,0.578978294297485,-50,0
12,1,1.5,49,99,-50,0,0.550290038618186,-49,0
12,1,1.5,74,1,73,1,0.546551152181564,-49,0
12,1,1.5,51,1,50,1,0.639399065645193,-49,0
12,1,1.5,39,100,-61,0,0.448774873217189,-50,0
12,1,1.5,91,15,76,1,0.632619951356901,-35,0
12,1,1.5,51,0,51,0,0.569826819912123,50,0
12,1,10,6,93,-87,0,0.628841110155918,-43,0
12,1,10,14,75,-61,0,0.605490664696845,-25,0
12,1,10,49,96,-47,0,0.392443417267714,-46,0
12,1,10,49,97,-48,0,0.498955127863155,-47,0
12,1,10,24,83,-59,0,0.553025290633741,-33,0
12,1,10,68,29,39,1,0.780322460626849,-21,0
12,1,10,51,0,51,0,0.67899643889541,50,0
12,1,10,81,49,32,1,0.590459241555436,-1,0
12,1,10,49,98,-49,0,0.713836262431869,-48,0
12,1,10,51,47,4,0,0.935856104189952,3,0
12,1,1.5,12,50,-38,0,0.444231759640388,0,0
12,1,1.5,76,48,28,1,0.604125238032793,-2,0
12,1,1.5,1,97,-96,0,0.51884966927355,-47,0
12,1,1.5,49,100,-51,0,0.604298986285357,-50,0
12,1,1.5,51,3,48,1,0.686341517950495,-47,0
12,1,10,49,97,-48,0,0.555809294797655,-47,0
12,1,10,49,98,-49,0,0.512047095307935,-48,0
12,1,10,19,87,-68,0,0.501268472205993,-37,0
12,1,10,30,85,-55,0,0.763939173450126,-35,0
12,1,10,80,46,34,1,0.768178410864493,-4,0
12,1,1.5,98,48,50,1,0.498203685001499,-2,0
12,1,1.5,51,50,1,0,0.624216620815787,0,0
12,1,1.5,47,66,-19,0,0.53850704798424,-16,0
12,1,1.5,51,3,48,1,0.695801267189381,-47,0
12,1,1.5,51,1,50,1,0.405800405778791,-49,0
12,1,10,91,26,65,1,0.63060241891435,-24,0
12,1,10,11,70,-59,0,0.664068018408216,-20,0
12,1,10,51,2,49,1,0.623625730137064,-48,0
12,1,10,26,94,-68,0,0.55291459027103,-44,0
12,1,10,42,74,-32,0,0.621534886193331,-24,0
12,1,1.5,49,96,-47,0,0.534375578474283,-46,0
12,1,1.5,51,0,51,1,0.603126002306453,-50,0
12,1,1.5,46,54,-8,0,0.429937117061854,-4,0
12,1,1.5,51,1,50,0,0.55057485378893,49,0
12,1,1.5,57,38,19,0,0.747323855379364,12,0
12,1,10,51,1,50,1,0.606581173240556,-49,0
12,1,10,49,96,-47,0,0.497564042176236,-46,0
12,1,10,49,97,-48,0,0.623586141926353,-47,0
12,1,10,12,90,-78,0,0.505137853109773,-40,0
12,1,10,98,1,97,1,0.61504351953954,-49,0
12,1,1.5,60,49,11,1,0.519951174541347,-1,0
12,1,1.5,93,28,65,1,0.469185161018686,-22,0
12,1,1.5,76,35,41,1,0.533322825353025,-15,0
12,1,1.5,90,29,61,1,0.498698537618111,-21,0
12,1,1.5,49,100,-51,0,0.505432198775452,-50,0
12,1,1.5,94,41,53,1,0.554353328432626,-9,0
12,1,1.5,51,0,51,1,0.662152388948016,-50,0
12,1,1.5,83,42,41,0,0.413720246986486,8,0
12,1,1.5,51,3,48,1,0.720040614569371,-47,0
12,1,1.5,48,70,-22,0,0.501220453175847,-20,0
12,1,10,51,4,47,1,0.658812683621363,-46,0
12,1,10,8,51,-43,0,0.626903487243908,-1,0
12,1,10,84,9,75,1,0.724364526764475,-41,0
12,1,10,52,5,47,0,0.722259387079248,45,0
12,1,10,49,99,-50,0,0.56015813290287,-49,0
12,1,10,84,48,36,1,0.755113935232657,-2,0
12,1,10,49,99,-50,0,0.623308657905,-49,0
12,1,10,49,98,-49,0,0.592605435682344,-48,0
12,1,10,45,83,-38,0,0.515323752741097,-33,0
12,1,10,51,1,50,1,0.680817863079938,-49,0
12,1,1.5,62,0,62,1,0.494988242668114,-50,0
12,1,1.5,49,97,-48,0,0.485611335423528,-47,0
12,1,1.5,5,83,-78,0,0.500386901434467,-33,0
12,1,1.5,98,44,54,1,0.47420369966494,-6,0
12,1,1.5,76,26,50,1,0.513902609340221,-24,0
12,1,10,31,98,-67,0,0.702010018017972,-48,0
12,1,10,42,61,-19,0,0.771976313055347,-11,0
12,1,10,22,51,-29,0,0.519601112135206,-1,0
12,1,10,10,54,-44,0,0.548801448634549,-4,0
12,1,10,9,50,-41,0,0.560856424928716,0,0
12,1,1.5,18,64,-46,0,0.50775287426768,-14,0
12,1,1.5,51,2,49,0,0.649825793550917,48,0
12,1,1.5,49,97,-48,0,0.48173572304222,-47,0
12,1,1.5,51,0,51,0,0.528541815961944,50,0
12,1,1.5,51,4,47,0,0.566004358368446,46,0
12,1,1.5,51,2,49,0,0.400082108877541,48,0
12,1,1.5,65,32,33,1,0.553996667991669,-18,0
12,1,1.5,49,100,-51,0,0.414403143597156,-50,0
12,1,1.5,25,51,-26,0,0.431821589138053,-1,0
12,1,1.5,39,79,-40,0,0.4490688523274,-29,0
12,1,10,95,49,46,1,0.592544587136217,-1,0
12,1,10,7,55,-48,0,0.498622293660446,-5,0
12,1,10,51,4,47,0,0.552754038088096,46,0
12,1,10,41,52,-11,0,0.716713372199592,-2,0
12,1,10,49,96,-47,0,0.450111341837328,-46,0
13,1,10,25,55,-30,1,2.92036611762478,5,0
13,1,10,48,100,-52,1,2.02155724620025,50,0
13,1,10,50,43,7,1,0.975511760080963,-7,0
13,1,10,75,0,75,0,1.81943964355946,50,0
13,1,10,53,0,53,0,1.27010155475341,50,0
13,1,1.5,28,85,-57,1,0.837342678105642,35,0
13,1,1.5,30,100,-70,0,0.935317997789753,-50,0
13,1,1.5,5,83,-78,0,0.973203914101077,-33,0
13,1,1.5,53,23,30,0,1.02585330002535,27,0
13,1,1.5,3,100,-97,0,1.0917786652542,-50,0
13,1,10,48,80,-32,1,2.73039183163269,30,0
13,1,10,48,60,-12,1,3.92762432255586,10,0
13,1,10,80,45,35,1,2.33291081472885,-5,0
13,1,10,98,38,60,1,2.89814320301593,-12,0
13,1,10,53,40,13,0,2.02480861116874,10,0
13,1,1.5,85,15,70,1,0.993370441170327,-35,0
13,1,1.5,100,15,85,1,1.1006614529972,-35,0
13,1,1.5,50,100,-50,NaN,NaN,0,0
13,1,1.5,100,0,100,0,0.643834044760297,50,0
13,1,1.5,0,68,-68,0,0.541156158990589,-18,0
13,1,1.5,97,14,83,1,0.416864210609219,-36,0
13,1,1.5,28,85,-57,1,0.802888473050189,35,0
13,1,1.5,85,30,55,1,0.869624663454488,-20,0
13,1,1.5,24,78,-54,0,1.0375197253752,-28,0
13,1,1.5,97,28,69,1,0.590838995119611,-22,0
13,1,10,47,54,-7,0,1.45676875903791,-4,0
13,1,10,6,67,-61,1,1.305394443355,17,0
13,1,10,36,96,-60,0,2.35995945874129,-46,0
13,1,10,52,36,16,1,2.11657884560054,-14,0
13,1,10,84,25,59,1,0.938589156863145,-25,0
13,1,1.5,48,80,-32,1,0.77446633810905,30,0
13,1,1.5,39,74,-35,1,0.866326012569061,24,0
13,1,1.5,18,84,-66,0,0.66636413454853,-34,0
13,1,1.5,80,36,44,1,0.738355659739227,-14,0
13,1,1.5,48,100,-52,1,0.959577872390128,50,0
13,1,10,65,6,59,1,1.69153857009587,-44,0
13,1,10,100,0,100,1,1.62682321115335,-50,0
13,1,10,35,94,-59,1,1.58060837547237,44,0
13,1,10,5,98,-93,0,1.16806881017283,-48,0
13,1,10,77,11,66,1,0.667861155352966,-39,0
13,1,10,2,68,-66,0,0.749027614608622,-18,0
13,1,10,20,96,-76,1,1.60167810020585,46,0
13,1,10,48,63,-15,1,0.972417281719572,13,0
13,1,10,0,92,-92,0,1.28021964124991,-42,0
13,1,10,47,58,-11,1,2.2475714649654,8,0
13,1,1.5,3,51,-48,0,0.351250785807679,-1,0
13,1,1.5,53,40,13,1,0.844077072378695,-10,0
13,1,1.5,34,98,-64,NaN,NaN,0,0
13,1,1.5,52,31,21,1,0.901262607286753,-19,0
13,1,1.5,9,54,-45,0,0.588079183749869,-4,0
13,1,10,88,33,55,1,0.645119195333336,-17,0
13,1,10,98,25,73,1,0.965715144506248,-25,0
13,1,10,48,65,-17,1,0.897680240901536,15,0
13,1,10,48,63,-15,1,1.28864093310904,13,0
13,1,10,62,14,48,1,0.863628882530975,-36,0
13,1,1.5,98,45,53,1,0.622177461479168,-5,0
13,1,1.5,3,76,-73,0,0.728051362035785,-26,0
13,1,1.5,5,51,-46,0,0.557416649407969,-1,0
13,1,1.5,46,98,-52,1,0.921923986972615,48,0
13,1,1.5,49,80,-31,0,0.927987581032085,-30,0
13,1,1.5,25,97,-72,0,0.771820526119882,-47,0
13,1,1.5,66,37,29,1,0.575916806111309,-13,0
13,1,1.5,5,87,-82,0,0.547841068002072,-37,0
13,1,1.5,53,40,13,1,1.17638233412845,-10,0
13,1,1.5,46,98,-52,1,1.1324463863848,48,0
13,1,10,61,46,15,1,1.86486638062934,-4,0
13,1,10,2,63,-61,0,1.09691010360757,-13,0
13,1,10,66,40,26,1,1.20744221679297,-10,0
13,1,10,75,0,75,0,1.56200814857311,50,0
13,1,10,48,65,-17,1,0.902074532134975,15,0
13,1,1.5,19,81,-62,0,0.691357490693917,-31,0
13,1,1.5,49,57,-8,1,0.554689095097729,7,0
13,1,1.5,18,62,-44,0,0.623309024462287,-12,0
13,1,1.5,5,68,-63,0,0.521241456919142,-18,0
13,1,1.5,48,65,-17,1,0.735225258743867,15,0
13,1,10,6,72,-66,0,0.715805409288805,-22,0
13,1,10,65,47,18,0,0.921706984936009,3,0
13,1,10,49,55,-6,0,1.26369156386272,-5,0
13,1,10,38,79,-41,1,1.63156756479384,29,0
13,1,10,47,62,-15,1,1.7607695508018,12,0
13,1,1.5,28,53,-25,0,0.7825221721464,-3,0
13,1,1.5,99,30,69,1,0.801698627425594,-20,0
13,1,1.5,68,15,53,1,0.980393572780486,-35,0
13,1,1.5,96,15,81,0,1.16769235562651,35,0
13,1,1.5,30,93,-63,1,0.995489876598185,43,0
13,1,10,46,98,-52,1,0.765416033591009,48,0
13,1,10,53,23,30,1,0.88968745475313,-27,0
13,1,10,65,47,18,1,0.968848111404441,-3,0
13,1,10,19,89,-70,0,0.940145926538207,-39,0
13,1,10,62,46,16,1,0.929308654239321,-4,0
13,1,1.5,54,4,50,1,0.468645588388881,-46,0
13,1,1.5,35,94,-59,1,0.892758473434696,44,0
13,1,1.5,46,98,-52,NaN,NaN,0,0
13,1,1.5,5,85,-80,0,0.635753651371033,-35,0
13,1,1.5,52,15,37,1,0.581168108764814,-35,0
13,1,10,50,84,-34,1,1.43152944281428,34,0
13,1,10,28,55,-27,0,1.20092775701642,-5,0
13,1,10,39,74,-35,1,3.58745640256802,24,0
13,1,10,71,42,29,1,2.15880480263604,-8,0
13,1,10,74,3,71,1,1.52330041036112,-47,0
13,1,1.5,57,8,49,1,0.496048693497869,-42,0
13,1,1.5,73,38,35,1,0.829960210184254,-12,0
13,1,1.5,56,32,24,1,0.519254348746472,-18,0
13,1,1.5,45,99,-54,0,1.19718520500646,-49,0
13,1,1.5,48,92,-44,0,0.935875898294853,-42,0
13,1,10,70,28,42,1,0.995777257673581,-22,0
13,1,10,48,60,-12,1,1.70230179778127,10,0
13,1,10,34,70,-36,1,1.50899183859747,20,0
13,1,10,1,61,-60,0,0.818953221765696,-11,0
13,1,10,24,78,-54,1,1.21275656733587,28,0
13,1,10,28,85,-57,0,2.96478152256987,-35,0
13,1,10,71,28,43,1,1.39190860988538,-22,0
13,1,10,74,35,39,1,0.666567207400021,-15,0
13,1,10,75,0,75,1,0.770620416885777,-50,0
13,1,10,50,100,-50,0,1.47060887032512,-50,0
13,1,1.5,34,70,-36,1,0.901864128133639,20,0
13,1,1.5,20,72,-52,0,0.619702831839732,-22,0
13,1,1.5,26,57,-31,0,0.77376438050851,-7,0
13,1,1.5,40,93,-53,1,0.904959706167574,43,0
13,1,1.5,47,59,-12,1,0.608009281235809,9,0
13,1,1.5,50,60,-10,1,0.840004252067047,10,0
13,1,1.5,71,40,31,1,1.08931136676483,-10,0
13,1,1.5,26,65,-39,0,0.66387374293663,-15,0
13,1,1.5,31,52,-21,1,1.2161717835038,2,0
13,1,1.5,65,49,16,1,0.401899867489647,-1,0
13,1,10,38,89,-51,1,0.907156485227006,39,0
13,1,10,64,21,43,1,0.729041800384039,-29,0
13,1,10,53,40,13,1,0.661486720538505,-10,0
13,1,10,50,84,-34,1,0.725655908815042,34,0
13,1,10,46,98,-52,0,0.955527412085758,-48,0
13,1,1.5,48,100,-52,0,0.622149603110302,-50,0
13,1,1.5,59,4,55,1,0.767379315527251,-46,0
13,1,1.5,70,43,27,NaN,NaN,0,0
13,1,1.5,38,94,-56,1,0.419945492900752,44,0
13,1,1.5,24,78,-54,1,0.477242094729718,28,0
13,1,10,1,58,-57,0,0.604568772600487,-8,0
13,1,10,48,83,-35,1,0.751237223180397,33,0
13,1,10,48,65,-17,1,1.35517808279428,15,0
13,1,10,75,3,72,1,0.495780006854602,-47,0
13,1,10,50,31,19,1,0.637075824250587,-19,0
13,1,10,53,40,13,1,0.444249354400654,-10,0
13,1,10,95,32,63,1,1.292976941701,-18,0
13,1,10,73,32,41,1,1.02824142209647,-18,0
13,1,10,100,47,53,1,0.540813794291353,-3,0
13,1,10,28,85,-57,0,0.713330779649368,-35,0
13,1,1.5,85,12,73,1,0.701430124061517,-38,0
13,1,1.5,46,91,-45,1,0.571391287295228,41,0
13,1,1.5,72,42,30,1,0.999160949897032,-8,0
13,1,1.5,44,98,-54,0,0.977102619603102,-48,0
13,1,1.5,48,100,-52,0,0.740385655139107,-50,0
13,1,10,37,59,-22,1,1.10375446512853,9,0
13,1,10,47,58,-11,0,1.27821493831789,-8,0
13,1,10,27,63,-36,0,1.60569300443331,-13,0
13,1,10,85,49,36,1,1.31949737636478,-1,0
13,1,10,26,97,-71,0,1.7089089966039,-47,0
13,1,1.5,46,91,-45,0,0.538040053737404,-41,0
13,1,1.5,34,66,-32,0,0.903435926666589,-16,0
13,1,1.5,26,93,-67,0,0.77335566890315,-43,0
13,1,1.5,50,84,-34,NaN,NaN,0,0
13,1,1.5,42,55,-13,1,0.560700271435962,5,0
13,1,1.5,49,55,-6,1,0.529888914751609,5,0
13,1,1.5,47,59,-12,1,0.430466792640345,9,0
13,1,1.5,94,26,68,1,0.39914445480963,-24,0
13,1,1.5,97,22,75,1,0.376915675281452,-28,0
13,1,1.5,30,57,-27,1,0.308383719715493,7,0
13,1,10,30,93,-63,0,0.785546271468775,-43,0
13,1,10,42,76,-34,0,0.916088758231581,-26,0
13,1,10,55,16,39,1,1.0894704527168,-34,0
13,1,10,48,65,-17,1,0.744159731093532,15,0
13,1,10,7,50,-43,0,1.58075756437211,0,0
13,1,1.5,20,96,-76,1,0.66995346552585,46,0
13,1,1.5,65,29,36,0,0.589351504810111,21,0
13,1,1.5,80,45,35,1,0.655897085317974,-5,0
13,1,1.5,42,94,-52,1,0.463911131801069,44,0
13,1,1.5,49,55,-6,1,0.615203338605625,5,0
13,1,10,33,71,-38,0,0.991781780992824,-21,0
13,1,10,48,95,-47,1,1.09034762479905,45,0
13,1,10,52,29,23,1,0.889023619131876,-21,0
13,1,10,92,20,72,1,0.943614293542851,-30,0
13,1,10,24,78,-54,0,0.852133272973333,-28,0
13,1,1.5,87,44,43,1,0.546838166699217,-6,0
13,1,1.5,53,23,30,1,0.734101393468336,-27,0
13,1,1.5,72,45,27,1,0.354725384289395,-5,0
13,1,1.5,95,1,94,1,0.422705670827781,-49,0
13,1,1.5,2,94,-92,1,0.255840268906468,44,0
13,1,10,36,99,-63,0,1.19919797220382,-49,0
13,1,10,53,40,13,1,1.26517648826939,-10,0
13,1,10,31,52,-21,1,1.77651869351575,2,0
13,1,10,69,43,26,1,0.643706849310092,-7,0
13,1,10,87,39,48,1,0.428394276571453,-11,0
13,1,1.5,9,51,-42,0,0.43589184354596,-1,0
13,1,1.5,80,30,50,1,0.548244647802221,-20,0
13,1,1.5,5,54,-49,0,0.512067622526502,-4,0
13,1,1.5,65,47,18,1,0.685463979311407,-3,0
13,1,1.5,50,50,0,1,0.596194400101012,0,0
13,1,10,69,36,33,1,1.11737390880398,-14,0
13,1,10,47,58,-11,1,0.530668582540329,8,0
13,1,10,51,45,6,1,1.26323006797793,-5,0
13,1,10,57,11,46,1,0.382632505952188,-39,0
13,1,10,47,59,-12,1,0.513203584198891,9,0
14,1,10,98,38,60,0,4.76312998854519,12,0
14,1,10,85,15,70,0,1.12672513172947,35,0
14,1,10,48,60,-12,0,0.892849484536328,-10,0
14,1,10,50,100,-50,0,1.27628096219951,-50,0
14,1,10,100,0,100,0,0.980907766323071,50,0
14,1,1.5,53,23,30,0,0.31170419243972,27,0
14,1,1.5,80,45,35,0,0.46989672394011,5,0
14,1,1.5,48,100,-52,0,0.25395793814414,-50,0
14,1,1.5,53,40,13,0,0.222710836196711,10,0
14,1,1.5,53,0,53,0,0.281254341351541,50,0
14,1,10,5,83,-78,0,0.416198304696081,-33,0
14,1,10,50,43,7,0,0.394246964490321,7,0
14,1,10,30,100,-70,0,0.941661030928117,-50,0
14,1,10,28,85,-57,0,1.01906657502877,-35,0
14,1,10,100,15,85,0,0.805218235967914,35,0
14,1,1.5,48,80,-32,0,0.583268361970113,-30,0
14,1,1.5,75,0,75,0,0.522688293241572,50,0
14,1,1.5,3,100,-97,0,0.537412325315017,-50,0
14,1,1.5,0,68,-68,0,0.463019473081204,-18,0
14,1,1.5,25,55,-30,0,0.366941030927592,-5,0
14,1,10,19,51,-32,0,0.73839358533769,-1,0
14,1,10,98,36,62,0,1.25573571592213,14,0
14,1,10,4,54,-50,0,2.95248091638041,-4,0
14,1,10,92,15,77,0,3.42932563573868,35,0
14,1,10,27,53,-26,0,1.65472293241692,-3,0
14,1,1.5,16,89,-73,0,0.590944696449242,-39,0
14,1,1.5,95,32,63,0,0.738228270332456,18,0
14,1,1.5,75,46,29,0,0.447719587628853,4,0
14,1,1.5,40,53,-13,0,0.336454158075412,-3,0
14,1,1.5,68,33,35,0,0.413949873997353,17,0
14,1,10,28,56,-28,0,1.4292420618558,-6,0
14,1,10,29,87,-58,0,2.91062726231394,-37,0
14,1,10,42,90,-48,0,2.17348471935884,-40,0
14,1,10,88,44,44,0,1.53754318442134,6,0
14,1,10,90,19,71,0,1.182982451317,31,0
14,1,1.5,84,10,74,0,0.74576311569308,40,0
14,1,1.5,90,8,82,0,0.33465915234865,42,0
14,1,1.5,97,29,68,0,0.788000549828212,21,0
14,1,1.5,87,45,42,0,0.37533397479956,5,0
14,1,1.5,94,22,72,0,0.483503138602828,28,0
14,1,1.5,21,74,-53,NaN,NaN,0,0
14,1,1.5,25,65,-40,0,1.02145796105424,-15,0
14,1,1.5,0,69,-69,0,0.927549507445747,-19,0
14,1,1.5,14,67,-53,0,0.765682290950735,-17,0
14,1,1.5,83,22,61,0,0.969705933562182,28,0
14,1,10,78,36,42,0,1.43730144329902,14,0
14,1,10,26,64,-38,0,1.07059134020619,-14,0
14,1,10,3,78,-75,0,0.92651949599076,-28,0
14,1,10,78,48,30,0,1.19665227949599,2,0
14,1,10,68,43,25,1,1.17566936998855,-7,0
14,1,1.5,12,78,-66,0,0.94495999999981,-28,0
14,1,1.5,76,32,44,0,0.87844288659835,18,0
14,1,1.5,3,51,-48,0,0.574067537228075,-1,0
14,1,1.5,74,38,36,0,0.785900572737773,12,0
14,1,1.5,93,15,78,0,0.885324902634238,35,0
14,1,10,77,43,34,0,1.31603243986228,7,0
14,1,10,97,19,78,0,0.898177686140116,31,0
14,1,10,88,45,43,0,1.19293470790353,5,0
14,1,10,86,50,36,0,1.67627802978268,0,0
14,1,10,7,65,-58,0,1.05243344788096,-15,0
14,1,10,12,96,-84,0,0.866586758304493,-46,0
14,1,10,100,24,76,0,1.53857649484553,26,0
14,1,10,61,11,50,0,1.0000179610538,39,0
14,1,10,36,99,-63,0,1.6507707674682,-49,0
14,1,10,82,40,42,0,1.37142542955326,10,0
14,1,1.5,38,80,-42,0,0.903030103092533,-30,0
14,1,1.5,90,41,49,0,1.45371161512048,9,0
14,1,1.5,6,82,-76,0,0.470552852233595,-32,0
14,1,1.5,43,77,-34,0,0.798627628866143,-27,0
14,1,1.5,94,39,55,0,0.881264238258609,11,0
14,1,1.5,69,41,28,NaN,NaN,0,0
14,1,1.5,57,48,9,0,0.751542176402836,2,0
14,1,1.5,73,30,43,0,0.746270057273705,20,0
14,1,1.5,98,7,91,0,0.495186620847562,43,0
14,1,1.5,92,16,76,0,0.421839908362017,34,0
14,1,10,27,92,-65,0,1.9352049484537,-42,0
14,1,10,93,41,52,0,1.26068123711366,9,0
14,1,10,9,67,-58,0,0.773448064146578,-17,0
14,1,10,91,47,44,0,0.833642153493656,3,0
14,1,10,99,35,64,0,1.0349250859108,15,0
14,1,1.5,87,42,45,0,0.432987857961052,8,0
14,1,1.5,86,21,65,0,0.778457731958952,29,0
14,1,1.5,95,6,89,0,0.805809117984154,44,0
14,1,1.5,82,26,56,0,0.768445727377184,24,0
14,1,1.5,86,23,63,0,0.636589599083891,27,0
14,1,10,73,44,29,0,0.637447331042495,6,0
14,1,10,90,36,54,0,0.846334753722658,14,0
14,1,10,35,59,-24,0,1.48684865979385,-9,0
14,1,10,28,72,-44,0,0.878367376861206,-22,0
14,1,10,59,50,9,1,1.24636407789239,0,0
14,1,1.5,94,12,82,0,0.413198442153771,38,0
14,1,1.5,77,20,57,0,0.487232806414795,30,0
14,1,1.5,96,45,51,0,0.342760320733305,5,0
14,1,1.5,26,65,-39,0,0.331998717067563,-15,0
14,1,1.5,76,42,34,0,0.345521557846496,8,0
14,1,10,31,93,-62,0,0.70963463917542,-43,0
14,1,10,83,12,71,0,0.812383963344473,38,0
14,1,10,6,65,-59,0,0.622338052691703,-15,0
14,1,10,4,66,-62,0,0.528502909507552,-16,0
14,1,10,23,64,-41,0,0.574537823596984,-14,0
14,1,1.5,50,54,-4,0,0.27937319587636,-4,0
14,1,1.5,84,32,52,0,0.670716701030869,18,0
14,1,1.5,67,42,25,0,0.81480943871702,8,0
14,1,1.5,17,81,-64,0,0.880198304696478,-31,0
14,1,1.5,8,63,-55,0,0.615650309278408,-13,0
14,1,10,80,42,38,0,1.02508132875164,8,0
14,1,10,18,57,-39,0,0.923158579610572,-7,0
14,1,10,76,34,42,0,1.1052726689577,16,0
14,1,10,15,99,-84,0,1.15999486827059,-49,0
14,1,10,65,37,28,0,1.25203757159215,13,0
14,1,10,95,9,86,0,0.882927285223559,41,0
14,1,10,93,39,54,0,1.77830744558969,11,0
14,1,10,67,6,61,0,1.02967899198165,44,0
14,1,10,59,39,20,0,1.25502423825901,11,0
14,1,10,30,65,-35,0,1.07189296678098,-15,0
14,1,1.5,90,18,72,0,0.567340939289807,32,0
14,1,1.5,88,37,51,1,0.699347720504193,-13,0
14,1,1.5,74,41,33,0,0.92944274914089,9,0
14,1,1.5,98,16,82,0,0.646276105384004,34,0
14,1,1.5,89,39,50,0,1.11109168384883,11,0
14,1,10,79,23,56,0,1.88850327605951,27,0
14,1,10,80,31,49,0,1.57592742268025,19,0
14,1,10,100,41,59,0,1.16338694158094,9,0
14,1,10,33,80,-47,0,2.24737942726233,-30,0
14,1,10,46,88,-42,0,2.08849557846497,-38,0
14,1,1.5,16,50,-34,0,0.559098281787101,0,0
14,1,1.5,73,36,37,0,0.907768888888768,14,0
14,1,1.5,85,39,46,0,0.802577594501599,11,0
14,1,1.5,56,16,40,0,0.661220435280939,34,0
14,1,1.5,98,43,55,0,0.757834043527964,7,0
14,1,10,44,76,-32,0,2.520301672394,-26,0
14,1,10,87,24,63,0,1.15015770904938,26,0
14,1,10,45,61,-16,0,2.96292252004559,-11,0
14,1,10,44,67,-23,0,1.495064558992,-17,0
14,1,10,36,51,-15,0,0.989945841924509,-1,0
14,1,1.5,96,50,46,0,0.936658327605983,0,0
14,1,1.5,88,14,74,0,0.766036013745634,36,0
14,1,1.5,86,22,64,0,0.697658648338802,28,0
14,1,1.5,65,0,65,0,0.607552439862502,50,0
14,1,1.5,87,38,49,0,0.713628224513286,12,0
14,1,1.5,56,20,36,0,1.00505512027485,30,0
14,1,1.5,24,51,-27,0,0.359465567010375,-1,0
14,1,1.5,6,95,-89,0,0.571158946162996,-45,0
14,1,1.5,35,99,-64,0,0.478548453608255,-49,0
14,1,1.5,32,72,-40,0,0.438059106529181,-22,0
14,1,10,80,27,53,0,1.21424164948485,23,0
14,1,10,22,99,-77,0,1.10344174112242,-49,0
14,1,10,86,28,58,0,1.61363573883182,22,0
14,1,10,99,11,88,0,1.66294579610576,39,0
14,1,10,91,23,68,0,1.4064674455899,27,0
14,1,10,71,37,34,0,1.46259207331013,13,0
14,1,10,45,65,-20,1,1.81472036655214,15,0
14,1,10,80,17,63,0,1.03999596792664,33,0
14,1,10,22,73,-51,0,1.20893287514309,-23,0
14,1,10,55,6,49,0,0.962809621993074,44,0
14,1,1.5,21,88,-67,0,0.341885727376848,-38,0
14,1,1.5,77,42,35,0,0.866514180985178,8,0
14,1,1.5,88,21,67,0,0.62595885452447,29,0
14,1,1.5,79,10,69,0,0.787303001145574,40,0
14,1,1.5,90,20,70,0,0.686219289805194,30,0
14,1,1.5,71,11,60,0,0.778969805269298,39,0
14,1,1.5,5,94,-89,0,0.677779793814352,-44,0
14,1,1.5,19,77,-58,0,0.557186345933587,-27,0
14,1,1.5,5,52,-47,0,0.385129347078873,-2,0
14,1,1.5,44,73,-29,0,0.780103184421478,-23,0
14,1,10,98,5,93,0,0.766139747995567,45,0
14,1,10,86,24,62,0,0.865513493699837,26,0
14,1,10,29,80,-51,0,0.657082061855817,-30,0
14,1,10,80,26,54,0,0.640953402061768,24,0
14,1,10,66,5,61,0,0.921743321878694,45,0
14,1,10,86,22,64,0,2.15693232531521,28,0
14,1,10,16,71,-55,0,3.43320705612814,-21,0
14,1,10,76,36,40,0,1.3141098739975,14,0
14,1,10,93,42,51,0,1.72750405498255,8,0
14,1,10,36,83,-47,0,1.42886304696412,-33,0
14,1,1.5,93,5,88,0,0.685109003436537,45,0
14,1,1.5,82,38,44,0,0.803822038945782,12,0
14,1,1.5,27,61,-34,0,1.34174460481108,-11,0
14,1,1.5,17,87,-70,0,0.714445269186399,-37,0
14,1,1.5,93,29,64,0,0.584064146621131,21,0
14,1,10,81,12,69,0,1.51283024054965,38,0
14,1,10,88,34,54,0,0.95026364261139,16,0
14,1,10,93,44,49,0,1.4422850859105,6,0
14,1,10,72,47,25,0,1.47505777777769,3,0
14,1,10,69,38,31,0,1.83433823596806,12,0
14,1,1.5,33,88,-55,0,0.858650904925526,-38,0
14,1,1.5,91,33,58,0,0.666702222222284,17,0
14,1,1.5,35,92,-57,0,0.634149461626293,-42,0
14,1,1.5,80,28,52,0,0.698089347079076,22,0
14,1,1.5,86,48,38,0,1.00826611683806,2,0
14,1,10,35,64,-29,0,0.737110286368534,-14,0
14,1,10,25,83,-58,0,0.621203940435407,-33,0
14,1,10,95,45,50,0,0.622662817869241,5,0
14,1,10,100,49,51,0,0.991362565865074,1,0
14,1,10,69,10,59,0,0.890068087056079,40,0
14,1,1.5,65,11,54,0,0.576068911798302,39,0
14,1,1.5,76,46,30,0,0.739557754868656,4,0
14,1,1.5,9,90,-81,0,0.480362886597504,-40,0
14,1,1.5,94,16,78,0,0.72643079037789,34,0
14,1,1.5,69,0,69,0,0.659156746849931,50,0
15,1,10,53,40,13,1,2.3358183487685,-10,0
15,1,10,53,23,30,1,1.87689129920818,-27,0
15,1,10,48,80,-32,0,1.22919153911994,-30,0
15,1,10,100,0,100,1,1.55810211192102,-50,0
15,1,10,50,43,7,1,1.47550644499734,-7,0
15,1,1.5,48,100,-52,0,1.36993605404518,-50,0
15,1,1.5,0,68,-68,0,0.917991558180802,-18,0
15,1,1.5,98,38,60,1,1.12478533476792,-12,0
15,1,1.5,30,100,-70,0,0.914617396452059,-50,0
15,1,1.5,100,15,85,1,0.993215753907862,-35,0
15,1,1.5,48,60,-12,0,1.26765844905844,-10,0
15,1,1.5,28,85,-57,0,0.779781788324044,-35,0
15,1,1.5,53,0,53,1,0.815731181396586,-50,0
15,1,1.5,75,0,75,1,0.769665534614887,-50,0
15,1,1.5,3,100,-97,0,0.645785963414028,-50,0
15,1,10,50,100,-50,0,1.12616908930613,-50,0
15,1,10,25,55,-30,0,1.76399672297612,-5,0
15,1,10,5,83,-78,0,2.26407534955842,-33,0
15,1,10,85,15,70,0,1.44802819560232,35,0
15,1,10,80,45,35,1,1.56867363003721,-5,0
15,1,1.5,51,1,50,1,0.807238044269297,-49,0
15,1,1.5,50,21,29,1,0.889937813521101,-29,0
15,1,1.5,48,81,-33,0,1.00114915774247,-31,0
15,1,1.5,51,2,49,NaN,NaN,0,0
15,1,1.5,47,50,-3,0,1.31625920746615,0,0
15,1,10,26,81,-55,0,0.832895969150513,-31,0
15,1,10,49,98,-49,0,1.60218981446678,-48,0
15,1,10,42,63,-21,0,1.86078293015066,-13,0
15,1,10,51,4,47,1,1.34939893734986,-46,0
15,1,10,23,82,-59,0,2.05006149001952,-32,0
15,1,1.5,51,3,48,1,0.745233744549751,-47,0
15,1,1.5,50,15,35,1,0.845941383791114,-35,0
15,1,1.5,42,94,-52,0,0.687179468381828,-44,0
15,1,1.5,51,2,49,1,0.526728822599125,-48,0
15,1,1.5,49,96,-47,0,0.603787638581707,-46,0
15,1,10,59,31,28,1,1.31769941185848,-19,0
15,1,10,73,16,57,1,0.891654035706551,-34,0
15,1,10,19,100,-81,0,0.82693317840176,-50,0
15,1,10,49,98,-49,0,1.32489163644095,-48,0
15,1,10,54,35,19,0,2.19470800946442,15,0
15,1,1.5,51,3,48,1,0.668482103746783,-47,0
15,1,1.5,91,2,89,1,0.588614357690403,-48,0
15,1,1.5,51,2,49,1,0.839845899229658,-48,0
15,1,1.5,61,37,24,1,0.825134847337949,-13,0
15,1,1.5,54,29,25,1,0.691202070316649,-21,0
15,1,10,87,18,69,1,0.873704814915982,-32,0
15,1,10,51,1,50,1,0.905585053251571,-49,0
15,1,10,51,4,47,1,0.616290181574186,-46,0
15,1,10,24,93,-69,0,1.62623561949113,-43,0
15,1,10,12,83,-71,0,1.14815704056127,-33,0
15,1,10,39,92,-53,1,1.07940551705678,42,0
15,1,10,29,52,-23,0,1.70268778282184,-2,0
15,1,10,51,2,49,1,0.861269718502172,-48,0
15,1,10,52,1,51,1,1.80580003922159,-49,0
15,1,10,25,78,-53,0,2.01656363346456,-28,0
15,1,1.5,51,4,47,1,0.793775853758234,-46,0
15,1,1.5,51,1,50,1,0.541061953714916,-49,0
15,1,1.5,78,47,31,1,1.28230462027386,-3,0
15,1,1.5,5,53,-48,0,0.641655593575706,-3,0
15,1,1.5,49,96,-47,0,0.986921595184867,-46,0
15,1,1.5,51,4,47,1,0.900871490440977,-46,0
15,1,1.5,85,14,71,1,0.747512632487542,-36,0
15,1,1.5,49,96,-47,0,1.33610866230333,-46,0
15,1,1.5,51,2,49,1,0.861311506056381,-48,0
15,1,1.5,72,34,38,1,0.806025472080364,-16,0
15,1,10,51,1,50,1,2.48725021397786,-49,0
15,1,10,6,97,-91,0,0.79052852092218,-47,0
15,1,10,59,22,37,1,1.13781095530385,-28,0
15,1,10,91,19,72,1,1.57512724126991,-31,0
15,1,10,92,19,73,1,1.35506738243134,-31,0
15,1,10,35,65,-30,0,1.78277986206444,-15,0
15,1,10,74,5,69,1,1.02620152964437,-45,0
15,1,10,51,0,51,1,1.01218767010573,-50,0
15,1,10,32,92,-60,0,1.3901396034214,-42,0
15,1,10,51,2,49,1,0.865371130298399,-48,0
15,1,1.5,51,43,8,1,1.10468808706469,-7,0
15,1,1.5,51,4,47,1,0.447342366531984,-46,0
15,1,1.5,49,96,-47,0,0.607917275304771,-46,0
15,1,1.5,39,58,-19,NaN,NaN,0,0
15,1,1.5,79,30,49,1,0.747144608764074,-20,0
15,1,1.5,49,100,-51,0,0.654774686272731,-50,0
15,1,1.5,49,96,-47,0,0.783543767881156,-46,0
15,1,1.5,73,23,50,1,0.938604552277639,-27,0
15,1,1.5,88,47,41,0,0.616011964436439,3,0
15,1,1.5,48,54,-6,0,0.833910966850453,-4,0
15,1,10,51,2,49,1,0.594554055317076,-48,0
15,1,10,23,64,-41,0,1.25367684657908,-14,0
15,1,10,80,25,55,1,1.18238104751117,-25,0
15,1,10,28,100,-72,0,1.15357952556451,-50,0
15,1,10,51,3,48,1,1.08628360186731,-47,0
15,1,10,78,40,38,1,1.65217835954536,-10,0
15,1,10,49,96,-47,0,0.99687436425188,-46,0
15,1,10,51,2,49,1,0.783416572430951,-48,0
15,1,10,28,66,-38,0,1.09060678094693,-16,0
15,1,10,67,40,27,1,1.19388765379381,-10,0
15,1,1.5,58,27,31,1,0.732653124810895,-23,0
15,1,1.5,23,52,-29,0,0.585953883401771,-2,0
15,1,1.5,4,61,-57,0,0.653225614304574,-11,0
15,1,1.5,51,0,51,1,0.701816842217113,-50,0
15,1,1.5,49,99,-50,0,0.916568581990532,-49,0
15,1,1.5,51,4,47,1,0.545075391712317,-46,0
15,1,1.5,77,40,37,1,0.445529373168256,-10,0
15,1,1.5,94,36,58,1,0.830199938784972,-14,0
15,1,1.5,72,44,28,1,0.671438756490488,-6,0
15,1,1.5,6,53,-47,0,0.575497464338468,-3,0
15,1,10,49,97,-48,0,1.0027477149722,-47,0
15,1,10,51,3,48,1,1.14143400957073,-47,0
15,1,10,14,84,-70,0,1.28253885051231,-34,0
15,1,10,44,84,-40,0,1.27395444056901,-34,0
15,1,10,51,2,49,1,0.841966434330288,-48,0
15,1,1.5,36,53,-17,0,0.777754358826769,-3,0
15,1,1.5,96,29,67,1,0.605157463935257,-21,0
15,1,1.5,7,71,-64,0,0.551773863350945,-21,0
15,1,1.5,67,24,43,1,0.604382927951292,-26,0
15,1,1.5,51,2,49,1,0.518347852064608,-48,0
15,1,10,49,100,-51,0,0.979529596768316,-50,0
15,1,10,54,26,28,1,0.886739965946845,-24,0
15,1,10,51,0,51,1,0.590147667686324,-50,0
15,1,10,47,63,-16,1,0.672791353641742,13,0
15,1,10,49,97,-48,0,1.44076485886626,-47,0
15,1,10,33,61,-28,0,0.859925185615566,-11,0
15,1,10,51,2,49,1,0.82795843971121,-48,0
15,1,10,9,71,-62,0,0.997919419666232,-21,0
15,1,10,40,50,-10,0,1.20778568116452,0,0
15,1,10,51,3,48,1,0.82643722611283,-47,0
15,1,1.5,51,1,50,1,0.787045858175361,-49,0
15,1,1.5,49,100,-51,0,0.82234204579413,-50,0
15,1,1.5,86,44,42,1,1.0721359488432,-6,0
15,1,1.5,100,37,63,1,1.16026626736334,-13,0
15,1,1.5,18,56,-38,0,0.556235234605992,-6,0
15,1,10,72,44,28,1,0.711546377770446,-6,0
15,1,10,75,2,73,1,0.597405139502598,-48,0
15,1,10,74,25,49,1,0.719332792049954,-25,0
15,1,10,51,0,51,1,0.525368161182769,-50,0
15,1,10,30,60,-30,0,0.826631135027128,-10,0
15,1,1.5,49,99,-50,0,0.619172423146438,-49,0
15,1,1.5,66,15,51,1,0.869142640350219,-35,0
15,1,1.5,49,100,-51,0,0.517140778238172,-50,0
15,1,1.5,30,98,-68,0,0.626403136265935,-48,0
15,1,1.5,49,96,-47,0,0.548348383573284,-46,0
15,1,10,40,72,-32,0,0.760293392617768,-22,0
15,1,10,75,25,50,1,1.1242369647573,-25,0
15,1,10,9,75,-66,0,1.20927830327855,-25,0
15,1,10,49,97,-48,0,0.835454540456112,-47,0
15,1,10,51,1,50,1,0.564771258960036,-49,0
15,1,1.5,49,96,-47,0,0.50334612008055,-46,0
15,1,1.5,53,22,31,1,0.613240789784868,-28,0
15,1,1.5,49,99,-50,0,0.615452231143763,-49,0
15,1,1.5,49,50,-1,0,1.18455546656355,0,0
15,1,1.5,69,22,47,1,0.875685325054064,-28,0
15,1,1.5,51,0,51,1,0.714448780004886,-50,0
15,1,1.5,28,94,-66,0,0.752249654977732,-44,0
15,1,1.5,43,53,-10,1,0.940324073480042,3,0
15,1,1.5,7,80,-73,0,0.561674214696268,-30,0
15,1,1.5,49,99,-50,0,0.708884070694239,-49,0
15,1,10,51,3,48,1,0.690919821046691,-47,0
15,1,10,100,5,95,1,1.34613510942654,-45,0
15,1,10,49,98,-49,0,1.16672940909098,-48,0
15,1,10,62,6,56,1,1.10660591587134,-44,0
15,1,10,63,30,33,1,1.14531108818073,-20,0
15,1,1.5,31,89,-58,0,0.713029835947282,-39,0
15,1,1.5,25,85,-60,0,0.662642109758281,-35,0
15,1,1.5,51,1,50,1,0.581775127974424,-49,0
15,1,1.5,13,50,-37,0,0.728365501808184,0,0
15,1,1.5,51,3,48,1,0.781047877907213,-47,0
15,1,10,51,2,49,1,0.735000559000127,-48,0
15,1,10,51,50,1,1,1.01957380360204,0,0
15,1,10,51,4,47,1,0.508724618184488,-46,0
15,1,10,63,15,48,1,0.603309281052589,-35,0
15,1,10,58,29,29,1,0.797401107370206,-21,0
15,1,10,51,4,47,1,0.694044723679781,-46,0
15,1,10,49,99,-50,0,0.677297811468407,-49,0
15,1,10,49,100,-51,0,0.476469758090388,-50,0
15,1,10,24,70,-46,0,0.715945067694065,-20,0
15,1,10,19,77,-58,0,0.64107973175328,-27,0
15,1,1.5,47,60,-13,0,0.537764402502034,-10,0
15,1,1.5,19,91,-72,0,0.814174411721069,-41,0
15,1,1.5,41,74,-33,0,0.615726782706588,-24,0
15,1,1.5,49,96,-47,0,0.672997725510641,-46,0
15,1,1.5,28,96,-68,0,0.56028386212347,-46,0
15,1,1.5,70,43,27,1,1.00204502425686,-7,0
15,1,1.5,50,94,-44,0,0.75603216175432,-44,0
15,1,1.5,94,6,88,1,0.776121345192678,-44,0
15,1,1.5,49,98,-49,0,0.708233064585784,-48,0
15,1,1.5,51,2,49,1,0.48197435197244,-48,0
15,1,10,51,3,48,1,0.783270682548391,-47,0
15,1,10,98,14,84,1,0.641887991026579,-36,0
15,1,10,49,97,-48,0,0.610400335766826,-47,0
15,1,10,58,31,27,1,0.692405478568617,-19,0
15,1,10,26,73,-47,0,0.667107879703053,-23,0
15,1,1.5,56,38,18,0,0.769676164782595,12,0
15,1,1.5,87,1,86,1,0.500833368461826,-49,0
15,1,1.5,49,100,-51,0,0.642915451681347,-50,0
15,1,1.5,20,81,-61,0,0.619577835734617,-31,0
15,1,1.5,49,96,-47,0,0.628825348183454,-46,0
15,1,10,46,52,-6,0,1.69273318096748,-2,0
15,1,10,51,2,49,1,0.875247288849096,-48,0
15,1,10,46,77,-31,0,1.30667079654768,-27,0
15,1,10,35,54,-19,0,0.5765898056693,-4,0
15,1,10,51,0,51,1,0.779178068132296,-50,0
16,1,10,100,15,85,1,0.497412682394497,-35,0
16,1,10,48,80,-32,1,0.344139451597584,30,0
16,1,10,25,55,-30,0,0.172949820655049,-5,0
16,1,10,48,100,-52,1,0.376937189226737,50,0
16,1,10,85,15,70,1,0.317068378717522,-35,0
16,1,1.5,0,68,-68,1,0.266619625632302,18,0
16,1,1.5,53,40,13,0,0.250540391454706,10,0
16,1,1.5,5,83,-78,0,0.187988409568788,-33,0
16,1,1.5,80,45,35,1,0.319409922245541,-5,0
16,1,1.5,30,100,-70,0,0.381358190541505,-50,0
16,1,1.5,53,0,53,1,0.176250634598546,-50,0
16,1,1.5,50,100,-50,1,0.180345769884298,50,0
16,1,1.5,48,60,-12,0,0.279686156922253,-10,0
16,1,1.5,3,100,-97,0,0.591046565124998,-50,0
16,1,1.5,53,23,30,1,0.339159822804504,-27,0
16,1,10,50,43,7,1,0.816600839782041,-7,0
16,1,10,28,85,-57,1,2.01885001182382,35,0
16,1,10,100,0,100,0,0.756766118734959,50,0
16,1,10,98,38,60,1,1.1294945411064,-12,0
16,1,10,75,0,75,1,1.12688944564434,-50,0
16,1,10,28,85,-57,0,0.957545777942869,-35,0
16,1,10,19,80,-61,1,0.618505451566307,30,0
16,1,10,9,55,-46,0,0.732256154893548,-5,0
16,1,10,31,69,-38,0,0.825944654090563,-19,0
16,1,10,53,40,13,1,0.67603858342045,-10,0
16,1,1.5,48,100,-52,1,0.339527109390474,50,0
16,1,1.5,1,51,-50,0,0.33693227742333,-1,0
16,1,1.5,14,95,-81,1,0.350335304785403,45,0
16,1,1.5,70,7,63,0,0.531015004860819,43,0
16,1,1.5,16,55,-39,0,0.392446432786528,-5,0
16,1,10,1,61,-60,0,0.594595902293804,-11,0
16,1,10,50,100,-50,0,3.46123422215169,-50,0
16,1,10,48,80,-32,1,0.854090828288463,30,0
16,1,10,42,81,-39,1,0.734701799592585,31,0
16,1,10,0,84,-84,0,0.668267283457681,-34,0
16,1,1.5,28,84,-56,0,0.459658408828545,-34,0
16,1,1.5,53,46,7,1,0.628808902853052,-4,0
16,1,1.5,4,51,-47,0,0.349840457609389,-1,0
16,1,1.5,59,10,49,1,0.242620637320215,-40,0
16,1,1.5,0,68,-68,0,0.507989582547452,-18,0
16,1,1.5,0,51,-51,0,0.430243226554012,-1,0
16,1,1.5,48,80,-32,1,0.455610925506335,30,0
16,1,1.5,80,16,64,1,0.440338475469616,-34,0
16,1,1.5,14,70,-56,0,0.681821330843377,-20,0
16,1,1.5,47,96,-49,1,1.0410910097271,46,0
16,1,10,25,77,-52,0,0.929268744162982,-27,0
16,1,10,53,40,13,1,0.614736182309571,-10,0
16,1,10,19,80,-61,0,0.304793236355181,-30,0
16,1,10,96,41,55,1,0.527451372108771,-9,0
16,1,10,62,46,16,1,0.389560923940735,-4,0
16,1,10,12,94,-82,0,0.551101034958265,-44,0
16,1,10,36,68,-32,0,0.515812199999345,-18,0
16,1,10,3,72,-69,0,0.56984804525564,-22,0
16,1,10,11,85,-74,0,0.485984645085409,-35,0
16,1,10,27,72,-45,0,0.381438832308049,-22,0
16,1,1.5,70,7,63,1,0.416145580384182,-43,0
16,1,1.5,51,28,23,0,0.290192312269937,22,0
16,1,1.5,9,53,-44,0,0.417602263827575,-3,0
16,1,1.5,48,80,-32,1,0.347649934119545,30,0
16,1,1.5,50,100,-50,1,0.384443104485399,50,0
16,1,10,34,98,-64,0,0.554545171296922,-48,0
16,1,10,51,21,30,0,0.63121349355788,29,0
16,1,10,3,69,-66,0,0.488671115395846,-19,0
16,1,10,0,93,-93,0,0.408131622025394,-43,0
16,1,10,42,81,-39,0,0.554809089793707,-31,0
16,1,1.5,84,26,58,1,0.470218814094551,-24,0
16,1,1.5,75,16,59,1,0.574341624160297,-34,0
16,1,1.5,19,80,-61,0,0.434459691023221,-30,0
16,1,1.5,84,44,40,1,0.619799751846585,-6,0
16,1,1.5,100,0,100,1,0.437926920232712,-50,0
16,1,10,88,32,56,1,0.485358571750112,-18,0
16,1,10,44,80,-36,0,0.644498124165693,-30,0
16,1,10,89,21,68,1,0.566136324894615,-29,0
16,1,10,59,9,50,1,0.498189042627928,-41,0
16,1,10,37,70,-33,0,0.457178308090079,-20,0
16,1,1.5,42,81,-39,1,0.529085833986755,31,0
16,1,1.5,68,35,33,1,0.430532803788083,-15,0
16,1,1.5,0,89,-89,0,0.295884887556895,-39,0
16,1,1.5,28,85,-57,0,0.542631817210349,-35,0
16,1,1.5,47,96,-49,0,0.411959906385164,-46,0
16,1,10,76,42,34,1,0.610712524940027,-8,0
16,1,10,51,1,50,1,0.357591963678715,-49,0
16,1,10,78,49,29,1,1.92231265910959,-1,0
16,1,10,36,57,-21,0,0.464320602317457,-7,0
16,1,10,49,100,-51,1,0.576522617266164,50,0
16,1,1.5,54,3,51,0,0.428031076400657,47,0
16,1,1.5,51,2,49,0,0.334017810833757,48,0
16,1,1.5,86,48,38,0,0.61947058684018,2,0
16,1,1.5,49,99,-50,0,0.509508580100373,-49,0
16,1,1.5,66,17,49,1,0.636190923047252,-33,0
16,1,1.5,51,2,49,1,0.451763946897699,-48,0
16,1,1.5,62,4,58,0,0.412491042356123,46,0
16,1,1.5,50,26,24,0,0.2065147546964,24,0
16,1,1.5,49,78,-29,0,0.561237337868079,-28,0
16,1,1.5,3,81,-78,0,0.190117718651891,-31,0
16,1,10,19,80,-61,0,0.776045364662423,-30,0
16,1,10,86,48,38,0,0.436178460222436,2,0
16,1,10,40,61,-21,0,0.325451822965988,-11,0
16,1,10,4,79,-75,0,0.363685181902838,-29,0
16,1,10,6,89,-83,0,0.295545825589215,-39,0
16,1,1.5,6,70,-64,0,0.573203842213843,-20,0
16,1,1.5,62,4,58,0,0.385255753528327,46,0
16,1,1.5,77,12,65,1,0.404658527957508,-38,0
16,1,1.5,12,88,-76,0,0.631430859764805,-38,0
16,1,1.5,28,85,-57,0,0.712821856854134,-35,0
16,1,10,26,77,-51,0,0.510259281596518,-27,0
16,1,10,94,48,46,1,0.612867126197671,-2,0
16,1,10,49,100,-51,0,0.567068836913677,-50,0
16,1,10,53,15,38,0,0.379140175544308,35,0
16,1,10,48,82,-34,0,0.48651064929436,-32,0
16,1,1.5,79,39,40,1,0.252715153139434,-11,0
16,1,1.5,47,85,-38,0,0.589379113414907,-35,0
16,1,1.5,28,85,-57,0,0.272783222113503,-35,0
16,1,1.5,95,31,64,1,0.472842603776371,-19,0
16,1,1.5,16,86,-70,0,0.328960472717881,-36,0
16,1,10,54,3,51,1,0.42176814393315,-47,0
16,1,10,17,58,-41,0,0.311145974410465,-8,0
16,1,10,16,71,-55,0,0.461854430628591,-21,0
16,1,10,62,4,58,0,0.262608431090484,46,0
16,1,10,88,33,55,1,1.93396209469938,-17,0
16,1,1.5,52,47,5,0,1.03047562144639,3,0
16,1,1.5,49,96,-47,1,0.671268623205833,46,0
16,1,1.5,71,37,34,1,0.366679557133466,-13,0
16,1,1.5,51,1,50,1,0.6027506171813,-49,0
16,1,1.5,51,2,49,1,0.397446588569437,-48,0
16,1,10,62,41,21,1,0.710939971366315,-9,0
16,1,10,59,11,48,1,0.693713791391929,-39,0
16,1,10,39,60,-21,0,0.541120517271338,-10,0
16,1,10,98,36,62,1,0.426510979188606,-14,0
16,1,10,51,0,51,0,0.564560878105112,50,0
16,1,1.5,27,86,-59,0,0.742712458973983,-36,0
16,1,1.5,47,96,-49,0,0.412147581751924,-46,0
16,1,1.5,56,33,23,0,0.862385200045537,17,0
16,1,1.5,36,53,-17,0,0.486268357461086,-3,0
16,1,1.5,100,46,54,0,0.349021210611681,4,0
16,1,10,55,30,25,1,0.640998638249584,-20,0
16,1,10,0,84,-84,0,0.409891445189714,-34,0
16,1,10,28,85,-57,0,0.427973160956753,-35,0
16,1,10,9,53,-44,0,0.429904531149077,-3,0
16,1,10,48,100,-52,0,0.262785476414138,-50,0
16,1,10,41,73,-32,0,0.445395813600044,-23,0
16,1,10,49,98,-49,1,0.342955117361271,48,0
16,1,10,49,96,-47,1,0.43633607821539,46,0
16,1,10,51,0,51,0,0.413081926541054,50,0
16,1,10,86,3,83,1,0.583109216444427,-47,0
16,1,1.5,49,100,-51,0,0.521953070157906,-50,0
16,1,1.5,86,25,61,1,0.431336655528867,-25,0
16,1,1.5,14,89,-75,0,0.288047241410823,-39,0
16,1,1.5,37,87,-50,0,0.622786796011496,-37,0
16,1,1.5,11,89,-78,0,0.360202923999168,-39,0
16,1,1.5,6,97,-91,0,0.411044255830348,-47,0
16,1,1.5,13,65,-52,0,0.365153228514828,-15,0
16,1,1.5,62,4,58,0,0.512464467217796,46,0
16,1,1.5,12,80,-68,0,0.493937755556544,-30,0
16,1,1.5,36,87,-51,0,0.333325757892453,-37,0
16,1,10,86,34,52,1,0.937353447341593,-16,0
16,1,10,19,91,-72,0,0.526157438376686,-41,0
16,1,10,51,28,23,0,0.547528971466818,22,0
16,1,10,24,84,-60,0,0.43941952593741,-34,0
16,1,10,100,46,54,0,0.264414073448279,4,0
16,1,10,49,96,-47,1,1.17491344755399,46,0
16,1,10,1,65,-64,0,0.418293583657942,-15,0
16,1,10,71,2,69,0,0.299715004686732,48,0
16,1,10,5,65,-60,0,0.257856431999244,-15,0
16,1,10,2,58,-56,0,0.329829937516479,-8,0
16,1,1.5,27,67,-40,0,0.510046314040665,-17,0
16,1,1.5,48,51,-3,0,0.292047072784044,-1,0
16,1,1.5,23,96,-73,0,0.474832989086281,-46,0
16,1,1.5,49,98,-49,0,0.226236430651625,-48,0
16,1,1.5,54,3,51,1,0.195645344865625,-47,0
16,1,10,95,37,58,1,0.660371721867705,-13,0
16,1,10,100,46,54,1,0.500519956083735,-4,0
16,1,10,50,10,40,0,0.418521213359782,40,0
16,1,10,52,35,17,0,0.571942165202927,15,0
16,1,10,2,68,-66,0,0.463358766035526,-18,0
16,1,1.5,30,94,-64,1,0.214152262647985,44,0
16,1,1.5,91,1,90,0,0.32823946204735,49,0
16,1,1.5,49,98,-49,0,0.41348623498925,-48,0
16,1,1.5,86,48,38,1,0.342994338585413,-2,0
16,1,1.5,63,38,25,1,0.515762715280289,-12,0
16,1,10,34,77,-43,0,0.487906851441949,-27,0
16,1,10,14,97,-83,0,0.558649836981203,-47,0
16,1,10,0,67,-67,0,0.594667013676371,-17,0
16,1,10,70,7,63,0,0.469443920082995,43,0
16,1,10,60,13,47,0,0.884856393517111,37,0
16,1,1.5,37,53,-16,0,0.434973598981742,-3,0
16,1,1.5,49,96,-47,0,0.53969609052001,-46,0
16,1,1.5,50,100,-50,0,0.584272290565423,-50,0
16,1,1.5,57,26,31,0,0.684014053651481,24,0
16,1,1.5,99,32,67,1,0.466601297972375,-18,0
16,1,1.5,31,80,-49,0,0.544703577368637,-30,0
16,1,1.5,27,71,-44,0,0.533842964840005,-21,0
16,1,1.5,13,53,-40,0,0.490172518388135,-3,0
16,1,1.5,12,80,-68,0,0.528907689018524,-30,0
16,1,1.5,14,95,-81,0,0.485730623520794,-45,0
16,1,10,94,32,62,1,0.66786187532125,-18,0
16,1,10,3,52,-49,0,0.499925039810478,-2,0
16,1,10,71,2,69,1,0.465960929068387,-48,0
16,1,10,60,13,47,1,0.433306880382588,-37,0
16,1,10,37,70,-33,1,0.394127446983475,20,0
17,1,10,80,45,35,0,1.5645810385613,5,0
17,1,10,53,23,30,0,0.559910047784797,27,0
17,1,10,100,15,85,0,0.524724214337766,35,0
17,1,10,25,55,-30,0,0.778585213600309,-5,0
17,1,10,5,83,-78,0,0.518611202234752,-33,0
17,1,1.5,3,100,-97,0,0.235930670081871,-50,0
17,1,1.5,50,43,7,0,0.229060725076124,7,0
17,1,1.5,48,100,-52,0,0.254401299069286,-50,0
17,1,1.5,98,38,60,0,0.279190943198046,12,0
17,1,1.5,100,0,100,0,0.198343911455595,50,0
17,1,1.5,0,68,-68,0,0.216361846920336,-18,0
17,1,1.5,50,100,-50,0,0.21825326277758,-50,0
17,1,1.5,30,100,-70,0,0.196381017653039,-50,0
17,1,1.5,75,0,75,0,0.231726668411284,50,0
17,1,1.5,53,40,13,0,0.184822853887454,10,0
17,1,10,48,60,-12,0,2.93145376935718,-10,0
17,1,10,53,0,53,0,0.94463869741594,50,0
17,1,10,48,80,-32,0,0.670034071154078,-30,0
17,1,10,28,85,-57,0,0.398029408592265,-35,0
17,1,10,85,15,70,0,0.568599930717028,35,0
17,1,1.5,75,49,26,0,0.211231931200018,1,0
17,1,1.5,96,29,67,0,0.253863198580802,21,0
17,1,1.5,67,3,64,0,0.190669015064486,47,0
17,1,1.5,97,4,93,0,0.193822474495391,46,0
17,1,1.5,3,86,-83,0,0.189151850267081,-36,0
17,1,10,62,39,23,0,0.312358533279621,11,0
17,1,10,60,23,37,0,0.302240558041376,27,0
17,1,10,48,99,-51,0,0.276937372516841,-49,0
17,1,10,17,98,-81,0,0.22098848472524,-48,0
17,1,10,94,34,60,0,0.198904738252168,16,0
17,1,1.5,49,76,-27,0,0.19954254127515,-26,0
17,1,1.5,49,96,-47,0,0.274121142254444,-46,0
17,1,1.5,79,39,40,0,0.250163207922014,11,0
17,1,1.5,96,15,81,0,0.202761980341165,35,0
17,1,1.5,56,50,6,0,0.205348381568911,0,0
17,1,10,13,74,-61,0,0.567326890537515,-24,0
17,1,10,14,91,-77,0,0.283157051657327,-41,0
17,1,10,87,22,65,0,0.314573615847621,28,0
17,1,10,7,78,-71,0,0.336464921754668,-28,0
17,1,10,100,20,80,0,0.269812306301901,30,0
17,1,10,51,21,30,0,0.457528733211802,29,0
17,1,10,32,93,-61,0,0.314146947610425,-43,0
17,1,10,46,66,-20,0,0.440193686852581,-16,0
17,1,10,83,12,71,0,0.20951792721462,38,0
17,1,10,78,29,49,0,0.43611944510485,21,0
17,1,1.5,100,43,57,0,0.260547300975304,7,0
17,1,1.5,97,23,74,0,0.205301096182666,27,0
17,1,1.5,67,37,30,0,0.183832426424487,13,0
17,1,1.5,90,10,80,0,0.259256299672415,40,0
17,1,1.5,52,41,11,0,0.219777758640703,9,0
17,1,1.5,51,21,30,0,0.211848840684979,29,0
17,1,1.5,90,42,48,0,0.318394202593481,8,0
17,1,1.5,94,46,48,0,0.380411749516497,4,0
17,1,1.5,31,75,-44,0,0.23177505347121,-25,0
17,1,1.5,17,51,-34,0,0.25701372558251,-1,0
17,1,10,24,100,-76,0,0.968826460768469,-50,0
17,1,10,39,78,-39,0,0.740897652765852,-28,0
17,1,10,98,9,89,0,0.242097932088654,41,0
17,1,10,72,5,67,0,0.20343130697438,45,0
17,1,10,71,28,43,0,0.23803725282778,22,0
17,1,10,43,69,-26,0,0.491981826271513,-19,0
17,1,10,93,9,84,0,0.283354990533553,41,0
17,1,10,92,43,49,0,0.314658289687941,7,0
17,1,10,22,73,-51,0,0.256648271795711,-23,0
17,1,10,69,9,60,0,0.24127245368436,41,0
17,1,1.5,35,68,-33,0,0.289192354422994,-18,0
17,1,1.5,75,33,42,0,0.2405199194327,17,0
17,1,1.5,16,75,-59,0,0.21783465873159,-25,0
17,1,1.5,12,64,-52,0,0.139956343482481,-14,0
17,1,1.5,3,65,-62,0,0.28910731401993,-15,0
17,1,10,9,67,-58,0,0.398324117573793,-17,0
17,1,10,24,63,-39,0,1.37692472641356,-13,0
17,1,10,58,43,15,0,0.340779622551054,7,0
17,1,10,53,11,42,0,0.306250286375871,39,0
17,1,10,93,38,55,0,0.464900123348343,12,0
17,1,1.5,50,55,-5,0,0.280251382369897,-5,0
17,1,1.5,68,33,35,0,0.239418426266639,17,0
17,1,1.5,80,38,42,0,0.288749191284296,12,0
17,1,1.5,96,7,89,0,0.256017066727509,43,0
17,1,1.5,83,3,80,0,0.296612496167654,47,0
17,1,1.5,20,73,-53,0,0.22495459318452,-23,0
17,1,1.5,91,32,59,0,0.322723565535853,18,0
17,1,1.5,27,77,-50,0,0.208901750840596,-27,0
17,1,1.5,7,63,-56,0,0.499436424055602,-13,0
17,1,1.5,31,82,-51,0,0.218175553454785,-32,0
17,1,10,93,29,64,0,0.275441834368394,21,0
17,1,10,10,64,-54,0,0.267262193869101,-14,0
17,1,10,66,10,56,0,0.307293130972539,40,0
17,1,10,82,46,36,0,0.218084648193326,4,0
17,1,10,45,84,-39,0,0.307784312622971,-34,0
17,1,10,95,25,70,0,0.255730055374443,25,0
17,1,10,98,34,64,0,0.296464408573229,16,0
17,1,10,0,83,-83,0,0.52706099266652,-33,0
17,1,10,73,34,39,0,0.220903077773983,16,0
17,1,10,64,6,58,0,0.166915984111256,44,0
17,1,1.5,7,85,-78,0,0.217671908991178,-35,0
17,1,1.5,86,9,77,0,0.21962563895795,41,0
17,1,1.5,47,88,-41,0,0.309494651068235,-38,0
17,1,1.5,58,27,31,0,0.284147845668485,23,0
17,1,1.5,3,86,-83,0,0.227494442122406,-36,0
17,1,10,18,95,-77,0,0.33011951475055,-45,0
17,1,10,16,93,-77,0,0.247345878015039,-43,0
17,1,10,80,27,53,0,0.287344558426412,23,0
17,1,10,38,69,-31,0,0.222657402642653,-19,0
17,1,10,73,24,49,0,1.02452902462392,26,0
17,1,1.5,50,51,-1,0,0.281856153422268,-1,0
17,1,1.5,88,12,76,0,0.225178190798033,38,0
17,1,1.5,88,27,61,0,0.315142873383593,23,0
17,1,1.5,83,34,49,0,0.417001482710475,16,0
17,1,1.5,100,38,62,0,0.363016954928753,12,0
17,1,1.5,16,95,-79,0,0.260375020850915,-45,0
17,1,1.5,88,15,73,0,0.308948486417648,35,0
17,1,1.5,52,38,14,0,0.291659259237349,12,0
17,1,1.5,46,92,-46,0,0.282930888177361,-42,0
17,1,1.5,83,7,76,0,0.177504613995552,43,0
17,1,10,96,16,80,0,0.22871543171641,34,0
17,1,10,100,41,59,0,0.134194123049383,9,0
17,1,10,41,66,-25,0,0.362688523033285,-16,0
17,1,10,97,10,87,0,0.494055419214419,40,0
17,1,10,15,88,-73,0,0.349327649309998,-38,0
17,1,10,62,43,19,0,0.270052398816915,7,0
17,1,10,80,28,52,0,0.270114712911891,22,0
17,1,10,38,50,-12,0,0.445395447037299,0,0
17,1,10,51,25,26,0,0.213334481872153,25,0
17,1,10,75,28,47,0,0.230714980862103,22,0
17,1,1.5,40,90,-50,0,0.223331127897836,-40,0
17,1,1.5,91,16,75,0,0.208559756458271,34,0
17,1,1.5,50,37,13,0,0.235076233948348,13,0
17,1,1.5,34,93,-59,0,0.220605436348706,-43,0
17,1,1.5,66,45,21,0,0.12561897134583,5,0
17,1,1.5,59,15,44,0,0.257633200948476,35,0
17,1,1.5,24,87,-63,0,0.218318875849945,-37,0
17,1,1.5,18,99,-81,0,0.276378745038528,-49,0
17,1,1.5,43,69,-26,0,0.203687894390896,-19,0
17,1,1.5,47,77,-30,0,0.253589016589103,-27,0
17,1,10,72,33,39,0,0.276956066736602,17,0
17,1,10,95,47,48,0,0.436020475681289,3,0
17,1,10,96,20,76,0,0.316803360561607,30,0
17,1,10,93,4,89,0,0.38612045312766,46,0
17,1,10,95,44,51,0,0.788598354542046,6,0
17,1,1.5,95,47,48,0,0.196580789299333,3,0
17,1,1.5,25,96,-71,0,0.254665950662456,-46,0
17,1,1.5,51,11,40,0,0.222607184812659,39,0
17,1,1.5,94,13,81,0,0.255882541605388,37,0
17,1,1.5,40,87,-47,0,0.271908259004704,-37,0
17,1,10,61,49,12,0,0.247151604678947,1,0
17,1,10,42,65,-23,0,0.359135886872537,-15,0
17,1,10,8,54,-46,0,0.235050575211062,-4,0
17,1,10,0,78,-78,0,0.356454548280453,-28,0
17,1,10,46,61,-15,0,0.208322229824262,-11,0
17,1,10,82,47,35,0,0.328906589347753,3,0
17,1,10,30,86,-56,0,0.189405505268951,-36,0
17,1,10,49,75,-26,0,0.2321936575172,-25,0
17,1,10,56,31,25,0,0.216891150121228,19,0
17,1,10,21,62,-41,0,0.210793533260585,-12,0
17,1,1.5,83,29,54,0,0.372082921719993,21,0
17,1,1.5,97,24,73,0,0.255319882038748,26,0
17,1,1.5,23,53,-30,0,0.351364220347023,-3,0
17,1,1.5,95,25,70,0,0.24328446565778,25,0
17,1,1.5,64,22,42,0,0.219969832643983,28,0
17,1,10,82,33,49,0,0.279285513985087,17,0
17,1,10,77,41,36,0,0.52601924771443,9,0
17,1,10,45,89,-44,0,0.315291694088955,-39,0
17,1,10,41,58,-17,0,0.440612657461315,-8,0
17,1,10,92,37,55,0,0.329196533144568,13,0
17,1,1.5,92,4,88,0,0.309167318831896,46,0
17,1,1.5,17,58,-41,0,0.298988129157806,-8,0
17,1,1.5,79,49,30,0,0.289039135081111,1,0
17,1,1.5,18,83,-65,0,0.183649149679695,-33,0
17,1,1.5,38,51,-13,0,0.194412992117577,-1,0
17,1,1.5,5,99,-94,0,0.202814764037612,-49,0
17,1,1.5,36,53,-17,0,0.205161439313088,-3,0
17,1,1.5,47,57,-10,0,0.254774817047291,-7,0
17,1,1.5,74,44,30,0,0.582646992523223,6,0
17,1,1.5,72,39,33,0,0.209382302433369,11,0
17,1,10,66,35,31,0,0.330719929319457,15,0
17,1,10,3,67,-64,0,0.847322785135475,-17,0
17,1,10,0,75,-75,0,0.367333855072502,-25,0
17,1,10,51,18,33,0,0.490525875924504,32,0
17,1,10,69,36,33,0,0.441186680182,14,0
17,1,10,16,97,-81,0,0.358587522889138,-47,0
17,1,10,90,22,68,0,0.266483267754666,28,0
17,1,10,85,17,68,0,0.257820143204299,33,0
17,1,10,50,57,-7,0,0.273766685044393,-7,0
17,1,10,9,92,-83,0,0.177152722666506,-42,0
17,1,1.5,20,60,-40,0,0.235622765176231,-10,0
17,1,1.5,76,35,41,0,0.380222607927863,15,0
17,1,1.5,63,26,37,0,0.182955997093813,24,0
17,1,1.5,72,38,34,0,0.385579053661786,12,0
17,1,1.5,1,70,-69,0,0.276222226690152,-20,0
17,1,1.5,83,32,51,0,0.400780392330489,18,0
17,1,1.5,79,25,54,0,0.274786436799332,25,0
17,1,1.5,25,86,-61,0,0.305911590970936,-36,0
17,1,1.5,80,2,78,0,0.367959928378696,48,0
17,1,1.5,78,34,44,0,0.235318892358919,16,0
17,1,10,82,31,51,0,0.531242634562659,19,0
17,1,10,93,8,85,0,0.359904549477505,42,0
17,1,10,66,50,16,0,0.139100807704381,0,0
17,1,10,53,24,29,0,0.175834596419008,26,0
17,1,10,23,69,-46,0,0.147006999337464,-19,0
18,1,1.5,3,100,-97,0,0.852246539238877,-50,0
18,1,1.5,48,100,-52,NaN,NaN,0,0
18,1,1.5,48,60,-12,0,0.956782138386188,-10,0
18,1,1.5,75,0,75,0,0.417362362243693,50,0
18,1,1.5,48,80,-32,0,0.523991737793949,-30,0
18,1,10,30,100,-70,0,0.857892257755339,-50,0
18,1,10,25,55,-30,0,1.01139334001709,-5,0
18,1,10,80,45,35,1,0.733851401257198,-5,0
18,1,10,53,40,13,0,1.01174596832607,10,0
18,1,10,53,0,53,0,0.525750480648639,50,0
18,1,10,53,23,30,0,0.994152308303455,27,0
18,1,10,85,15,70,1,0.829495415282508,-35,0
18,1,10,28,85,-57,0,0.502812412370076,-35,0
18,1,10,100,15,85,0,0.525544108779286,35,0
18,1,10,50,43,7,0,0.883504362950589,7,0
18,1,1.5,50,100,-50,0,0.522080873579398,-50,0
18,1,1.5,100,0,100,0,0.592671049472301,50,0
18,1,1.5,0,68,-68,0,0.595963835437033,-18,0
18,1,1.5,98,38,60,1,0.775085820273489,-12,0
18,1,1.5,5,83,-78,0,0.571258593482526,-33,0
18,1,1.5,45,93,-48,0,0.597145616797206,-43,0
18,1,1.5,51,49,2,0,0.575729495231826,1,0
18,1,1.5,35,63,-28,0,0.715729165330231,-13,0
18,1,1.5,47,65,-18,0,0.817660006928236,-15,0
18,1,1.5,75,0,75,1,0.635623890017996,-50,0
18,1,10,50,43,7,0,2.07621719997769,7,0
18,1,10,18,82,-64,0,0.980134783190806,-32,0
18,1,10,62,28,34,1,1.15937516609665,-22,0
18,1,10,18,93,-75,0,0.7720675858709,-43,0
18,1,10,100,0,100,1,1.01601233099427,-50,0
18,1,1.5,80,37,43,0,0.615901997188303,13,0
18,1,1.5,50,43,7,0,0.993897917403956,7,0
18,1,1.5,37,99,-62,0,0.613211098627289,-49,0
18,1,1.5,75,0,75,1,0.631104236122155,-50,0
18,1,1.5,48,85,-37,0,0.632426775558997,-35,0
18,1,10,53,23,30,0,1.40089623307176,27,0
18,1,10,50,61,-11,0,1.28355018263755,-11,0
18,1,10,43,76,-33,0,1.0509294981639,-26,0
18,1,10,15,73,-58,0,1.36349197330674,-23,0
18,1,10,54,39,15,0,1.51959341442853,11,0
18,1,10,85,44,41,1,1.93222755156057,-6,0
18,1,10,54,39,15,1,1.67354279650408,-11,0
18,1,10,46,56,-10,0,0.889516272402943,-6,0
18,1,10,52,25,27,0,2.0567823216652,25,0
18,1,10,45,92,-47,0,0.817320574688893,-42,0
18,1,1.5,80,37,43,1,0.474681690636316,-13,0
18,1,1.5,21,96,-75,1,0.730639991055796,46,0
18,1,1.5,53,40,13,NaN,NaN,0,0
18,1,1.5,64,39,25,1,0.78453603901562,-11,0
18,1,1.5,61,5,56,0,0.483773049593765,45,0
18,1,1.5,54,30,24,0,0.481704932214598,20,0
18,1,1.5,22,50,-28,1,0.768950747502458,0,0
18,1,1.5,100,15,85,0,0.428969038721334,35,0
18,1,1.5,32,81,-49,0,0.894248529646575,-31,0
18,1,1.5,51,39,12,1,1.18889734007553,-11,0
18,1,10,21,96,-75,0,0.703556157523963,-46,0
18,1,10,79,50,29,1,1.31004752417903,0,0
18,1,10,75,8,67,1,1.23670450150894,-42,0
18,1,10,5,92,-87,0,0.90991153134928,-42,0
18,1,10,100,0,100,1,0.892556133698235,-50,0
18,1,1.5,47,82,-35,0,0.505848608088854,-32,0
18,1,1.5,12,98,-86,0,0.496468401827769,-48,0
18,1,1.5,22,50,-28,0,0.551093532642881,0,0
18,1,1.5,53,23,30,1,1.05170403414832,-27,0
18,1,1.5,100,0,100,1,0.548247213704599,-50,0
18,1,10,80,39,41,1,1.35147548555142,-11,0
18,1,10,87,17,70,1,1.26016088208416,-33,0
18,1,10,6,59,-53,0,1.26885086058519,-9,0
18,1,10,65,19,46,1,1.22874947078253,-31,0
18,1,10,13,96,-83,0,2.02198171977761,-46,0
18,1,10,53,23,30,0,1.29395784955432,27,0
18,1,10,35,89,-54,0,1.8532395434886,-39,0
18,1,10,61,5,56,1,1.87780072834903,-45,0
18,1,10,65,19,46,1,1.14910239233723,-31,0
18,1,10,47,92,-45,0,1.05773793705066,-42,0
18,1,1.5,61,38,23,1,0.833603425113324,-12,0
18,1,1.5,53,40,13,0,0.786962283066714,10,0
18,1,1.5,36,75,-39,0,0.934193399399192,-25,0
18,1,1.5,2,61,-59,0,0.675507178111729,-11,0
18,1,1.5,0,73,-73,0,0.819444775363991,-23,0
18,1,10,26,67,-41,0,0.756064052256079,-17,0
18,1,10,53,40,13,0,1.07265646048381,10,0
18,1,10,34,64,-30,0,0.680732821741913,-14,0
18,1,10,81,17,64,1,1.04783501980364,-33,0
18,1,10,80,2,78,1,1.00855985059115,-48,0
18,1,1.5,53,0,53,NaN,NaN,0,0
18,1,1.5,50,45,5,0,0.483043233623903,5,0
18,1,1.5,61,5,56,0,0.930325484726382,45,0
18,1,1.5,33,60,-27,0,0.80765335390879,-10,0
18,1,1.5,48,73,-25,0,0.810165005856106,-23,0
18,1,1.5,75,0,75,1,0.451511591463714,-50,0
18,1,1.5,81,28,53,1,0.492100502733592,-22,0
18,1,1.5,75,3,72,1,0.45144707734471,-47,0
18,1,1.5,45,86,-41,0,0.532016781002312,-36,0
18,1,1.5,61,5,56,1,0.905274212496806,-45,0
18,1,10,93,21,72,1,0.655247178881837,-29,0
18,1,10,12,91,-79,0,0.855873259080909,-41,0
18,1,10,88,40,48,1,0.600455630964461,-10,0
18,1,10,75,11,64,1,0.595076766302554,-39,0
18,1,10,50,43,7,0,1.04569359092602,7,0
18,1,10,73,27,46,1,0.603634050991786,-23,0
18,1,10,66,42,24,1,1.17416576096457,-8,0
18,1,10,79,23,56,1,0.946219417650354,-27,0
18,1,10,100,15,85,1,0.726859683624753,-35,0
18,1,10,46,73,-27,0,0.740791434283892,-23,0
18,1,1.5,73,29,44,1,0.649345603234906,-21,0
18,1,1.5,3,69,-66,1,0.650075785762056,19,0
18,1,1.5,54,39,15,0,1.0426544627453,11,0
18,1,1.5,87,22,65,1,0.571871844168527,-28,0
18,1,1.5,100,0,100,1,0.439219085916193,-50,0
18,1,1.5,12,55,-43,0,0.447192811074274,-5,0
18,1,1.5,75,0,75,1,0.727754083908621,-50,0
18,1,1.5,51,49,2,0,1.02966843041941,1,0
18,1,1.5,27,95,-68,0,0.750270977627224,-45,0
18,1,1.5,71,7,64,1,0.610691748974205,-43,0
18,1,10,21,96,-75,0,1.0435301685975,-46,0
18,1,10,13,68,-55,0,1.30815205537874,-18,0
18,1,10,31,97,-66,0,0.650056358214897,-47,0
18,1,10,31,82,-51,0,0.730730530756773,-32,0
18,1,10,47,58,-11,0,1.36737564995201,-8,0
18,1,10,66,48,18,1,0.859935082667107,-2,0
18,1,10,90,33,57,1,0.604440110920223,-17,0
18,1,10,53,19,34,0,1.08653982555552,31,0
18,1,10,49,96,-47,0,1.17306902094333,-46,0
18,1,10,51,1,50,0,1.55307550901034,49,0
18,1,1.5,41,56,-15,0,0.517015049017573,-6,0
18,1,1.5,49,98,-49,0,0.506962576312617,-48,0
18,1,1.5,63,40,23,0,0.849601826922481,10,0
18,1,1.5,51,3,48,0,0.706196837708376,47,0
18,1,1.5,20,65,-45,0,0.616126330374755,-15,0
18,1,10,10,84,-74,0,1.04797577788031,-34,0
18,1,10,84,48,36,1,0.79204130369817,-2,0
18,1,10,75,0,75,1,0.474638803410016,-50,0
18,1,10,96,20,76,1,0.689927549910863,-30,0
18,1,10,4,100,-96,0,1.03320974236522,-50,0
18,1,1.5,54,39,15,0,0.801076945916975,11,0
18,1,1.5,61,41,20,0,0.907102234717968,9,0
18,1,1.5,53,0,53,0,0.793022211551033,50,0
18,1,1.5,67,12,55,1,0.748319058973721,-38,0
18,1,1.5,79,45,34,1,0.656953137457094,-5,0
18,1,10,53,19,34,0,1.19155158288686,31,0
18,1,10,3,91,-88,0,0.946779517500545,-41,0
18,1,10,33,96,-63,0,0.654723001665843,-46,0
18,1,10,61,41,20,1,0.799195039743609,-9,0
18,1,10,58,29,29,0,1.12202698962847,21,0
18,1,1.5,80,37,43,1,0.495250697833399,-13,0
18,1,1.5,72,36,36,1,0.581214295008976,-14,0
18,1,1.5,31,100,-69,0,0.672566287340487,-50,0
18,1,1.5,2,89,-87,0,0.680431878038689,-39,0
18,1,1.5,3,95,-92,0,0.543776311955298,-45,0
18,1,10,94,48,46,1,1.27434519085728,-2,0
18,1,10,100,0,100,1,0.865607559881028,-50,0
18,1,10,24,78,-54,0,1.10555536209449,-28,0
18,1,10,51,3,48,1,1.09618505288472,-47,0
18,1,10,12,70,-58,0,1.03815093737921,-20,0
18,1,1.5,29,72,-43,0,0.86943368700031,-22,0
18,1,1.5,53,0,53,1,1.1006570543077,-50,0
18,1,1.5,66,11,55,1,0.91465002006953,-39,0
18,1,1.5,96,44,52,1,0.61664574234328,-6,0
18,1,1.5,0,63,-63,0,1.20188043994222,-13,0
18,1,1.5,36,67,-31,0,0.485198225128443,-17,0
18,1,1.5,51,1,50,0,0.883814837147838,49,0
18,1,1.5,49,98,-49,0,0.690430100235062,-48,0
18,1,1.5,49,100,-51,1,1.36098655283877,50,0
18,1,1.5,56,42,14,0,1.18888194466035,8,0
18,1,10,51,0,51,0,1.43089786425298,50,0
18,1,10,23,94,-71,0,1.87943704100144,-44,0
18,1,10,52,45,7,0,1.03013799056862,5,0
18,1,10,51,5,46,0,1.23941116204151,45,0
18,1,10,42,85,-43,0,1.53603718359227,-35,0
18,1,10,0,88,-88,0,0.674568057813303,-38,0
18,1,10,69,28,41,1,0.937841746133017,-22,0
18,1,10,53,0,53,0,0.838443816816834,50,0
18,1,10,21,96,-75,0,0.887043475551764,-46,0
18,1,10,95,5,90,1,1.22967869402964,-45,0
18,1,1.5,50,45,5,0,1.15833890806243,5,0
18,1,1.5,84,44,40,1,0.802311511554763,-6,0
18,1,1.5,39,56,-17,0,1.020231407746,-6,0
18,1,1.5,74,47,27,1,0.861764937675616,-3,0
18,1,1.5,65,29,36,1,0.804854320887898,-21,0
18,1,1.5,95,33,62,1,0.964685484506845,-17,0
18,1,1.5,71,34,37,1,0.664042725940817,-16,0
18,1,1.5,26,76,-50,0,0.863299713902052,-26,0
18,1,1.5,48,68,-20,0,1.46260545400855,-18,0
18,1,1.5,51,3,48,0,1.17384209069769,47,0
18,1,10,70,29,41,1,0.864418080815085,-21,0
18,1,10,54,30,24,0,1.03970074246172,20,0
18,1,10,53,23,30,0,0.744363170501856,27,0
18,1,10,95,1,94,1,0.70028719779566,-49,0
18,1,10,77,12,65,1,0.834303916482895,-38,0
18,1,1.5,14,62,-48,0,0.576879019531589,-12,0
18,1,1.5,66,22,44,0,0.412303135715774,28,0
18,1,1.5,29,92,-63,0,0.709400916760387,-42,0
18,1,1.5,52,25,27,0,1.1633743083521,25,0
18,1,1.5,95,43,52,1,0.93472710711012,-7,0
18,1,10,74,48,26,1,2.41857933312167,-2,0
18,1,10,80,37,43,1,1.26788718093485,-13,0
18,1,10,65,18,47,0,2.02715604535751,32,0
18,1,10,81,43,38,1,1.50705934749021,-7,0
18,1,10,51,3,48,0,1.92094784436722,47,0
19,1,1.5,85,15,70,NaN,NaN,0,0
19,1,1.5,28,85,-57,0,0.816167573590064,-35,0
19,1,1.5,25,55,-30,0,0.610312615113799,-5,0
19,1,1.5,30,100,-70,0,0.677410593023524,-50,0
19,1,1.5,50,43,7,0,0.636423684481997,7,0
19,1,10,100,15,85,0,3.27719945822901,35,0
19,1,10,75,0,75,0,1.82860583224101,50,0
19,1,10,53,40,13,0,2.19025737552147,10,0
19,1,10,48,100,-52,1,1.58586386570823,50,0
19,1,10,53,0,53,0,1.07694543668185,50,0
19,1,1.5,53,23,30,0,1.08460090575682,27,0
19,1,1.5,80,45,35,0,0.547911286717863,5,0
19,1,1.5,48,60,-12,0,0.87258015149564,-10,0
19,1,1.5,100,0,100,0,0.672599212281057,50,0
19,1,1.5,5,83,-78,0,1.10490906726045,-33,0
19,1,10,50,100,-50,1,1.71886925587023,50,0
19,1,10,48,80,-32,1,1.38909063582832,30,0
19,1,10,98,38,60,0,1.97659336208017,12,0
19,1,10,3,100,-97,0,2.85276390473882,-50,0
19,1,10,0,68,-68,0,1.17329401435563,-18,0
19,1,1.5,60,1,59,0,0.918931203414104,49,0
19,1,1.5,39,56,-17,0,0.716878870574874,-6,0
19,1,1.5,80,30,50,0,0.755075940716779,20,0
19,1,1.5,1,98,-97,0,0.583623857499333,-48,0
19,1,1.5,70,23,47,0,1.05902866998804,27,0
19,1,10,83,49,34,0,1.64319209416863,1,0
19,1,10,3,69,-66,0,1.01263033265423,-19,0
19,1,10,84,20,64,0,1.66283239526092,30,0
19,1,10,6,96,-90,0,0.966804551862879,-46,0
19,1,10,59,35,24,0,1.59498628173606,15,0
19,1,10,81,48,33,0,1.67559688650363,2,0
19,1,10,99,3,96,0,1.57981536701845,47,0
19,1,10,42,82,-40,1,1.78334967550472,32,0
19,1,10,24,72,-48,1,2.2025776039518,22,0
19,1,10,66,44,22,0,2.30135936351144,6,0
19,1,1.5,63,14,49,0,0.723569570938707,36,0
19,1,1.5,66,4,62,0,0.48980119972839,46,0
19,1,1.5,89,22,67,0,0.88119709030434,28,0
19,1,1.5,62,33,29,0,0.760428354376927,17,0
19,1,1.5,86,37,49,0,0.580514017914538,13,0
19,1,10,77,37,40,0,0.921421567632933,13,0
19,1,10,3,74,-71,0,1.04767321025429,-24,0
19,1,10,50,15,35,0,1.08032469305908,35,0
19,1,10,4,69,-65,0,0.855679837550269,-19,0
19,1,10,55,47,8,0,2.7525353586534,3,0
19,1,1.5,84,7,77,0,0.499881419949816,43,0
19,1,1.5,71,50,21,1,1.02658025779238,0,0
19,1,1.5,78,36,42,0,1.43677374304389,14,0
19,1,1.5,59,12,47,NaN,NaN,0,0
19,1,1.5,9,75,-66,0,0.831113057909533,-25,0
19,1,1.5,67,14,53,0,0.910351286511286,36,0
19,1,1.5,88,24,64,0,0.50917538300564,26,0
19,1,1.5,17,63,-46,0,0.75604217563523,-13,0
19,1,1.5,7,71,-64,0,0.680575415623025,-21,0
19,1,1.5,87,40,47,0,1.32804408905213,10,0
19,1,10,92,48,44,0,1.30098584553343,2,0
19,1,10,21,52,-31,1,1.29984916324611,2,0
19,1,10,41,62,-21,1,2.29834079575085,12,0
19,1,10,68,43,25,0,1.80129063474305,7,0
19,1,10,13,64,-51,0,1.8358196043846,-14,0
19,1,10,82,36,46,0,1.63550986669725,14,0
19,1,10,17,75,-58,0,1.37280246616865,-25,0
19,1,10,4,95,-91,0,0.976989972929005,-45,0
19,1,10,66,0,66,0,0.829127437798888,50,0
19,1,10,56,7,49,0,0.766314103326295,43,0
19,1,1.5,96,17,79,0,0.569808457497857,33,0
19,1,1.5,40,58,-18,1,1.2138439911796,8,0
19,1,1.5,92,26,66,0,0.807996363786515,24,0
19,1,1.5,95,40,55,0,0.786894247503369,10,0
19,1,1.5,5,95,-90,0,0.926326052969671,-45,0
19,1,1.5,5,74,-69,0,0.698893924927688,-24,0
19,1,1.5,34,78,-44,0,0.48171649654978,-28,0
19,1,1.5,87,49,38,0,1.4573212639516,1,0
19,1,1.5,88,23,65,0,0.882027700456092,27,0
19,1,1.5,100,12,88,0,0.673402697459096,38,0
19,1,10,4,86,-82,0,2.58466486934049,-36,0
19,1,10,32,54,-22,0,1.56420458813955,-4,0
19,1,10,97,50,47,0,1.14418160525383,0,0
19,1,10,81,30,51,0,0.613920234303805,20,0
19,1,10,80,33,47,0,1.51196962005633,17,0
19,1,1.5,50,10,40,0,1.22806150034012,40,0
19,1,1.5,92,33,59,0,0.749983046902344,17,0
19,1,1.5,86,36,50,0,0.722919671650743,14,0
19,1,1.5,82,3,79,0,0.888816270569805,47,0
19,1,1.5,30,61,-31,1,1.45619961035845,11,0
19,1,10,2,51,-49,0,1.30437463230919,-1,0
19,1,10,0,97,-97,0,0.942440476297634,-47,0
19,1,10,51,12,39,0,1.26777976733865,38,0
19,1,10,98,46,52,0,1.42015200972673,4,0
19,1,10,56,41,15,0,1.35737239815353,9,0
19,1,10,17,67,-50,0,1.54412295669317,-17,0
19,1,10,93,7,86,0,1.80560496899125,43,0
19,1,10,16,93,-77,0,2.12039705070492,-43,0
19,1,10,11,60,-49,0,1.47064218333981,-10,0
19,1,10,84,15,69,0,1.03803945214895,35,0
19,1,1.5,73,49,24,0,1.15063147997716,1,0
19,1,1.5,100,43,57,0,0.80346063124307,7,0
19,1,1.5,91,40,51,NaN,NaN,0,0
19,1,1.5,98,38,60,0,1.12630589253968,12,0
19,1,1.5,17,52,-35,0,0.499238118631183,-2,0
19,1,10,91,0,91,0,0.799947582854657,50,0
19,1,10,7,81,-74,0,1.33807958973921,-31,0
19,1,10,11,87,-76,0,1.03886676330876,-37,0
19,1,10,93,7,86,0,1.43161230372789,43,0
19,1,10,86,37,49,0,1.52097583861905,13,0
19,1,1.5,66,17,49,0,1.38915881478169,33,0
19,1,1.5,9,93,-84,0,1.28777012698993,-43,0
19,1,1.5,95,21,74,0,0.51117456558859,29,0
19,1,1.5,93,41,52,0,0.61392096740019,9,0
19,1,1.5,75,16,59,0,0.9754423842096,34,0
19,1,10,72,28,44,0,0.913448296720162,22,0
19,1,10,51,36,15,0,0.814842482810491,14,0
19,1,10,92,31,61,0,0.912299884730601,19,0
19,1,10,12,62,-50,0,0.901889033266343,-12,0
19,1,10,11,98,-87,0,0.747929980963818,-48,0
19,1,1.5,45,50,-5,0,1.15125022223219,0,0
19,1,1.5,81,40,41,0,0.787307353239157,10,0
19,1,1.5,85,32,53,0,0.622278386363178,18,0
19,1,1.5,50,90,-40,0,0.423472250986379,-40,0
19,1,1.5,19,78,-59,0,0.82490254259028,-28,0
19,1,10,43,98,-55,0,0.865723402428557,-48,0
19,1,10,68,36,32,0,1.80120082915528,14,0
19,1,10,1,52,-51,0,0.796095472513116,-2,0
19,1,10,2,84,-82,0,0.934122645121533,-34,0
19,1,10,63,46,17,0,1.802714328398,4,0
19,1,1.5,88,36,52,0,0.659683701014728,14,0
19,1,1.5,56,13,43,0,1.10046423994936,37,0
19,1,1.5,56,26,30,0,0.882349900930421,24,0
19,1,1.5,70,49,21,NaN,NaN,0,0
19,1,1.5,21,74,-53,0,0.601570315033314,-24,0
19,1,10,81,23,58,0,1.45753313184832,27,0
19,1,10,84,49,35,1,1.36150675466342,-1,0
19,1,10,13,53,-40,0,1.30105842312332,-3,0
19,1,10,98,42,56,0,1.45894619546016,8,0
19,1,10,88,36,52,0,0.987162931181956,14,0
19,1,1.5,2,72,-70,0,0.549995876281173,-22,0
19,1,1.5,28,50,-22,0,0.722085762507049,0,0
19,1,1.5,9,52,-43,0,0.783458175341366,-2,0
19,1,1.5,63,11,52,0,0.514726468638401,39,0
19,1,1.5,23,89,-66,0,0.62429956215783,-39,0
19,1,10,53,25,28,0,1.30444244469982,25,0
19,1,10,73,20,53,0,1.01454704072967,30,0
19,1,10,67,42,25,0,0.815719278689357,8,0
19,1,10,94,31,63,0,1.07414276890631,19,0
19,1,10,90,19,71,0,0.777267087352811,31,0
19,1,1.5,62,2,60,0,0.748869457485853,48,0
19,1,1.5,0,89,-89,0,0.552911809063517,-39,0
19,1,1.5,69,37,32,0,0.764870982355205,13,0
19,1,1.5,95,29,66,0,0.688280369417043,21,0
19,1,1.5,86,27,59,0,0.991033002632321,23,0
19,1,10,36,80,-44,1,2.43246967227606,30,0
19,1,10,93,37,56,0,1.36126299660827,13,0
19,1,10,39,59,-20,0,1.78934099186154,-9,0
19,1,10,22,84,-62,0,1.88822905193956,-34,0
19,1,10,66,36,30,0,1.69507993615116,14,0
19,1,1.5,59,38,21,0,0.796340696775587,12,0
19,1,1.5,50,40,10,0,0.607241263656761,10,0
19,1,1.5,98,47,51,0,0.545196225240943,3,0
19,1,1.5,85,34,51,0,0.494302476246958,16,0
19,1,1.5,61,17,44,0,0.725018556768191,33,0
19,1,1.5,34,97,-63,0,0.995134735901956,-47,0
19,1,1.5,74,5,69,0,0.933950731545337,45,0
19,1,1.5,98,14,84,0,0.730689138828893,36,0
19,1,1.5,11,88,-77,0,0.751221264508786,-38,0
19,1,1.5,97,23,74,0,0.819278879382182,27,0
19,1,10,81,22,59,0,0.692214954280644,28,0
19,1,10,44,93,-49,0,1.53077417923487,-43,0
19,1,10,88,39,49,0,1.0635050208657,11,0
19,1,10,48,71,-23,1,1.92714749928564,21,0
19,1,10,13,92,-79,0,1.18031607904413,-42,0
19,1,1.5,100,15,85,0,0.829189751893864,35,0
19,1,1.5,50,14,36,0,0.838151250951341,36,0
19,1,1.5,95,41,54,0,0.742593329094234,9,0
19,1,1.5,66,13,53,0,0.651398859641631,37,0
19,1,1.5,99,7,92,0,0.72297795364284,43,0
19,1,10,88,26,62,0,1.15162740575033,24,0
19,1,10,5,94,-89,0,0.907673613473889,-44,0
19,1,10,76,38,38,0,1.04184977538534,12,0
19,1,10,58,34,24,0,1.23457588847668,16,0
19,1,10,42,78,-36,0,0.93938048799464,-28,0
19,1,10,9,96,-87,0,0.982951598445652,-46,0
19,1,10,50,0,50,0,1.04972994173295,50,0
19,1,10,7,87,-80,0,0.721595313982107,-37,0
19,1,10,65,47,18,0,0.799132001411635,3,0
19,1,10,91,46,45,0,1.55321384912531,4,0
19,1,1.5,21,85,-64,0,1.00470911234152,-35,0
19,1,1.5,12,73,-61,0,0.734187158523127,-23,0
19,1,1.5,91,22,69,0,0.794698170720949,28,0
19,1,1.5,97,48,49,0,0.493454271534574,2,0
19,1,1.5,86,27,59,0,0.828206288962974,23,0
19,1,10,92,9,83,0,0.963757026373059,41,0
19,1,10,37,58,-21,0,1.46300944058748,-8,0
19,1,10,91,14,77,0,1.11076805779885,36,0
19,1,10,39,87,-48,0,0.804749799761339,-37,0
19,1,10,14,72,-58,0,0.710785652365303,-22,0
19,1,1.5,91,21,70,0,1.13161505288735,29,0
19,1,1.5,73,35,38,0,0.904367667782935,15,0
19,1,1.5,76,16,60,0,0.686674132128246,34,0
19,1,1.5,65,48,17,0,0.796458360448014,2,0
19,1,1.5,8,82,-74,0,0.726450314599788,-32,0
20,1,1.5,100,0,100,0,0.693276468489785,50,0
20,1,1.5,80,45,35,1,1.39531176403398,-5,0
20,1,1.5,48,100,-52,0,0.901933026791085,-50,0
20,1,1.5,25,55,-30,0,0.884556862758473,-5,0
20,1,1.5,53,40,13,1,1.06787238758989,-10,0
20,1,10,100,15,85,0,1.27501287520863,35,0
20,1,10,53,0,53,0,1.43496529641561,50,0
20,1,10,50,100,-50,1,2.92499372275779,50,0
20,1,10,28,85,-57,0,2.65883534541354,-35,0
20,1,10,53,23,30,1,1.94752071489347,-27,0
20,1,1.5,48,80,-32,NaN,NaN,0,0
20,1,1.5,85,15,70,0,0.54404284292832,35,0
20,1,1.5,5,83,-78,0,0.901293388626073,-33,0
20,1,1.5,3,100,-97,0,0.435979920090176,-50,0
20,1,1.5,48,60,-12,1,0.685955635912251,10,0
20,1,10,30,100,-70,0,1.0925118351588,-50,0
20,1,10,0,68,-68,0,0.547806994232815,-18,0
20,1,10,98,38,60,0,0.888246603426524,12,0
20,1,10,75,0,75,0,0.727701463096309,50,0
20,1,10,50,43,7,1,0.900879914755933,-7,0
20,1,1.5,60,47,13,1,0.666257347096689,-3,0
20,1,1.5,96,3,93,0,0.738158905180171,47,0
20,1,1.5,49,87,-38,0,0.791425183415413,-37,0
20,1,1.5,93,37,56,0,0.794789056875743,13,0
20,1,1.5,15,79,-64,0,0.47740794433048,-29,0
20,1,10,10,92,-82,0,0.764615364896599,-42,0
20,1,10,53,21,32,0,0.752533718477935,29,0
20,1,10,40,72,-32,0,0.917051579745021,-22,0
20,1,10,39,71,-32,0,0.97911077470053,-21,0
20,1,10,54,17,37,0,0.886430690938141,33,0
20,1,10,94,34,60,0,1.03604076820193,16,0
20,1,10,98,25,73,0,0.604982212884352,25,0
20,1,10,49,83,-34,0,1.34358574909857,-33,0
20,1,10,91,19,72,0,0.788949105713982,31,0
20,1,10,65,14,51,0,0.640387741674203,36,0
20,1,1.5,83,16,67,0,1.24860846629599,34,0
20,1,1.5,74,37,37,0,0.737355417048093,13,0
20,1,1.5,100,26,74,0,0.582611739693675,24,0
20,1,1.5,91,33,58,0,0.833975598448887,17,0
20,1,1.5,94,23,71,0,0.507256135635544,27,0
20,1,10,32,56,-24,1,1.3483777201036,6,0
20,1,10,79,29,50,0,0.624998671235517,21,0
20,1,10,92,5,87,0,0.586954314436298,45,0
20,1,10,74,32,42,0,1.05427980230888,18,0
20,1,10,98,45,53,0,0.590901743154973,5,0
20,1,1.5,15,51,-36,0,0.72933666408062,-1,0
20,1,1.5,41,98,-57,0,0.742619877157267,-48,0
20,1,1.5,8,81,-73,0,0.483884234621655,-31,0
20,1,1.5,53,10,43,0,0.747198146709707,40,0
20,1,1.5,36,98,-62,0,0.59180163522251,-48,0
20,1,10,87,38,49,0,0.865203868597746,12,0
20,1,10,33,59,-26,0,2.54513737559319,-9,0
20,1,10,99,45,54,0,1.06161456397967,5,0
20,1,10,100,40,60,0,0.629705601546448,10,0
20,1,10,3,76,-73,0,0.855008513201028,-26,0
20,1,1.5,21,95,-74,0,1.17491188942222,-45,0
20,1,1.5,41,54,-13,0,0.442885079537518,-4,0
20,1,1.5,21,58,-37,0,0.556167742819525,-8,0
20,1,1.5,37,86,-49,0,0.560771304590162,-36,0
20,1,1.5,7,58,-51,0,0.445446931116749,-8,0
20,1,10,32,66,-34,0,6.77975261217216,-16,0
20,1,10,96,34,62,0,0.919234413653612,16,0
20,1,10,35,80,-45,0,2.6291414736188,-30,0
20,1,10,91,26,65,0,0.814423931646161,24,0
20,1,10,68,34,34,0,1.56839637772646,16,0
20,1,1.5,7,65,-58,0,0.58763940539211,-15,0
20,1,1.5,60,8,52,0,0.518891684885602,42,0
20,1,1.5,0,61,-61,0,0.548933783720713,-11,0
20,1,1.5,83,42,41,1,0.985353569616564,-8,0
20,1,1.5,90,24,66,0,0.692801413417328,26,0
20,1,1.5,3,50,-47,0,0.418056123191491,0,0
20,1,1.5,31,60,-29,0,1.04411487095058,-10,0
20,1,1.5,65,20,45,0,0.700655216758605,30,0
20,1,1.5,85,35,50,0,0.779257030051667,15,0
20,1,1.5,78,18,60,0,0.646379446552601,32,0
20,1,10,96,35,61,0,1.02247934008483,15,0
20,1,10,90,24,66,0,0.504372449009679,26,0
20,1,10,35,60,-25,0,0.463069053424988,-10,0
20,1,10,94,26,68,0,0.527002809685655,24,0
20,1,10,90,22,68,0,0.532993781380355,28,0
20,1,10,85,17,68,0,0.738037575560156,33,0
20,1,10,13,53,-40,0,0.495454903692007,-3,0
20,1,10,91,32,59,0,1.11011123104254,18,0
20,1,10,50,38,12,1,1.98053044144763,-12,0
20,1,10,0,95,-95,0,0.920009677007329,-45,0
20,1,1.5,23,67,-44,0,0.564637724717613,-17,0
20,1,1.5,23,66,-43,0,0.720456873881631,-16,0
20,1,1.5,53,43,10,1,0.854371074412484,-7,0
20,1,1.5,84,18,66,0,0.559130238776561,32,0
20,1,1.5,21,81,-60,0,0.475786305905785,-31,0
20,1,10,71,39,32,0,0.520865949045401,11,0
20,1,10,15,86,-71,0,0.494971417880151,-36,0
20,1,10,90,48,42,0,0.589660955127329,2,0
20,1,10,51,28,23,0,0.464894129778259,22,0
20,1,10,93,23,70,0,0.568873998592608,27,0
20,1,1.5,8,100,-92,NaN,NaN,0,0
20,1,1.5,99,23,76,0,0.620705947920214,27,0
20,1,1.5,51,34,17,0,0.350507403491065,16,0
20,1,1.5,80,30,50,0,1.04327729321085,20,0
20,1,1.5,71,48,23,0,0.388464520219713,2,0
20,1,1.5,13,88,-75,0,0.381957072764635,-38,0
20,1,1.5,41,88,-47,0,0.37702434475068,-38,0
20,1,1.5,97,27,70,0,0.269150930747855,23,0
20,1,1.5,92,19,73,0,0.364856924512424,31,0
20,1,1.5,18,100,-82,0,0.400837211171165,-50,0
20,1,10,92,45,47,0,0.746931661386043,5,0
20,1,10,70,9,61,0,0.695561204571277,41,0
20,1,10,13,85,-72,0,0.64601069240598,-35,0
20,1,10,35,97,-62,0,0.518692279059906,-47,0
20,1,10,22,55,-33,0,1.10074905474903,-5,0
20,1,1.5,95,25,70,0,0.993972372787539,25,0
20,1,1.5,62,1,61,0,0.469306716579013,49,0
20,1,1.5,13,54,-41,0,0.285206764412578,-4,0
20,1,1.5,8,83,-75,0,0.307865349808708,-33,0
20,1,1.5,30,68,-38,0,0.513733892235905,-18,0
20,1,10,31,99,-68,0,0.4863368528313,-49,0
20,1,10,2,82,-80,0,0.501727756054606,-32,0
20,1,10,97,36,61,0,0.580344598158263,14,0
20,1,10,51,48,3,1,1.06297521537635,-2,0
20,1,10,93,19,74,0,0.638266489026137,31,0
20,1,1.5,79,45,34,0,0.647939137241337,5,0
20,1,1.5,84,6,78,0,0.688056728045922,44,0
20,1,1.5,27,65,-38,0,0.44665766163962,-15,0
20,1,1.5,67,44,23,0,0.494609628338367,6,0
20,1,1.5,22,86,-64,0,0.637249299441464,-36,0
20,1,10,35,93,-58,0,1.08579838386504,-43,0
20,1,10,88,22,66,0,1.06112044811016,28,0
20,1,10,86,21,65,0,0.644912494171876,29,0
20,1,10,76,35,41,0,1.05301885376684,15,0
20,1,10,89,31,58,0,0.485665324493311,19,0
20,1,10,44,81,-37,0,0.722915356978774,-31,0
20,1,10,47,84,-37,0,0.456130170961842,-34,0
20,1,10,87,20,67,0,0.719996481086127,30,0
20,1,10,89,26,63,0,0.446112228091806,24,0
20,1,10,15,57,-42,0,0.453909581934568,-7,0
20,1,1.5,91,10,81,0,0.39801290637115,40,0
20,1,1.5,11,64,-53,0,0.27197486901423,-14,0
20,1,1.5,56,35,21,0,0.26328348799143,15,0
20,1,1.5,80,32,48,0,0.48722024995368,18,0
20,1,1.5,81,19,62,0,0.310374783992302,31,0
20,1,10,96,14,82,0,0.546287624572869,36,0
20,1,10,76,46,30,0,0.406913590210024,4,0
20,1,10,100,47,53,0,0.545011647278443,3,0
20,1,10,80,12,68,0,0.460980057541747,38,0
20,1,10,63,33,30,0,0.508260495844297,17,0
20,1,1.5,94,9,85,0,0.376698477542959,41,0
20,1,1.5,0,61,-61,0,0.388843537890352,-11,0
20,1,1.5,73,32,41,0,0.400135625270195,18,0
20,1,1.5,6,65,-59,0,0.346051563275978,-15,0
20,1,1.5,68,1,67,0,0.374013463559095,49,0
20,1,10,93,40,53,0,0.847097160818521,10,0
20,1,10,11,77,-66,0,1.95921821187949,-27,0
20,1,10,82,12,70,0,0.507855086238123,38,0
20,1,10,76,36,40,0,0.42576880287379,14,0
20,1,10,63,37,26,0,0.475088752107695,13,0
20,1,1.5,18,96,-78,0,0.393020429939497,-46,0
20,1,1.5,89,26,63,0,0.436152567446698,24,0
20,1,1.5,97,7,90,0,0.38090359425405,43,0
20,1,1.5,61,45,16,0,0.408248582796659,5,0
20,1,1.5,67,20,47,0,0.426163215888664,30,0
20,1,1.5,68,12,56,0,0.429090889054351,38,0
20,1,1.5,78,16,62,0,0.381818515073974,34,0
20,1,1.5,77,38,39,0,0.456501857552212,12,0
20,1,1.5,73,8,65,0,0.416252307011746,42,0
20,1,1.5,88,37,51,0,0.45768033125205,13,0
20,1,10,17,98,-81,0,0.865443595452234,-48,0
20,1,10,6,51,-45,0,0.544901314307936,-1,0
20,1,10,96,45,51,0,0.532770916062873,5,0
20,1,10,66,48,18,0,0.625970774563029,2,0
20,1,10,10,88,-78,0,0.515458532550838,-38,0
20,1,10,95,6,89,0,0.726533619512338,44,0
20,1,10,53,36,17,1,1.7157961295452,-14,0
20,1,10,96,27,69,0,1.08923006994883,23,0
20,1,10,98,48,50,0,0.775861999485642,2,0
20,1,10,90,45,45,0,0.563171872054227,5,0
20,1,1.5,0,85,-85,0,0.414418799860869,-35,0
20,1,1.5,1,63,-62,0,0.287606232217513,-13,0
20,1,1.5,96,45,51,0,0.326239642570727,5,0
20,1,1.5,96,3,93,0,0.260333088343032,47,0
20,1,1.5,14,86,-72,0,0.292257079563569,-36,0
20,1,10,53,4,49,0,1.92150632035919,46,0
20,1,10,58,27,31,0,0.47072308434872,23,0
20,1,10,98,43,55,0,1.03808614402078,7,0
20,1,10,91,23,68,0,0.526694537024014,27,0
20,1,10,3,87,-84,0,0.451995799259748,-37,0
20,1,1.5,6,95,-89,0,0.30725503602298,-45,0
20,1,1.5,50,49,1,0,0.425229600747116,1,0
20,1,1.5,78,34,44,0,0.50651312910486,16,0
20,1,1.5,13,70,-57,0,0.416471873293631,-20,0
20,1,1.5,82,39,43,0,0.457626081130002,11,0
20,1,1.5,84,33,51,0,0.503688091179356,17,0
20,1,1.5,98,31,67,0,0.493609300232492,19,0
20,1,1.5,92,23,69,0,0.484266184736043,27,0
20,1,1.5,38,72,-34,0,0.522868071449921,-22,0
20,1,1.5,76,47,29,0,0.696196810575202,3,0
20,1,10,21,91,-70,0,0.549367418047041,-41,0
20,1,10,23,90,-67,0,0.473402233386878,-40,0
20,1,10,60,32,28,0,0.944606604229193,18,0
20,1,10,81,21,60,0,0.676545440859627,29,0
20,1,10,93,43,50,0,0.915891433774959,7,0
21,1,10,3,100,-97,0,1.0927618254791,-50,0
21,1,10,85,15,70,0,1.03480107989162,35,0
21,1,10,48,100,-52,0,1.41211317013949,-50,0
21,1,10,25,55,-30,0,1.2543182905647,-5,0
21,1,10,98,38,60,1,1.58370040741283,-12,0
21,1,1.5,50,100,-50,1,0.802687579824124,50,0
21,1,1.5,100,15,85,1,1.20596238051075,-35,0
21,1,1.5,100,0,100,0,0.536755000299308,50,0
21,1,1.5,75,0,75,1,0.974059282918461,-50,0
21,1,1.5,28,85,-57,NaN,NaN,0,0
21,1,1.5,53,0,53,1,0.425757439690642,-50,0
21,1,1.5,0,68,-68,0,0.403823899745476,-18,0
21,1,1.5,50,43,7,1,0.903167583339382,-7,0
21,1,1.5,53,23,30,1,0.862081921310164,-27,0
21,1,1.5,5,83,-78,0,0.509925754333381,-33,0
21,1,10,53,40,13,0,0.988747867115308,10,0
21,1,10,48,80,-32,0,1.5207724776119,-30,0
21,1,10,30,100,-70,1,1.05486482376,50,0
21,1,10,80,45,35,0,1.60784170695115,5,0
21,1,10,48,60,-12,0,0.754406446998473,-10,0
21,1,1.5,2,62,-60,0,0.28182822879171,-12,0
21,1,1.5,56,39,17,0,0.273592841927893,11,0
21,1,1.5,100,0,100,0,0.60942559025716,50,0
21,1,1.5,10,82,-72,0,0.891992793534882,-32,0
21,1,1.5,50,100,-50,0,0.811494059045799,-50,0
21,1,10,23,96,-73,0,1.19699241785565,-46,0
21,1,10,37,96,-59,0,0.791725758346729,-46,0
21,1,10,85,15,70,0,0.899165538023226,35,0
21,1,10,54,30,24,1,1.12190916406689,-20,0
21,1,10,71,45,26,1,1.15987654437777,-5,0
21,1,10,63,23,40,0,1.41874048102181,27,0
21,1,10,0,95,-95,0,1.28483874339145,-45,0
21,1,10,82,43,39,1,1.19624354632106,-7,0
21,1,10,30,100,-70,0,0.678921449172776,-50,0
21,1,10,56,39,17,0,1.07087300525745,11,0
21,1,1.5,53,40,13,0,0.669956984813325,10,0
21,1,1.5,19,89,-70,0,0.542143355938606,-39,0
21,1,1.5,16,86,-70,0,0.555230828758795,-36,0
21,1,1.5,82,47,35,1,0.536191238963511,-3,0
21,1,1.5,83,15,68,1,0.757636894471943,-35,0
21,1,10,21,98,-77,0,0.920571972092148,-48,0
21,1,10,50,100,-50,0,0.950634964567143,-50,0
21,1,10,19,100,-81,0,0.65933899168158,-50,0
21,1,10,12,90,-78,0,0.652029155753553,-40,0
21,1,10,100,0,100,0,1.13285742304288,50,0
21,1,1.5,53,40,13,1,0.585703262884635,-10,0
21,1,1.5,43,62,-19,0,0.740887539170217,-12,0
21,1,1.5,51,45,6,0,0.634454319020733,5,0
21,1,1.5,96,28,68,0,0.787920552946161,22,0
21,1,1.5,59,15,44,0,0.79929364885902,35,0
21,1,10,67,11,56,0,0.791332078515552,39,0
21,1,10,27,79,-52,0,0.650867543590721,-29,0
21,1,10,72,11,61,0,0.755506844492629,39,0
21,1,10,74,15,59,0,0.608353417483158,35,0
21,1,10,95,35,60,0,0.803046437038574,15,0
21,1,1.5,93,10,83,0,0.644554370141122,40,0
21,1,1.5,63,23,40,0,0.597832928004209,27,0
21,1,1.5,80,45,35,0,0.600667862861883,5,0
21,1,1.5,93,13,80,0,0.723326264938805,37,0
21,1,1.5,96,28,68,0,1.00945528125158,22,0
21,1,1.5,96,39,57,0,0.810922233562451,11,0
21,1,1.5,30,93,-63,0,0.581640369433444,-43,0
21,1,1.5,53,40,13,1,0.904941342072561,-10,0
21,1,1.5,36,67,-31,0,0.69586691132281,-17,0
21,1,1.5,56,39,17,NaN,NaN,0,0
21,1,10,59,15,44,0,0.822599203500431,35,0
21,1,10,33,97,-64,0,0.632892062421888,-47,0
21,1,10,83,6,77,0,0.746231175085995,44,0
21,1,10,5,57,-52,0,0.6069484128966,-7,0
21,1,10,20,87,-67,0,0.71366937860148,-37,0
21,1,10,23,70,-47,0,0.949903321219608,-20,0
21,1,10,80,45,35,0,1.15453730698209,5,0
21,1,10,49,67,-18,0,1.07133193186019,-17,0
21,1,10,26,84,-58,0,0.655390463303775,-34,0
21,1,10,53,40,13,1,0.583989985752851,-10,0
21,1,1.5,85,15,70,1,0.506328018906061,-35,0
21,1,1.5,55,39,16,0,0.521000108099543,11,0
21,1,1.5,90,46,44,0,0.527141367376316,4,0
21,1,1.5,38,61,-23,0,0.725195327948313,-11,0
21,1,1.5,14,92,-78,0,0.867264273168985,-42,0
21,1,10,33,94,-61,0,0.771615095436573,-44,0
21,1,10,28,65,-37,0,0.671554797212593,-15,0
21,1,10,85,15,70,0,0.551876119105145,35,0
21,1,10,51,16,35,1,0.764536189031787,-34,0
21,1,10,89,24,65,0,0.856606325600296,26,0
21,1,1.5,96,28,68,0,0.592751745309215,22,0
21,1,1.5,77,6,71,0,0.580220702628139,44,0
21,1,1.5,57,11,46,0,0.583603636943735,39,0
21,1,1.5,46,96,-50,0,0.586886868346483,-46,0
21,1,1.5,83,6,77,0,0.790336149104405,44,0
21,1,10,74,45,29,1,1.11116177710937,-5,0
21,1,10,56,39,17,1,0.917918115330394,-11,0
21,1,10,3,64,-61,0,0.579974011227023,-14,0
21,1,10,7,61,-54,0,0.831261626677588,-11,0
21,1,10,72,11,61,0,0.952837958931923,39,0
21,1,1.5,93,13,80,0,0.588948372576851,37,0
21,1,1.5,36,98,-62,0,0.496373490022961,-48,0
21,1,1.5,70,50,20,0,0.50296744442312,0,0
21,1,1.5,5,89,-84,0,0.445794425089844,-39,0
21,1,1.5,28,100,-72,0,0.574566594790667,-50,0
21,1,1.5,74,15,59,0,0.904662760382053,35,0
21,1,1.5,50,100,-50,0,0.503446898132097,-50,0
21,1,1.5,21,86,-65,0,0.646174175839406,-36,0
21,1,1.5,35,91,-56,0,0.582871260412503,-41,0
21,1,1.5,27,71,-44,0,0.530299603531603,-21,0
21,1,10,3,54,-51,0,0.942461525439285,-4,0
21,1,10,53,40,13,1,0.811797199945431,-10,0
21,1,10,3,88,-85,0,0.542605214985088,-38,0
21,1,10,13,94,-81,0,1.02788785623852,-44,0
21,1,10,11,76,-65,0,0.566235170525033,-26,0
21,1,1.5,74,15,59,0,0.632211370160803,35,0
21,1,1.5,96,39,57,0,0.529615612351336,11,0
21,1,1.5,91,21,70,0,0.526341544813477,29,0
21,1,1.5,74,50,24,0,0.547747978940606,0,0
21,1,1.5,74,20,54,0,0.847826238314155,30,0
21,1,10,70,50,20,0,1.15985748346429,0,0
21,1,10,16,80,-64,0,0.619994098437019,-30,0
21,1,10,56,5,51,0,1.04542677057907,45,0
21,1,10,22,100,-78,0,0.67012376722414,-50,0
21,1,10,46,60,-14,0,0.877449731575325,-10,0
21,1,10,98,8,90,0,0.851810322550591,42,0
21,1,10,39,57,-18,0,1.12382074742345,-7,0
21,1,10,88,5,83,1,1.0657610319322,-45,0
21,1,10,38,88,-50,0,0.634030948218424,-38,0
21,1,10,28,92,-64,0,0.65073814970674,-42,0
21,1,1.5,97,6,91,0,0.586929022159893,44,0
21,1,1.5,30,100,-70,0,0.558131743455306,-50,0
21,1,1.5,29,51,-22,0,0.538425390492193,-1,0
21,1,1.5,64,3,61,0,0.455158067634329,47,0
21,1,1.5,38,57,-19,0,0.495185485866386,-7,0
21,1,1.5,46,76,-30,0,0.987260387744755,-26,0
21,1,1.5,28,79,-51,0,0.278083138284273,-29,0
21,1,1.5,95,35,60,1,0.733444643788971,-15,0
21,1,1.5,40,68,-28,0,0.370174901618157,-18,0
21,1,1.5,40,63,-23,0,0.557579345360864,-13,0
21,1,10,63,23,40,0,1.09639584989054,27,0
21,1,10,12,97,-85,0,0.863153727608733,-47,0
21,1,10,47,65,-18,0,1.27047639293596,-15,0
21,1,10,19,86,-67,0,0.821947469026782,-36,0
21,1,10,55,39,16,0,0.815360845706891,11,0
21,1,1.5,64,3,61,0,0.784125977545045,47,0
21,1,1.5,77,39,38,0,0.915528911107685,11,0
21,1,1.5,0,85,-85,0,1.04899994679727,-35,0
21,1,1.5,96,28,68,0,0.489747278741561,22,0
21,1,1.5,30,86,-56,0,0.504477650276385,-36,0
21,1,10,29,85,-56,0,0.661911106784828,-35,0
21,1,10,70,50,20,1,0.877410510205664,0,0
21,1,10,63,30,33,0,0.852017426048405,20,0
21,1,10,58,5,53,0,0.88414962036768,45,0
21,1,10,3,68,-65,0,0.634891252324451,-18,0
21,1,1.5,74,15,59,0,0.433742103050463,35,0
21,1,1.5,31,78,-47,0,0.435150773148052,-28,0
21,1,1.5,82,46,36,0,0.355711748648901,4,0
21,1,1.5,41,56,-15,0,0.959842088224832,-6,0
21,1,1.5,70,50,20,1,0.716650935355574,0,0
21,1,10,84,7,77,0,0.649350739782676,43,0
21,1,10,72,17,55,0,0.657427408441436,33,0
21,1,10,95,43,52,0,0.513453111227136,7,0
21,1,10,83,6,77,0,0.542935480887536,44,0
21,1,10,94,39,55,0,0.619773065904155,11,0
21,1,10,98,9,89,0,0.569196566822939,41,0
21,1,10,25,73,-48,0,1.25263690360589,-23,0
21,1,10,93,10,83,0,0.669407885696273,40,0
21,1,10,70,50,20,1,0.948761869512964,0,0
21,1,10,16,62,-46,0,0.66470425442094,-12,0
21,1,1.5,3,86,-83,0,0.663714556430932,-36,0
21,1,1.5,0,92,-92,0,0.751044039730914,-42,0
21,1,1.5,21,55,-34,0,0.451185346581042,-5,0
21,1,1.5,8,56,-48,0,0.49923481681617,-6,0
21,1,1.5,68,8,60,0,0.905194997962099,42,0
21,1,10,30,100,-70,0,0.5581148819183,-50,0
21,1,10,14,91,-77,0,0.666185502370354,-41,0
21,1,10,100,47,53,0,0.441587475594133,3,0
21,1,10,98,26,72,0,0.594303371733986,24,0
21,1,10,23,57,-34,0,0.901021771482192,-7,0
21,1,1.5,77,6,71,0,0.875093883834779,44,0
21,1,1.5,95,44,51,0,0.610608462651726,6,0
21,1,1.5,3,66,-63,0,0.485285940230824,-16,0
21,1,1.5,97,11,86,0,0.540021003631409,39,0
21,1,1.5,30,50,-20,0,0.95364291331498,0,0
21,1,10,22,91,-69,0,0.586962745175697,-41,0
21,1,10,31,72,-41,0,0.493734661955386,-22,0
21,1,10,95,14,81,0,0.540298485546373,36,0
21,1,10,12,52,-40,0,0.497113564168103,-2,0
21,1,10,99,3,96,0,0.687238577695098,47,0
21,1,1.5,88,42,46,0,1.15800381579902,8,0
21,1,1.5,50,34,16,0,0.737925776280463,16,0
21,1,1.5,72,17,55,0,0.774797157733701,33,0
21,1,1.5,0,50,-50,0,0.626258153526578,0,0
21,1,1.5,42,86,-44,0,0.963657557207625,-36,0
21,1,1.5,100,3,97,0,0.421118322061375,47,0
21,1,1.5,86,6,80,0,0.638715518638492,44,0
21,1,1.5,68,50,18,1,0.791237140831072,0,0
21,1,1.5,97,10,87,0,0.625971507688519,40,0
21,1,1.5,89,42,47,0,0.77952094952343,8,0
21,1,10,95,14,81,0,0.557673183444422,36,0
21,1,10,48,94,-46,0,0.857646241609473,-44,0
21,1,10,41,85,-44,0,1.20966971578309,-35,0
21,1,10,61,29,32,0,0.715592691616621,21,0
21,1,10,44,75,-31,0,0.625176450295839,-25,0
22,1,1.5,28,85,-57,0,0.679701477754861,-35,0
22,1,1.5,0,68,-68,0,0.590322219999507,-18,0
22,1,1.5,30,100,-70,0,0.777595070539974,-50,0
22,1,1.5,53,23,30,0,0.812839681748301,27,0
22,1,1.5,50,43,7,1,0.975544196378905,-7,0
22,1,10,50,100,-50,1,3.5234409965924,50,0
22,1,10,25,55,-30,0,3.08134107739897,-5,0
22,1,10,48,60,-12,1,4.10465139721055,10,0
22,1,10,5,83,-78,0,1.07992031099275,-33,0
22,1,10,53,40,13,1,1.91119440051261,-10,0
22,1,1.5,53,0,53,0,0.99714710394619,50,0
22,1,1.5,75,0,75,0,0.696410878619645,50,0
22,1,1.5,48,100,-52,1,1.46373288420727,50,0
22,1,1.5,100,0,100,0,1.11961709684692,50,0
22,1,1.5,98,38,60,0,0.877676262403838,12,0
22,1,10,100,15,85,0,1.24421054177219,35,0
22,1,10,85,15,70,0,1.51018270920031,35,0
22,1,10,48,80,-32,1,1.33274415752385,30,0
22,1,10,3,100,-97,0,0.834771022375207,-50,0
22,1,10,80,45,35,1,1.56401421496412,-5,0
22,1,1.5,94,33,61,0,1.18928413675167,17,0
22,1,1.5,96,13,83,0,0.952588335087057,37,0
22,1,1.5,8,64,-56,0,1.14119287929498,-14,0
22,1,1.5,69,48,21,1,1.11452858301345,-2,0
22,1,1.5,89,36,53,NaN,NaN,0,0
22,1,10,98,20,78,0,2.05699963896768,30,0
22,1,10,27,64,-37,0,1.33765562542249,-14,0
22,1,10,18,50,-32,0,1.36681579338619,0,0
22,1,10,86,40,46,1,1.21084928920027,-10,0
22,1,10,32,54,-22,0,1.18948097672546,-4,0
22,1,1.5,19,63,-44,0,0.429488967638463,-13,0
22,1,1.5,53,24,29,0,0.670752408739645,26,0
22,1,1.5,98,33,65,0,0.742654699890409,17,0
22,1,1.5,94,42,52,0,0.708032132184599,8,0
22,1,1.5,99,8,91,0,0.738549286092166,42,0
22,1,10,89,36,53,0,2.07923778594704,14,0
22,1,10,47,59,-12,1,1.23846076306654,9,0
22,1,10,96,24,72,0,0.807639368751552,26,0
22,1,10,16,77,-61,0,0.954425507807173,-27,0
22,1,10,39,97,-58,0,1.55167341430206,-47,0
22,1,1.5,65,42,23,1,0.862228909798432,-8,0
22,1,1.5,49,88,-39,1,0.902082947664894,38,0
22,1,1.5,96,25,71,0,0.740795167337637,25,0
22,1,1.5,24,58,-34,0,0.546156031370629,-8,0
22,1,1.5,53,32,21,0,0.854617399279959,18,0
22,1,10,33,54,-21,0,0.798659875639714,-4,0
22,1,10,65,40,25,0,1.88128426141338,10,0
22,1,10,77,31,46,0,1.32858999195741,19,0
22,1,10,74,3,71,0,0.637862179079093,47,0
22,1,10,29,76,-47,0,1.84711622173199,-26,0
22,1,10,61,22,39,0,2.64576326793758,28,0
22,1,10,91,34,57,0,2.12633421365172,16,0
22,1,10,42,72,-30,1,1.71629611030221,22,0
22,1,10,68,18,50,0,0.914261364552658,32,0
22,1,10,25,60,-35,0,1.80820312997093,-10,0
22,1,1.5,82,3,79,0,0.530153348227032,47,0
22,1,1.5,12,61,-49,0,0.607463055872358,-11,0
22,1,1.5,82,46,36,1,0.842062164039817,-4,0
22,1,1.5,88,13,75,0,0.603377435996663,37,0
22,1,1.5,90,16,74,0,0.533896239358,34,0
22,1,10,89,45,44,1,1.80982403532835,-5,0
22,1,10,56,29,27,0,0.84457563032629,21,0
22,1,10,48,89,-41,1,1.99775118625257,39,0
22,1,10,28,77,-49,0,0.808445789327379,-27,0
22,1,10,60,49,11,1,2.81901869614376,-1,0
22,1,1.5,77,25,52,0,0.660291301144753,25,0
22,1,1.5,95,20,75,0,0.988957536465023,30,0
22,1,1.5,80,29,51,0,0.848210021213163,21,0
22,1,1.5,42,89,-47,1,0.82476114371093,39,0
22,1,1.5,70,23,47,0,0.962790288496763,27,0
22,1,1.5,75,49,26,1,0.844654439599253,-1,0
22,1,1.5,7,75,-68,0,1.22204900468932,-25,0
22,1,1.5,99,19,80,0,1.15196482540341,31,0
22,1,1.5,70,37,33,NaN,NaN,0,0
22,1,1.5,66,3,63,0,0.517157514113933,47,0
22,1,10,99,25,74,0,1.11369687016122,25,0
22,1,10,76,42,34,1,0.847804978198837,-8,0
22,1,10,44,94,-50,1,0.984242541948333,44,0
22,1,10,6,50,-44,0,0.85158159234561,0,0
22,1,10,2,85,-83,0,0.788325962552335,-35,0
22,1,10,87,25,62,0,1.38959130970761,25,0
22,1,10,47,100,-53,1,0.856839454441797,50,0
22,1,10,75,10,65,0,3.57742938777665,40,0
22,1,10,94,3,91,0,0.669317346648313,47,0
22,1,10,77,19,58,0,1.12539546680637,31,0
22,1,1.5,72,30,42,1,0.746647947933525,-20,0
22,1,1.5,3,63,-60,0,0.495199781551491,-13,0
22,1,1.5,9,66,-57,0,0.494514324003831,-16,0
22,1,1.5,78,34,44,1,0.677885565208271,-16,0
22,1,1.5,93,28,65,1,0.877820318506565,-22,0
22,1,1.5,93,13,80,0,0.563733800547197,37,0
22,1,1.5,7,60,-53,0,0.519756021094508,-10,0
22,1,1.5,83,42,41,1,0.733695000701118,-8,0
22,1,1.5,40,85,-45,1,0.754991468449589,35,0
22,1,1.5,37,55,-18,1,0.791573638096452,5,0
22,1,10,16,61,-45,0,0.730182306026109,-11,0
22,1,10,44,67,-23,1,1.47965822432889,17,0
22,1,10,12,69,-57,0,0.622744725726079,-19,0
22,1,10,69,27,42,0,0.944731965952087,23,0
22,1,10,21,71,-50,0,0.590041805582587,-21,0
22,1,10,95,43,52,1,1.33525835699402,-7,0
22,1,10,85,28,57,0,0.779856347187888,22,0
22,1,10,44,69,-25,1,1.32719671714585,19,0
22,1,10,62,15,47,0,0.693042973056436,35,0
22,1,10,19,91,-72,0,0.996453582250979,-41,0
22,1,1.5,34,70,-36,0,0.790403228602372,-20,0
22,1,1.5,68,18,50,0,0.689570232818369,32,0
22,1,1.5,89,26,63,0,0.880824601685163,24,0
22,1,1.5,100,29,71,0,0.727591496659443,21,0
22,1,1.5,10,89,-79,0,0.581517940096091,-39,0
22,1,1.5,98,27,71,0,0.718829737103079,23,0
22,1,1.5,15,91,-76,0,0.476081015949603,-41,0
22,1,1.5,12,58,-46,0,0.459392508724704,-8,0
22,1,1.5,7,53,-46,0,0.436067526752595,-3,0
22,1,1.5,68,38,30,1,0.724723938445095,-12,0
22,1,10,89,18,71,0,0.873298498452641,32,0
22,1,10,39,82,-43,1,1.59246253350284,32,0
22,1,10,5,55,-50,0,0.523801686533261,-5,0
22,1,10,45,83,-38,1,1.09780305379536,33,0
22,1,10,96,29,67,0,0.896296146966051,21,0
22,1,1.5,43,98,-55,1,0.848917838535272,48,0
22,1,1.5,91,21,70,0,0.721819358121138,29,0
22,1,1.5,5,55,-50,0,0.567003102914896,-5,0
22,1,1.5,3,72,-69,0,0.514895137806889,-22,0
22,1,1.5,86,12,74,0,0.656897003587801,38,0
22,1,10,96,19,77,0,0.767988402221818,31,0
22,1,10,35,54,-19,1,1.71543507307069,4,0
22,1,10,41,72,-31,1,0.752576605416834,22,0
22,1,10,7,62,-55,0,0.628568181942683,-12,0
22,1,10,26,51,-25,0,1.66985031735385,-1,0
22,1,10,10,76,-66,0,1.3397116313572,-26,0
22,1,10,11,66,-55,0,0.512519129551947,-16,0
22,1,10,40,79,-39,1,0.821840435033664,29,0
22,1,10,43,80,-37,1,0.863104975840542,30,0
22,1,10,92,38,54,0,1.23891345824813,12,0
22,1,1.5,90,12,78,0,0.678451525862329,38,0
22,1,1.5,64,25,39,0,0.7895198315382,25,0
22,1,1.5,99,41,58,0,0.424259696737863,9,0
22,1,1.5,21,92,-71,0,0.561502214870416,-42,0
22,1,1.5,13,74,-61,0,0.429387431882787,-24,0
22,1,1.5,92,34,58,1,0.772115442785434,-16,0
22,1,1.5,96,41,55,1,0.559394524781965,-9,0
22,1,1.5,94,22,72,0,0.59516917419387,28,0
22,1,1.5,17,88,-71,0,0.589947600965388,-38,0
22,1,1.5,95,17,78,0,0.729237694293261,33,0
22,1,10,10,69,-59,0,0.557084862899501,-19,0
22,1,10,94,35,59,1,1.65717338596005,-15,0
22,1,10,98,29,69,1,1.44908938620938,-21,0
22,1,10,89,22,67,0,0.816956458787899,28,0
22,1,10,78,16,62,0,0.842361272720154,34,0
22,1,10,9,90,-81,0,0.752978349395562,-40,0
22,1,10,86,15,71,0,0.556910749408416,35,0
22,1,10,21,63,-42,0,0.752901739440858,-13,0
22,1,10,80,20,60,0,0.724815210560337,30,0
22,1,10,10,88,-78,0,0.538138378120493,-38,0
22,1,1.5,48,98,-50,1,0.613400144095067,48,0
22,1,1.5,59,28,31,0,0.718692645663396,22,0
22,1,1.5,28,95,-67,0,0.843820160836913,-45,0
22,1,1.5,42,75,-33,1,0.684663163614459,25,0
22,1,1.5,34,77,-43,0,0.627918280253652,-27,0
22,1,10,89,43,46,1,1.0611519718077,-7,0
22,1,10,4,74,-70,0,0.653128453646787,-24,0
22,1,10,31,64,-33,0,1.80496388516622,-14,0
22,1,10,5,65,-60,0,0.567006768425927,-15,0
22,1,10,40,70,-30,1,0.946279193798546,20,0
22,1,1.5,79,26,53,0,0.741621381836012,24,0
22,1,1.5,100,11,89,0,0.906227949424647,39,0
22,1,1.5,54,24,30,0,0.744161973241717,26,0
22,1,1.5,17,67,-50,0,0.460764889896382,-17,0
22,1,1.5,50,80,-30,1,0.613180211163126,30,0
22,1,10,3,91,-88,0,0.612047556845937,-41,0
22,1,10,86,26,60,0,1.10928574966965,24,0
22,1,10,46,92,-46,1,0.803088590793777,42,0
22,1,10,52,26,26,0,0.733170094259549,24,0
22,1,10,9,88,-79,0,0.609702339221258,-38,0
22,1,1.5,68,23,45,0,0.570919741003308,27,0
22,1,1.5,100,18,82,0,0.55096119834343,32,0
22,1,1.5,96,22,74,0,0.618404716835357,28,0
22,1,1.5,57,5,52,0,0.499563249992207,45,0
22,1,1.5,46,71,-25,1,1.07359907333739,21,0
22,1,1.5,77,7,70,0,0.622239246673416,43,0
22,1,1.5,96,6,90,0,0.527562905394007,44,0
22,1,1.5,31,76,-45,0,1.13269980443874,-26,0
22,1,1.5,43,80,-37,0,0.68937449256191,-30,0
22,1,1.5,15,83,-68,0,0.520051464322023,-33,0
22,1,10,81,7,74,0,0.644680464989506,43,0
22,1,10,38,67,-29,0,1.70129338867264,-17,0
22,1,10,18,91,-73,0,1.39521426043939,-41,0
22,1,10,38,80,-42,0,1.71785909996834,-30,0
22,1,10,87,14,73,0,1.98711743130116,36,0
22,1,1.5,19,90,-71,0,0.619794692669529,-40,0
22,1,1.5,92,2,90,0,0.685091666178778,48,0
22,1,1.5,90,25,65,0,0.651673597632907,25,0
22,1,1.5,0,88,-88,0,0.563636297010817,-38,0
22,1,1.5,3,71,-68,0,0.486966594005935,-21,0
22,1,10,82,22,60,0,1.85285280441167,28,0
22,1,10,6,62,-56,0,0.516832013439853,-12,0
22,1,10,29,84,-55,1,1.21794102498097,34,0
22,1,10,33,95,-62,1,1.34736089705257,45,0
22,1,10,84,25,59,0,1.53533313417574,25,0
23,1,10,0,68,-68,0,1.88327642547665,-18,0
23,1,10,48,60,-12,1,1.46619014366297,10,0
23,1,10,53,23,30,1,1.48990522691747,-27,0
23,1,10,100,15,85,1,2.07346518355189,-35,0
23,1,10,30,100,-70,1,2.03341085999273,50,0
23,1,1.5,50,43,7,1,0.865996235457715,-7,0
23,1,1.5,25,55,-30,1,1.42589279334061,5,0
23,1,1.5,100,0,100,0,0.771906403591856,50,0
23,1,1.5,28,85,-57,1,0.880054763460066,35,0
23,1,1.5,85,15,70,1,0.967472906864714,-35,0
23,1,10,48,100,-52,1,1.49059801804833,50,0
23,1,10,48,80,-32,1,1.88169326947536,30,0
23,1,10,98,38,60,1,1.15342207660433,-12,0
23,1,10,3,100,-97,0,2.38151640613796,-50,0
23,1,10,75,0,75,0,1.41678827168653,50,0
23,1,1.5,50,100,-50,1,1.01029436290264,50,0
23,1,1.5,53,0,53,0,0.812998081091791,50,0
23,1,1.5,5,83,-78,0,0.870830377971288,-33,0
23,1,1.5,80,45,35,1,0.942892384598963,-5,0
23,1,1.5,53,40,13,1,0.843885201960802,-10,0
23,1,10,84,37,47,1,1.12883495626738,-13,0
23,1,10,38,92,-54,1,1.42183061811375,42,0
23,1,10,4,77,-73,0,0.80862909834832,-27,0
23,1,10,36,85,-49,1,2.18573693360668,35,0
23,1,10,34,69,-35,1,0.941386938502546,19,0
23,1,1.5,68,31,37,1,0.841825889481697,-19,0
23,1,1.5,21,93,-72,0,0.979062679281924,-43,0
23,1,1.5,63,19,44,NaN,NaN,0,0
23,1,1.5,89,30,59,1,0.51119480811758,-20,0
23,1,1.5,67,28,39,1,0.621851511765271,-22,0
23,1,1.5,81,19,62,1,0.548314483196009,-31,0
23,1,1.5,49,61,-12,1,0.833149138838053,11,0
23,1,1.5,42,77,-35,1,1.15426735504298,27,0
23,1,1.5,65,9,56,0,0.839163592201658,41,0
23,1,1.5,26,67,-41,0,1.20812508359086,-17,0
23,1,10,28,79,-51,0,3.98613061493961,-29,0
23,1,10,7,99,-92,0,0.885253629356157,-49,0
23,1,10,64,23,41,1,1.26054444583133,-27,0
23,1,10,0,54,-54,0,0.869543765904382,-4,0
23,1,10,5,62,-57,0,5.72538273042301,-12,0
23,1,1.5,57,49,8,1,0.826506041747052,-1,0
23,1,1.5,11,88,-77,0,0.716636700730305,-38,0
23,1,1.5,40,80,-40,1,0.674670786771458,30,0
23,1,1.5,17,95,-78,0,0.778491584816948,-45,0
23,1,1.5,50,10,40,0,1.2937504008878,40,0
23,1,10,70,44,26,1,0.947746321151499,-6,0
23,1,10,19,71,-52,0,1.72051266540075,-21,0
23,1,10,35,99,-64,0,1.86245420342311,-49,0
23,1,10,69,3,66,0,0.774493556818925,47,0
23,1,10,43,98,-55,1,1.37058496865211,48,0
23,1,1.5,64,47,17,1,0.339620504411869,-3,0
23,1,1.5,41,85,-44,1,0.896771923231427,35,0
23,1,1.5,98,13,85,0,0.93639224441722,37,0
23,1,1.5,42,85,-43,1,0.724810169718694,35,0
23,1,1.5,75,0,75,0,0.690833713626489,50,0
23,1,10,39,82,-43,1,1.38519186468329,32,0
23,1,10,1,68,-67,0,0.61278071324341,-18,0
23,1,10,54,10,44,0,1.77445213601459,40,0
23,1,10,15,76,-61,0,1.45078782079509,-26,0
23,1,10,31,95,-64,1,9.2753390186117,45,0
23,1,1.5,49,64,-15,1,0.551987009239383,14,0
23,1,1.5,41,92,-51,1,0.884365097270347,42,0
23,1,1.5,75,32,43,1,1.33170912304195,-18,0
23,1,1.5,31,59,-28,1,0.929168522357941,9,0
23,1,1.5,2,98,-96,0,0.670656630361918,-48,0
23,1,10,43,90,-47,1,1.30903029401088,40,0
23,1,10,47,87,-40,1,1.76348514255369,37,0
23,1,10,36,83,-47,1,2.14356061647413,33,0
23,1,10,49,100,-51,1,1.90093380177859,50,0
23,1,10,56,0,56,0,0.962936774536502,50,0
23,1,10,75,27,48,1,1.65147804602748,-23,0
23,1,10,44,68,-24,1,0.939483779016882,18,0
23,1,10,1,92,-91,0,0.672025351028424,-42,0
23,1,10,71,27,44,1,3.75206948438426,-23,0
23,1,10,46,91,-45,1,1.21270153712248,41,0
23,1,1.5,40,86,-46,1,0.72539482684806,36,0
23,1,1.5,78,19,59,0,1.25179621682037,31,0
23,1,1.5,8,64,-56,0,0.811426288331859,-14,0
23,1,1.5,35,75,-40,1,1.16459764051251,25,0
23,1,1.5,43,99,-56,1,1.36874595639529,49,0
23,1,1.5,63,13,50,1,1.37088627781486,-37,0
23,1,1.5,48,81,-33,1,0.582286540593486,31,0
23,1,1.5,35,91,-56,1,1.11370791710215,41,0
23,1,1.5,47,60,-13,0,1.31904240872245,-10,0
23,1,1.5,46,99,-53,NaN,NaN,0,0
23,1,10,7,68,-61,0,3.53228461620165,-18,0
23,1,10,53,0,53,0,1.28883598261746,50,0
23,1,10,13,88,-75,0,0.815557742665987,-38,0
23,1,10,33,76,-43,0,1.66459525784012,-26,0
23,1,10,97,23,74,0,1.24800052784849,27,0
23,1,10,68,48,20,1,1.6386320857564,-2,0
23,1,10,7,54,-47,0,1.14327653544024,-4,0
23,1,10,91,2,89,1,1.38800701586297,-48,0
23,1,10,49,58,-9,1,1.00657381798374,8,0
23,1,10,9,53,-44,0,0.856960626377258,-3,0
23,1,1.5,10,63,-53,0,0.520034676184878,-13,0
23,1,1.5,30,58,-28,0,0.69318040611688,-8,0
23,1,1.5,40,83,-43,0,0.850904019083828,-33,0
23,1,1.5,40,90,-50,0,1.2831202725647,-40,0
23,1,1.5,63,16,47,1,0.609743795590475,-34,0
23,1,1.5,67,35,32,1,0.626988063100725,-15,0
23,1,1.5,30,98,-68,0,1.34838156297337,-48,0
23,1,1.5,78,9,69,1,0.49644092307426,-41,0
23,1,1.5,45,74,-29,1,1.2057006812538,24,0
23,1,1.5,5,96,-91,0,0.631372074654792,-46,0
23,1,10,8,93,-85,0,2.59161429497181,-43,0
23,1,10,49,93,-44,1,1.58626734040445,43,0
23,1,10,46,72,-26,1,3.94072677084478,22,0
23,1,10,36,67,-31,1,1.86544053634861,17,0
23,1,10,76,1,75,0,0.904660211584996,49,0
23,1,10,43,65,-22,1,1.81336756970268,15,0
23,1,10,43,87,-44,1,2.93439927860163,37,0
23,1,10,71,49,22,1,4.29114235390443,-1,0
23,1,10,100,26,74,1,2.79378504049964,-24,0
23,1,10,52,34,18,1,4.73248695518123,-16,0
23,1,1.5,11,55,-44,0,0.608367377251852,-5,0
23,1,1.5,51,20,31,1,0.922427921323106,-30,0
23,1,1.5,8,71,-63,0,0.59990579506848,-21,0
23,1,1.5,47,96,-49,1,0.665568831027485,46,0
23,1,1.5,15,72,-57,0,0.625047148263548,-22,0
23,1,1.5,98,13,85,0,1.1829511069227,37,0
23,1,1.5,46,91,-45,1,0.689602818049025,41,0
23,1,1.5,49,92,-43,1,0.616179055301473,42,0
23,1,1.5,62,50,12,1,0.65761456254404,0,0
23,1,1.5,76,39,37,1,0.840909865684807,-11,0
23,1,10,3,62,-59,0,0.776853445335291,-12,0
23,1,10,4,80,-76,0,1.75607557658805,-30,0
23,1,10,81,7,74,0,0.880126975069288,43,0
23,1,10,83,20,63,0,2.14272230258211,30,0
23,1,10,93,46,47,1,0.699980389210396,-4,0
23,1,1.5,59,10,49,0,1.08761754998704,40,0
23,1,1.5,43,64,-21,1,0.798957514285576,14,0
23,1,1.5,100,4,96,0,0.75250018783845,46,0
23,1,1.5,2,88,-86,0,0.692554328241386,-38,0
23,1,1.5,47,72,-25,1,0.635176560957916,22,0
23,1,10,46,53,-7,1,0.811160901677795,3,0
23,1,10,34,50,-16,1,1.08369649882661,0,0
23,1,10,84,3,81,0,2.05041613284266,47,0
23,1,10,97,31,66,1,2.84225329395849,-19,0
23,1,10,90,32,58,1,0.690732910705265,-18,0
23,1,1.5,39,82,-43,1,0.759605878789444,32,0
23,1,1.5,96,45,51,1,0.650802849617321,-5,0
23,1,1.5,39,56,-17,1,0.634941598400474,6,0
23,1,1.5,13,75,-62,0,0.548082453140523,-25,0
23,1,1.5,85,32,53,1,0.664109937555622,-18,0
23,1,10,2,58,-56,0,1.07870327099226,-8,0
23,1,10,42,68,-26,0,1.82911885395879,-18,0
23,1,10,48,61,-13,1,0.701821234251838,11,0
23,1,10,74,26,48,1,3.05211402097484,-24,0
23,1,10,72,1,71,0,2.64417954650708,49,0
23,1,1.5,66,12,54,0,0.745977321173996,38,0
23,1,1.5,43,58,-15,1,0.597184115671553,8,0
23,1,1.5,27,51,-24,1,0.574396786047146,1,0
23,1,1.5,79,47,32,1,0.577688460238278,-3,0
23,1,1.5,42,95,-53,1,0.789105951203965,45,0
23,1,10,46,65,-19,1,0.862346435838845,15,0
23,1,10,80,31,49,1,2.82128921459662,-19,0
23,1,10,17,96,-79,0,3.52629472216358,-46,0
23,1,10,35,87,-52,1,4.4988517628517,37,0
23,1,10,87,27,60,1,2.68874947534641,-23,0
23,1,1.5,64,20,44,1,0.844147289579269,-30,0
23,1,1.5,47,61,-14,1,0.732504916435573,11,0
23,1,1.5,10,94,-84,0,0.72949402424274,-44,0
23,1,1.5,73,0,73,0,0.901271400041878,50,0
23,1,1.5,35,65,-30,1,0.76334951678291,15,0
23,1,10,25,94,-69,0,1.12529439042555,-44,0
23,1,10,12,70,-58,0,1.09800135256955,-20,0
23,1,10,41,61,-20,1,4.471877995471,11,0
23,1,10,45,77,-32,1,3.29516164213419,27,0
23,1,10,43,98,-55,1,4.42891614849214,48,0
23,1,1.5,39,65,-26,0,0.931815057760105,-15,0
23,1,1.5,51,41,10,1,0.608277204388287,-9,0
23,1,1.5,57,9,48,0,0.801753604609985,41,0
23,1,1.5,43,76,-33,1,0.722211653192062,26,0
23,1,1.5,43,52,-9,1,0.550875977554824,2,0
23,1,10,16,88,-72,1,5.6579125727294,38,0
23,1,10,88,29,59,1,4.53722579311579,-21,0
23,1,10,14,65,-51,0,5.08524813101394,-15,0
23,1,10,25,55,-30,1,3.75535419402877,5,0
23,1,10,66,12,54,0,3.43864198273513,38,0
23,1,1.5,75,47,28,1,0.964533859689254,-3,0
23,1,1.5,63,12,51,0,0.814948159793857,38,0
23,1,1.5,49,83,-34,1,0.935891528672073,33,0
23,1,1.5,47,62,-15,1,0.651916447211988,12,0
23,1,1.5,9,90,-81,0,0.779171546397265,-40,0
23,1,10,15,63,-48,0,0.86822269752156,-13,0
23,1,10,71,18,53,0,4.21158720646054,32,0
23,1,10,39,92,-53,1,5.69289265951375,42,0
23,1,10,69,22,47,1,4.29820112569723,-28,0
23,1,10,49,65,-16,1,4.86344537127297,15,0
23,1,10,57,22,35,1,2.11739070672775,-28,0
23,1,10,46,90,-44,1,2.57817011501174,40,0
23,1,10,99,14,85,0,3.07662049890496,36,0
23,1,10,76,12,64,1,4.45929595560301,-38,0
23,1,10,82,17,65,0,2.55458186019678,33,0
23,1,1.5,95,36,59,0,0.693267646478489,14,0
23,1,1.5,42,93,-51,1,1.21911187109072,43,0
23,1,1.5,3,62,-59,0,0.795764810231049,-12,0
23,1,1.5,75,0,75,0,0.853177766897716,50,0
23,1,1.5,34,99,-65,1,0.860518420347944,49,0
24,1,1.5,30,100,-70,1,0.987206823774613,50,0
24,1,1.5,48,60,-12,1,0.790052032622043,10,0
24,1,1.5,100,15,85,0,1.06547169364057,35,0
24,1,1.5,3,100,-97,0,1.24950780672953,-50,0
24,1,1.5,50,100,-50,1,0.770205583015922,50,0
24,1,10,98,38,60,1,0.756763602432329,-12,0
24,1,10,25,55,-30,0,0.969574006798211,-5,0
24,1,10,75,0,75,0,0.813780311902519,50,0
24,1,10,53,23,30,0,0.808230651833583,27,0
24,1,10,28,85,-57,1,1.70653734565713,35,0
24,1,1.5,5,83,-78,0,0.93709163350286,-33,0
24,1,1.5,50,43,7,1,0.662583231169265,-7,0
24,1,1.5,0,68,-68,0,0.670190737466328,-18,0
24,1,1.5,100,0,100,0,0.798414644610602,50,0
24,1,1.5,48,100,-52,1,0.665065549430437,50,0
24,1,10,53,40,13,0,0.864433973212726,10,0
24,1,10,53,0,53,0,0.872649596130941,50,0
24,1,10,85,15,70,1,1.03274336119648,-35,0
24,1,10,80,45,35,1,1.45845287642442,-5,0
24,1,10,48,80,-32,1,0.922882817452773,30,0
24,1,1.5,65,45,20,1,0.941717205627356,-5,0
24,1,1.5,48,69,-21,1,0.739114656986203,19,0
24,1,1.5,32,79,-47,1,1.08853100793203,29,0
24,1,1.5,59,4,55,0,0.911971907131374,46,0
24,1,1.5,7,80,-73,0,0.725934030895587,-30,0
24,1,10,28,93,-65,1,1.7074163472862,43,0
24,1,10,73,29,44,1,1.52218342840206,-21,0
24,1,10,19,57,-38,0,1.12824076873949,-7,0
24,1,10,57,8,49,0,1.05478108354146,42,0
24,1,10,0,100,-100,0,3.62322169862455,-50,0
24,1,1.5,28,93,-65,1,0.791189089824911,43,0
24,1,1.5,40,72,-32,1,0.738661593524739,22,0
24,1,1.5,46,99,-53,1,0.848171342979185,49,0
24,1,1.5,29,57,-28,0,1.09706480166642,-7,0
24,1,1.5,96,44,52,1,0.695638898178004,-6,0
24,1,10,82,17,65,0,2.70181463618064,33,0
24,1,10,88,5,83,0,1.03667760832468,45,0
24,1,10,1,89,-88,0,0.9100427221274,-39,0
24,1,10,45,92,-47,1,1.10867106902879,42,0
24,1,10,91,25,66,1,1.35546086187242,-25,0
24,1,1.5,30,100,-70,1,0.982089700002689,50,0
24,1,1.5,61,1,60,0,0.66558385983808,49,0
24,1,1.5,43,63,-20,1,0.953715688025113,13,0
24,1,1.5,51,36,15,0,1.30257194122532,14,0
24,1,1.5,35,77,-42,0,0.909420676354785,-27,0
24,1,10,23,96,-73,1,1.28345237241592,46,0
24,1,10,43,82,-39,1,2.57852714078035,32,0
24,1,10,14,79,-65,0,0.838209079985972,-29,0
24,1,10,22,56,-34,0,0.687583826831542,-6,0
24,1,10,67,13,54,1,3.21535796957323,-37,0
24,1,1.5,44,78,-34,1,0.671243853284977,28,0
24,1,1.5,83,28,55,1,1.35125279729255,-22,0
24,1,1.5,40,93,-53,1,0.892077072116081,43,0
24,1,1.5,59,21,38,0,1.17953333735932,29,0
24,1,1.5,25,97,-72,1,1.1027933411533,47,0
24,1,10,52,39,13,0,3.89339704078157,11,0
24,1,10,31,87,-56,1,1.54786105325911,37,0
24,1,10,32,88,-56,1,2.21657933463575,38,0
24,1,10,41,92,-51,1,1.39473991922569,42,0
24,1,10,4,98,-94,0,0.669387612957507,-48,0
24,1,1.5,50,78,-28,1,1.08421847480349,28,0
24,1,1.5,7,53,-46,0,0.931631779647432,-3,0
24,1,1.5,48,93,-45,1,0.769020873529371,43,0
24,1,1.5,31,100,-69,1,0.868378117331304,50,0
24,1,1.5,77,24,53,1,0.67652042908594,-26,0
24,1,10,45,69,-24,1,1.98810085427249,19,0
24,1,10,43,84,-41,1,1.18351120466832,34,0
24,1,10,60,25,35,0,1.73037155962083,25,0
24,1,10,35,99,-64,1,0.814989580598194,49,0
24,1,10,1,64,-63,0,0.561059640487656,-14,0
24,1,10,49,73,-24,1,0.91654946032213,23,0
24,1,10,37,84,-47,0,0.930555937404279,-34,0
24,1,10,35,59,-24,0,1.08747862518067,-9,0
24,1,10,24,93,-69,0,2.2868382515735,-43,0
24,1,10,28,92,-64,0,0.894238653709181,-42,0
24,1,1.5,22,93,-71,0,0.541083796590101,-43,0
24,1,1.5,45,81,-36,1,0.746015809534583,31,0
24,1,1.5,52,44,8,1,0.790666014188901,-6,0
24,1,1.5,41,89,-48,1,1.19410247809719,39,0
24,1,1.5,6,98,-92,0,0.596139797184151,-48,0
24,1,10,35,85,-50,1,1.66235413355753,35,0
24,1,10,89,33,56,1,1.19755726982839,-17,0
24,1,10,66,46,20,1,3.03191714367131,-4,0
24,1,10,35,86,-51,1,1.15326995577198,36,0
24,1,10,45,75,-30,1,1.14939069200773,25,0
24,1,1.5,28,93,-65,0,1.2728731954121,-43,0
24,1,1.5,15,83,-68,0,1.20089842914604,-33,0
24,1,1.5,100,34,66,1,0.898317323997617,-16,0
24,1,1.5,5,95,-90,0,0.896517533285078,-45,0
24,1,1.5,27,78,-51,NaN,NaN,0,0
24,1,10,2,88,-86,0,0.734075609536376,-38,0
24,1,10,38,100,-62,1,0.922489502758253,50,0
24,1,10,41,77,-36,1,0.712162882904522,27,0
24,1,10,53,0,53,0,0.757414972758852,50,0
24,1,10,14,98,-84,1,0.842292882036418,48,0
24,1,1.5,16,87,-71,0,1.01155898161232,-37,0
24,1,1.5,87,22,65,1,0.868547466292512,-28,0
24,1,1.5,42,54,-12,1,0.875981224991847,4,0
24,1,1.5,71,49,22,1,0.739366114430595,-1,0
24,1,1.5,22,73,-51,0,0.720154906623065,-23,0
24,1,10,48,77,-29,1,1.27621215541149,27,0
24,1,10,95,48,47,1,1.04346366238315,-2,0
24,1,10,78,43,35,1,1.26035530288937,-7,0
24,1,10,93,48,45,1,2.48445160454139,-2,0
24,1,10,45,91,-46,1,0.955327068862971,41,0
24,1,1.5,23,99,-76,0,0.711461294384208,-49,0
24,1,1.5,13,80,-67,0,0.79730764508713,-30,0
24,1,1.5,40,86,-46,1,1.39209521660814,36,0
24,1,1.5,44,55,-11,0,1.03637776541291,-5,0
24,1,1.5,25,56,-31,0,0.893070805817842,-6,0
24,1,10,36,88,-52,1,1.01660572667606,38,0
24,1,10,46,70,-24,1,1.34599271655316,20,0
24,1,10,59,31,28,0,1.89417780539952,19,0
24,1,10,7,63,-56,0,0.732930854719598,-13,0
24,1,10,47,70,-23,1,1.39367690641666,20,0
24,1,1.5,77,47,30,1,1.19561892090132,-3,0
24,1,1.5,0,86,-86,0,0.797968545812182,-36,0
24,1,1.5,9,63,-54,0,0.800038854940794,-13,0
24,1,1.5,53,3,50,0,1.36995779105928,47,0
24,1,1.5,76,49,27,1,0.917366513982415,-1,0
24,1,1.5,89,33,56,NaN,NaN,0,0
24,1,1.5,32,100,-68,1,0.736864735255949,50,0
24,1,1.5,39,67,-28,1,0.918230486800894,17,0
24,1,1.5,45,87,-42,1,0.843067048641387,37,0
24,1,1.5,52,12,40,0,0.755912459047977,38,0
24,1,10,91,2,89,1,1.61511860840255,-48,0
24,1,10,49,92,-43,1,0.856040203885641,42,0
24,1,10,39,91,-52,1,1.48803689022316,41,0
24,1,10,87,38,49,1,1.26280169858364,-12,0
24,1,10,50,23,27,0,1.16624054516433,27,0
24,1,10,86,32,54,1,0.831679248716682,-18,0
24,1,10,17,86,-69,0,1.38387666118797,-36,0
24,1,10,42,83,-41,1,1.01798361126566,33,0
24,1,10,41,87,-46,1,0.675370542448945,37,0
24,1,10,32,58,-26,0,1.27473603375256,-8,0
24,1,1.5,54,23,31,0,0.665625647234265,27,0
24,1,1.5,59,7,52,0,0.649130620469805,43,0
24,1,1.5,34,81,-47,1,1.02505374629982,31,0
24,1,1.5,69,40,29,1,1.08178784092888,-10,0
24,1,1.5,48,97,-49,1,1.17662764678244,47,0
24,1,10,78,8,70,0,1.14667744346661,42,0
24,1,10,4,81,-77,0,0.79867050080793,-31,0
24,1,10,37,84,-47,1,1.38491768063977,34,0
24,1,10,74,39,35,1,1.59473771991907,-11,0
24,1,10,6,72,-66,0,0.661779373476747,-22,0
24,1,1.5,59,4,55,0,0.70926012477139,46,0
24,1,1.5,43,81,-38,1,0.963010818872135,31,0
24,1,1.5,72,38,34,NaN,NaN,0,0
24,1,1.5,47,94,-47,1,0.734075976070017,44,0
24,1,1.5,38,54,-16,0,0.763504936592653,-4,0
24,1,10,50,79,-29,1,0.957823316275608,29,0
24,1,10,43,91,-48,1,0.737929214315955,41,0
24,1,10,20,52,-32,0,0.830896651314106,-2,0
24,1,10,43,100,-57,1,0.591475003631786,50,0
24,1,10,6,56,-50,0,0.729979344527237,-6,0
24,1,1.5,33,99,-66,1,0.582978232065216,49,0
24,1,1.5,49,63,-14,1,0.794403054169379,13,0
24,1,1.5,3,59,-56,0,0.532849845767487,-9,0
24,1,1.5,55,31,24,0,0.657167364028282,19,0
24,1,1.5,46,70,-24,1,0.553172818443272,20,0
24,1,1.5,85,13,72,0,0.789563779835589,37,0
24,1,1.5,13,74,-61,0,0.696214024792425,-24,0
24,1,1.5,40,80,-40,1,0.757698320609052,30,0
24,1,1.5,49,73,-24,1,0.7130855047144,23,0
24,1,1.5,9,66,-57,0,1.04586643795483,-16,0
24,1,10,92,29,63,1,1.02995863411343,-21,0
24,1,10,8,61,-53,0,0.782068806292955,-11,0
24,1,10,58,19,39,0,1.15208891185466,31,0
24,1,10,47,85,-38,1,0.82756172347581,35,0
24,1,10,47,89,-42,1,0.796897102205548,39,0
24,1,1.5,83,36,47,1,1.11766489065485,-14,0
24,1,1.5,41,98,-57,1,0.690819051407743,48,0
24,1,1.5,38,81,-43,1,0.729006137989927,31,0
24,1,1.5,62,11,51,0,0.677423256915063,39,0
24,1,1.5,55,43,12,0,0.80395257496275,7,0
24,1,10,71,32,39,1,1.69276289863046,-18,0
24,1,10,91,46,45,1,0.762983693741262,-4,0
24,1,10,49,73,-24,1,0.886335336603224,23,0
24,1,10,14,56,-42,0,0.740895753260702,-6,0
24,1,10,4,57,-53,0,0.689329000655562,-7,0
24,1,10,46,67,-21,0,0.750762711686548,-17,0
24,1,10,56,6,50,0,0.538811881560832,44,0
24,1,10,40,61,-21,1,0.57548839028459,11,0
24,1,10,36,87,-51,1,0.74701614130754,37,0
24,1,10,73,12,61,1,0.471069739141967,-38,0
24,1,1.5,43,89,-46,1,0.572977114061359,39,0
24,1,1.5,38,91,-53,1,0.559903155895881,41,0
24,1,1.5,86,38,48,1,0.659162162570283,-12,0
24,1,1.5,1,81,-80,0,0.66666263458319,-31,0
24,1,1.5,18,89,-71,0,0.913757768692449,-39,0
24,1,1.5,92,13,79,1,0.756354525801726,-37,0
24,1,1.5,100,22,78,1,0.726755116658751,-28,0
24,1,1.5,1,65,-64,0,0.580195337824989,-15,0
24,1,1.5,91,48,43,1,0.743157771299593,-2,0
24,1,1.5,88,32,56,1,0.756074476870708,-18,0
24,1,10,14,70,-56,0,0.999263588746544,-20,0
24,1,10,42,91,-49,1,0.70480830030283,41,0
24,1,10,35,88,-53,1,0.79077561449958,38,0
24,1,10,47,87,-40,1,0.664218438148964,37,0
24,1,10,6,85,-79,0,0.623112831497565,-35,0
25,1,1.5,25,55,-30,0,0.447012292460386,-5,0
25,1,1.5,28,85,-57,0,0.679181626739137,-35,0
25,1,1.5,100,15,85,0,0.878342213155975,35,0
25,1,1.5,3,100,-97,1,0.230244547935399,50,0
25,1,1.5,53,0,53,0,0.19097208858193,50,0
25,1,10,75,0,75,0,1.26473858131794,50,0
25,1,10,100,0,100,0,1.00098163736948,50,0
25,1,10,0,68,-68,0,1.95549898372337,-18,0
25,1,10,48,80,-32,1,0.888013064061397,30,0
25,1,10,80,45,35,1,1.1433630427091,-5,0
25,1,10,50,100,-50,1,1.57203982999135,50,0
25,1,10,85,15,70,0,1.29588705671904,35,0
25,1,10,48,60,-12,1,1.1424173278424,10,0
25,1,10,98,38,60,0,0.675817374395137,12,0
25,1,10,48,100,-52,1,1.17179167147742,50,0
25,1,1.5,5,83,-78,0,1.30300484403961,-33,0
25,1,1.5,53,23,30,1,1.3496784386175,-27,0
25,1,1.5,30,100,-70,NaN,NaN,0,0
25,1,1.5,53,40,13,0,0.354604953272883,10,0
25,1,1.5,50,43,7,1,0.271479548915977,-7,0
25,1,1.5,76,47,29,1,0.295354450633113,-3,0
25,1,1.5,69,45,24,0,0.230116986394933,5,0
25,1,1.5,4,53,-49,1,0.215614192321027,3,0
25,1,1.5,73,29,44,0,0.16152956550286,21,0
25,1,1.5,37,96,-59,0,0.133611182895038,-46,0
25,1,10,100,31,69,1,0.673874626800171,-19,0
25,1,10,44,54,-10,1,1.24998139727541,4,0
25,1,10,94,12,82,0,1.22687076513103,38,0
25,1,10,45,94,-49,0,0.819886037693323,-44,0
25,1,10,54,8,46,1,1.06169579871676,-42,0
25,1,1.5,53,40,13,NaN,NaN,0,0
25,1,1.5,51,48,3,1,0.381014590767791,-2,0
25,1,1.5,69,44,25,0,0.312628409201352,6,0
25,1,1.5,58,8,50,0,0.238367432219093,42,0
25,1,1.5,100,7,93,0,0.407428626936053,43,0
25,1,10,34,100,-66,0,0.929353999769319,-50,0
25,1,10,49,94,-45,1,0.519115719943784,44,0
25,1,10,3,77,-74,0,0.508679499797381,-27,0
25,1,10,36,92,-56,0,0.979733843579652,-42,0
25,1,10,100,5,95,1,0.294699414792831,-45,0
25,1,10,78,24,54,0,0.766465977174448,26,0
25,1,10,100,15,85,1,4.46636682373583,-35,0
25,1,10,1,100,-99,0,1.12246457692981,-50,0
25,1,10,14,52,-38,0,0.800331000203641,-2,0
25,1,10,84,16,68,1,1.28280393461409,-34,0
25,1,1.5,80,33,47,0,0.193848821246775,17,0
25,1,1.5,58,30,28,1,0.204258282794399,-20,0
25,1,1.5,100,7,93,0,0.198751876308961,43,0
25,1,1.5,4,53,-49,1,0.776582926914216,3,0
25,1,1.5,22,70,-48,0,0.228754497185946,-20,0
25,1,1.5,100,15,85,1,0.580670394542722,-35,0
25,1,1.5,1,100,-99,0,0.279979252921748,-50,0
25,1,1.5,6,56,-50,0,0.527266462494936,-6,0
25,1,1.5,53,0,53,0,0.373188983521231,50,0
25,1,1.5,48,100,-52,0,0.529018967448337,-50,0
25,1,10,22,50,-28,1,0.957160949307308,0,0
25,1,10,24,92,-68,0,1.12959519371589,-42,0
25,1,10,43,58,-15,0,1.10312874001829,-8,0
25,1,10,59,14,45,0,0.709534675295799,36,0
25,1,10,87,13,74,0,4.58025801887379,37,0
25,1,1.5,0,97,-97,0,1.26151362031032,-47,0
25,1,1.5,56,36,20,0,0.389451247116085,14,0
25,1,1.5,10,53,-43,0,0.265150956986872,-3,0
25,1,1.5,26,93,-67,0,0.272834340446934,-43,0
25,1,1.5,69,45,24,0,0.256274433258113,5,0
25,1,10,59,20,39,0,0.776061684068736,30,0
25,1,10,59,14,45,0,0.41961038746831,36,0
25,1,10,97,20,77,0,0.541173969381816,30,0
25,1,10,83,10,73,0,0.618305814130508,40,0
25,1,10,53,0,53,0,1.73241181117282,50,0
25,1,1.5,84,16,68,0,1.26369976118804,34,0
25,1,1.5,3,92,-89,0,0.350928761645264,-42,0
25,1,1.5,83,10,73,0,0.803682789638515,40,0
25,1,1.5,53,0,53,0,0.885868710583054,50,0
25,1,1.5,47,90,-43,0,0.580751403451359,-40,0
25,1,10,3,87,-84,0,0.582719443421411,-37,0
25,1,10,59,14,45,0,3.26604462088017,36,0
25,1,10,54,20,34,0,0.47334238727035,30,0
25,1,10,97,19,78,0,0.36077445983392,31,0
25,1,10,39,94,-55,0,0.348968419354605,-44,0
25,1,10,34,88,-54,0,0.641042192445639,-38,0
25,1,10,13,92,-79,0,0.857430917911188,-42,0
25,1,10,4,53,-49,0,0.601360656428369,-3,0
25,1,10,89,17,72,0,0.347785176103571,33,0
25,1,10,53,40,13,0,0.24796313911429,10,0
25,1,1.5,51,6,45,0,0.359359186538313,44,0
25,1,1.5,13,97,-84,0,0.276165236181441,-47,0
25,1,1.5,47,54,-7,0,0.587493837274451,-4,0
25,1,1.5,59,20,39,0,0.462067486652813,30,0
25,1,1.5,82,42,40,0,0.261436643518209,8,0
25,1,10,65,5,60,0,0.971378562696373,45,0
25,1,10,1,99,-98,0,0.84660248268483,-49,0
25,1,10,41,67,-26,0,0.655342280968398,-17,0
25,1,10,8,80,-72,0,0.543929738517363,-30,0
25,1,10,59,20,39,0,0.739983761562144,30,0
25,1,1.5,87,38,49,0,0.647967171231357,12,0
25,1,1.5,69,45,24,0,0.751840020233431,5,0
25,1,1.5,4,87,-83,0,0.700025842208561,-37,0
25,1,1.5,21,70,-49,0,0.602257252771778,-20,0
25,1,1.5,48,80,-32,0,0.900297093759036,-30,0
25,1,1.5,73,29,44,0,0.600358125358071,21,0
25,1,1.5,5,72,-67,0,0.369799438802147,-22,0
25,1,1.5,48,60,-12,0,0.37421790663393,-10,0
25,1,1.5,45,79,-34,0,1.00956198372842,-29,0
25,1,1.5,11,90,-79,0,0.692109329037521,-40,0
25,1,10,68,15,53,0,0.954087742546108,35,0
25,1,10,71,2,69,0,0.645904559775772,48,0
25,1,10,58,0,58,0,1.74999550968732,50,0
25,1,10,59,20,39,0,0.369917469882239,30,0
25,1,10,54,4,50,0,1.41306149529282,46,0
25,1,1.5,0,97,-97,0,0.396496822874724,-47,0
25,1,1.5,32,91,-59,0,0.278522925337711,-41,0
25,1,1.5,89,19,70,0,0.237089250924328,31,0
25,1,1.5,19,79,-60,0,0.253876056369336,-29,0
25,1,1.5,58,8,50,0,0.126330278088062,42,0
25,1,10,44,51,-7,0,0.472969233109325,-1,0
25,1,10,58,0,58,0,0.584277673615361,50,0
25,1,10,25,55,-30,0,0.267628876560593,-5,0
25,1,10,39,61,-22,0,0.330822057149817,-11,0
25,1,10,48,100,-52,0,0.287521878820371,-50,0
25,1,10,12,100,-88,0,0.493447625541194,-50,0
25,1,10,85,15,70,0,0.780037352071304,35,0
25,1,10,37,86,-49,1,1.01441885271561,36,0
25,1,10,62,33,29,0,0.27125594966401,17,0
25,1,10,87,13,74,0,0.430530461732815,37,0
25,1,1.5,59,20,39,0,0.646498014181816,30,0
25,1,1.5,29,82,-53,0,0.302966355643548,-32,0
25,1,1.5,66,44,22,0,0.116611774882585,6,0
25,1,1.5,43,54,-11,0,0.185728869411832,-4,0
25,1,1.5,21,82,-61,0,0.220309043490488,-32,0
25,1,1.5,72,10,62,0,0.605380311169938,40,0
25,1,1.5,24,62,-38,0,0.8707746614391,-12,0
25,1,1.5,22,52,-30,0,0.302394528050172,-2,0
25,1,1.5,87,38,49,0,0.619296248847604,12,0
25,1,1.5,8,83,-75,0,0.756931118601642,-33,0
25,1,10,34,75,-41,1,0.696198262890903,25,0
25,1,10,53,40,13,1,0.398019497121822,-10,0
25,1,10,66,46,20,0,0.600433269369205,4,0
25,1,10,61,28,33,1,0.497403866067543,-22,0
25,1,10,97,19,78,0,0.727315214462578,31,0
25,1,10,87,13,74,0,0.386960131520027,37,0
25,1,10,9,91,-82,0,0.828758895860119,-41,0
25,1,10,32,50,-18,0,0.916918948936654,0,0
25,1,10,16,79,-63,0,0.362348818497594,-29,0
25,1,10,32,97,-65,0,0.501510394616162,-47,0
25,1,1.5,90,13,77,0,0.602955542237396,37,0
25,1,1.5,16,77,-61,0,0.532299644990417,-27,0
25,1,1.5,97,19,78,0,0.256991417087193,31,0
25,1,1.5,72,10,62,0,0.448821613616929,40,0
25,1,1.5,8,73,-65,0,0.369304954556355,-23,0
25,1,1.5,7,77,-70,0,0.594748350039481,-27,0
25,1,1.5,74,45,29,0,1.09274310462024,5,0
25,1,1.5,69,45,24,0,0.947278228946743,5,0
25,1,1.5,89,17,72,NaN,NaN,0,0
25,1,1.5,7,76,-69,0,0.566523526490528,-26,0
25,1,10,13,83,-70,0,0.276525194321039,-33,0
25,1,10,20,75,-55,0,0.735817117805709,-25,0
25,1,10,82,42,40,0,0.700566145973426,8,0
25,1,10,56,15,41,0,0.649725174526793,35,0
25,1,10,8,80,-72,0,0.585011152471452,-30,0
25,1,10,98,3,95,0,0.337974667304479,47,0
25,1,10,98,5,93,0,4.23739532530999,45,0
25,1,10,24,84,-60,0,0.509603587851416,-34,0
25,1,10,19,91,-72,0,0.538664525978675,-41,0
25,1,10,35,66,-31,0,0.414749119807311,-16,0
25,1,1.5,98,39,59,0,1.22269385780146,11,0
25,1,1.5,88,32,56,0,0.295242651007356,18,0
25,1,1.5,81,18,63,0,1.15739114656935,32,0
25,1,1.5,37,86,-49,0,0.801052749263363,-36,0
25,1,1.5,16,100,-84,0,0.553632846363143,-50,0
25,1,1.5,7,59,-52,0,0.531712788594632,-9,0
25,1,1.5,61,43,18,0,0.560384444090232,7,0
25,1,1.5,3,97,-94,0,0.164166570445559,-47,0
25,1,1.5,81,47,34,0,0.286527778541313,3,0
25,1,1.5,39,75,-36,0,0.285002904956855,-25,0
25,1,10,85,15,70,0,0.618769507659636,35,0
25,1,10,68,5,63,0,0.602937214430312,45,0
25,1,10,49,94,-45,0,1.80461677470885,-44,0
25,1,10,99,8,91,0,0.869620376122839,42,0
25,1,10,40,92,-52,0,0.276082394490913,-42,0
25,1,1.5,69,44,25,0,0.138582050844889,6,0
25,1,1.5,63,37,26,0,0.262010670449854,13,0
25,1,1.5,6,73,-67,0,0.868500547085205,-23,0
25,1,1.5,93,8,85,NaN,NaN,0,0
25,1,1.5,65,3,62,0,0.666139192366245,47,0
25,1,10,98,8,90,0,0.360369415288005,42,0
25,1,10,24,92,-68,0,0.323775748278422,-42,0
25,1,10,89,50,39,0,0.424952576798205,0,0
25,1,10,88,13,75,0,0.2023591553816,37,0
25,1,10,86,12,74,0,0.251532296345431,38,0
25,1,10,97,8,89,0,2.23358937280409,42,0
25,1,10,79,12,67,0,0.345553948817724,38,0
25,1,10,8,81,-73,0,0.516689484786184,-31,0
25,1,10,50,15,35,0,0.530016000175237,35,0
25,1,10,86,6,80,0,0.174758576956265,44,0
25,1,1.5,59,14,45,0,0.393756815653433,36,0
25,1,1.5,86,38,48,0,0.283311981437691,12,0
25,1,1.5,50,46,4,0,0.721871855635072,4,0
25,1,1.5,97,20,77,0,0.638544478839322,30,0
25,1,1.5,26,96,-70,0,0.150421814490073,-46,0
26,1,1.5,0,68,-68,0,1.25869480351685,-18,0
26,1,1.5,53,40,13,1,0.913970737834461,-10,0
26,1,1.5,75,0,75,0,1.07178012491204,50,0
26,1,1.5,100,15,85,1,1.30371119774645,-35,0
26,1,1.5,48,80,-32,1,1.34263176313834,30,0
26,1,10,30,100,-70,0,6.74683946126606,-50,0
26,1,10,28,85,-57,1,4.15971511253156,35,0
26,1,10,85,15,70,0,3.54833354410948,35,0
26,1,10,3,100,-97,0,1.12863005138934,-50,0
26,1,10,80,45,35,1,1.98211865790654,-5,0
26,1,10,98,38,60,1,2.26470119261649,-12,0
26,1,10,25,55,-30,0,3.30483285954688,-5,0
26,1,10,100,0,100,0,1.75163401570171,50,0
26,1,10,48,100,-52,0,6.21183939708862,-50,0
26,1,10,53,23,30,0,4.99000328069087,27,0
26,1,1.5,50,100,-50,NaN,NaN,0,0
26,1,1.5,5,83,-78,0,0.961191234178841,-33,0
26,1,1.5,48,60,-12,1,1.03790117282188,10,0
26,1,1.5,50,43,7,1,1.0310370423249,-7,0
26,1,1.5,53,0,53,0,0.992492930090521,50,0
26,1,1.5,97,5,92,0,0.995606457989197,45,0
26,1,1.5,87,16,71,0,1.09449084434891,34,0
26,1,1.5,87,24,63,0,1.3728411217453,26,0
26,1,1.5,88,6,82,0,1.00908472761512,44,0
26,1,1.5,68,42,26,1,1.05146375030745,-8,0
26,1,10,94,7,87,0,1.97164358280133,43,0
26,1,10,54,15,39,0,1.15150315512437,35,0
26,1,10,100,9,91,0,0.972118639561813,41,0
26,1,10,91,7,84,0,0.991708726796787,43,0
26,1,10,78,25,53,1,2.47543029108783,-25,0
26,1,10,29,97,-68,1,2.94540695979958,47,0
26,1,10,49,54,-5,1,2.08577010693261,4,0
26,1,10,23,75,-52,0,1.77329601795645,-25,0
26,1,10,97,30,67,1,3.08920803712681,-20,0
26,1,10,54,15,39,0,2.20856348477537,35,0
26,1,1.5,44,88,-44,NaN,NaN,0,0
26,1,1.5,90,14,76,0,0.866992168535944,36,0
26,1,1.5,17,87,-70,0,0.874939105822705,-37,0
26,1,1.5,62,36,26,1,0.642833918856923,-14,0
26,1,1.5,83,21,62,1,0.98840472928714,-29,0
26,1,1.5,87,14,73,0,0.949179189105053,36,0
26,1,1.5,1,80,-79,1,0.713791125337593,30,0
26,1,1.5,83,28,55,NaN,NaN,0,0
26,1,1.5,64,48,16,1,1.1125107446569,-2,0
26,1,1.5,97,10,87,1,0.622346729098354,-40,0
26,1,10,97,4,93,0,1.10386735061184,46,0
26,1,10,52,44,8,1,3.44635029206984,-6,0
26,1,10,63,50,13,1,3.1188118449063,0,0
26,1,10,14,94,-80,0,0.964880988409277,-44,0
26,1,10,99,15,84,0,1.16088222735561,35,0
26,1,10,76,3,73,0,1.18010589806363,47,0
26,1,10,99,15,84,0,0.984101360081695,35,0
26,1,10,94,32,62,1,1.49938803445548,-18,0
26,1,10,72,43,29,1,1.93833499203902,-7,0
26,1,10,40,65,-25,1,3.11914651066763,15,0
26,1,1.5,95,9,86,NaN,NaN,0,0
26,1,1.5,95,8,87,0,1.14039906969992,42,0
26,1,1.5,91,0,91,0,1.19344011112116,50,0
26,1,1.5,0,85,-85,0,1.11733792262385,-35,0
26,1,1.5,0,92,-92,0,0.667069145303685,-42,0
26,1,10,95,6,89,0,0.880512413918041,44,0
26,1,10,85,32,53,1,2.20830176363233,-18,0
26,1,10,43,97,-54,0,2.39427879161667,-47,0
26,1,10,49,54,-5,1,1.98142879921943,4,0
26,1,10,79,25,54,1,2.61697118321899,-25,0
26,1,1.5,79,3,76,0,0.945653652073815,47,0
26,1,1.5,61,10,51,0,0.949513121740893,40,0
26,1,1.5,96,6,90,0,0.905774175713304,44,0
26,1,1.5,18,84,-66,1,1.07930442306679,34,0
26,1,1.5,88,39,49,1,0.902873983490281,-11,0
26,1,10,98,9,89,0,1.35418414679589,41,0
26,1,10,50,50,0,1,1.65463666035794,0,0
26,1,10,82,21,61,1,3.73465183580993,-29,0
26,1,10,93,11,82,0,1.35522260033758,39,0
26,1,10,97,42,55,1,2.74329596298048,-8,0
26,1,1.5,16,80,-64,0,0.915331394237,-30,0
26,1,1.5,91,12,79,0,1.1524990882026,38,0
26,1,1.5,1,74,-73,0,0.812420755100902,-24,0
26,1,1.5,95,9,86,0,0.965514397423249,41,0
26,1,1.5,98,2,96,0,0.969035535817966,48,0
26,1,1.5,100,2,98,0,0.856329783215187,48,0
26,1,1.5,67,43,24,NaN,NaN,0,0
26,1,1.5,38,94,-56,0,0.77610823669238,-44,0
26,1,1.5,60,35,25,1,0.979674461472314,-15,0
26,1,1.5,43,70,-27,1,1.27022812626092,20,0
26,1,10,94,8,86,0,2.15683801332489,42,0
26,1,10,100,7,93,0,0.752804796036799,43,0
26,1,10,90,38,52,0,4.46840670867823,12,0
26,1,10,50,38,12,1,3.11587279767264,-12,0
26,1,10,42,70,-28,1,4.25732131762197,20,0
26,1,1.5,97,7,90,0,1.25507762742927,43,0
26,1,1.5,21,97,-76,0,0.895252914575394,-47,0
26,1,1.5,40,67,-27,1,0.941633997310419,17,0
26,1,1.5,91,0,91,0,0.753847648273222,50,0
26,1,1.5,63,48,15,NaN,NaN,0,0
26,1,10,3,75,-72,0,1.18908725690562,-25,0
26,1,10,100,21,79,0,0.727657211304177,29,0
26,1,10,99,7,92,0,0.820818189997226,43,0
26,1,10,6,75,-69,0,1.13397590629756,-25,0
26,1,10,96,9,87,0,0.738875295734033,41,0
26,1,10,100,11,89,0,0.790251072670799,39,0
26,1,10,89,3,86,0,1.28079850593349,47,0
26,1,10,35,83,-48,1,1.65523671277333,33,0
26,1,10,91,0,91,0,1.29470454656985,50,0
26,1,10,76,3,73,0,0.900652286654804,47,0
26,1,1.5,40,100,-60,0,1.48993748379871,-50,0
26,1,1.5,3,90,-87,0,1.10471152944956,-40,0
26,1,1.5,42,66,-24,NaN,NaN,0,0
26,1,1.5,61,9,52,0,0.830645560345147,41,0
26,1,1.5,26,83,-57,0,0.895261711906642,-33,0
26,1,1.5,96,9,87,0,0.827765528694727,41,0
26,1,1.5,1,80,-79,0,0.764999752573203,-30,0
26,1,1.5,7,74,-67,0,0.896439823380206,-24,0
26,1,1.5,52,19,33,0,1.42275470611639,31,0
26,1,1.5,80,43,37,0,1.0557990099187,7,0
26,1,10,35,54,-19,0,1.84625718678581,-4,0
26,1,10,64,1,63,0,0.798264356621075,49,0
26,1,10,92,26,66,0,1.34419475862524,24,0
26,1,10,98,36,62,1,1.4768389663659,-14,0
26,1,10,85,15,70,0,1.02011440217029,35,0
26,1,1.5,74,11,63,NaN,NaN,0,0
26,1,1.5,84,22,62,0,0.750737419351935,28,0
26,1,1.5,45,98,-53,0,0.914663528907113,-48,0
26,1,1.5,88,6,82,0,0.831901015189942,44,0
26,1,1.5,89,45,44,1,1.04867938987445,-5,0
26,1,10,90,11,79,0,0.799886734166648,39,0
26,1,10,61,10,51,0,1.23392257234082,40,0
26,1,10,40,93,-53,0,3.75452980923001,-43,0
26,1,10,48,60,-12,1,1.75036903040018,10,0
26,1,10,74,18,56,0,1.29841995966854,32,0
26,1,10,69,46,23,1,0.998901064682286,-4,0
26,1,10,56,41,15,0,0.872470716771204,9,0
26,1,10,90,12,78,0,0.791082422016189,38,0
26,1,10,68,22,46,0,1.0898784683086,28,0
26,1,10,84,31,53,1,1.81559623108478,-19,0
26,1,1.5,48,100,-52,0,0.968227279430721,-50,0
26,1,1.5,95,10,85,0,1.44294425233966,40,0
26,1,1.5,9,98,-89,0,0.947119143558666,-48,0
26,1,1.5,28,97,-69,0,1.22218581096968,-47,0
26,1,1.5,53,23,30,0,1.0147377565736,27,0
26,1,10,99,6,93,0,1.36524901073426,44,0
26,1,10,26,53,-27,0,1.80867491784738,-3,0
26,1,10,99,3,96,0,1.50671219296055,47,0
26,1,10,48,60,-12,1,1.48072336189216,10,0
26,1,10,69,26,43,0,1.05483533377992,24,0
26,1,1.5,73,5,68,0,0.709162620769348,45,0
26,1,1.5,60,4,56,0,0.970523020601831,46,0
26,1,1.5,64,35,29,0,1.35699270002078,15,0
26,1,1.5,33,100,-67,0,1.16927123133792,-50,0
26,1,1.5,89,47,42,NaN,NaN,0,0
26,1,10,100,0,100,0,1.51437065057689,50,0
26,1,10,61,9,52,0,0.902963423170149,41,0
26,1,10,81,44,37,0,1.7319620467606,6,0
26,1,10,77,48,29,1,1.34477208455792,-2,0
26,1,10,81,0,81,0,0.924968521983828,50,0
26,1,1.5,72,49,23,NaN,NaN,0,0
26,1,1.5,20,69,-49,0,1.0488809957169,-19,0
26,1,1.5,36,81,-45,1,1.3528440175578,31,0
26,1,1.5,94,7,87,0,1.41266671434278,43,0
26,1,1.5,15,83,-68,0,1.4134372153203,-33,0
26,1,1.5,68,21,47,NaN,NaN,0,0
26,1,1.5,96,12,84,0,0.71618290420156,38,0
26,1,1.5,79,45,34,1,1.2338126054965,-5,0
26,1,1.5,28,76,-48,0,1.10586141614476,-26,0
26,1,1.5,99,4,95,0,1.02383897925029,46,0
26,1,10,2,87,-85,0,1.4075341951102,-37,0
26,1,10,67,4,63,0,1.74526253668591,46,0
26,1,10,71,44,27,0,2.63686088641407,6,0
26,1,10,56,41,15,1,1.54208742734045,-9,0
26,1,10,1,65,-64,0,0.825463922636118,-15,0
26,1,1.5,8,90,-82,0,0.727380461408757,-40,0
26,1,1.5,89,14,75,0,0.708564401196782,36,0
26,1,1.5,15,98,-83,0,0.881970019370783,-48,0
26,1,1.5,40,65,-25,0,0.928111740970053,-15,0
26,1,1.5,55,6,49,0,1.37129205546807,44,0
26,1,10,7,89,-82,0,0.781349256576505,-39,0
26,1,10,85,17,68,0,0.935086571436841,33,0
26,1,10,69,18,51,0,1.25115584320156,32,0
26,1,10,96,9,87,0,1.25057155266404,41,0
26,1,10,30,76,-46,1,2.11381165246712,26,0
26,1,1.5,73,5,68,NaN,NaN,0,0
26,1,1.5,70,46,24,1,0.275725735351443,-4,0
26,1,1.5,89,27,62,1,0.86708160827402,-23,0
26,1,1.5,100,43,57,0,0.737667493231129,7,0
26,1,1.5,20,92,-72,0,1.03760756133124,-42,0
26,1,10,16,64,-48,0,5.61275432124967,-14,0
26,1,10,22,97,-75,0,0.813404591812287,-47,0
26,1,10,10,84,-74,0,1.08629684813786,-34,0
26,1,10,96,6,90,0,1.34810847864719,44,0
26,1,10,43,70,-27,1,1.52740905282553,20,0
26,1,10,0,62,-62,0,0.866775533882901,-12,0
26,1,10,92,14,78,0,1.00919542758493,36,0
26,1,10,99,8,91,0,2.11444029625272,42,0
26,1,10,98,32,66,0,2.71118747699074,18,0
26,1,10,15,75,-60,0,1.25183727109106,-25,0
26,1,1.5,46,90,-44,0,0.978482787439134,-40,0
26,1,1.5,70,29,41,1,0.861641914932989,-21,0
26,1,1.5,63,19,44,0,0.868400843814015,31,0
26,1,1.5,80,49,31,1,1.05104917532299,-1,0
26,1,1.5,90,12,78,0,0.930268557392992,38,0
27,1,10,5,83,-78,0,1.47821713765734,-33,0
27,1,10,75,0,75,0,1.88424114350346,50,0
27,1,10,3,100,-97,0,3.03620268430677,-50,0
27,1,10,85,15,70,1,1.22941074048867,-35,0
27,1,10,25,55,-30,1,2.21485437586671,5,0
27,1,1.5,53,40,13,1,1.0563725103857,-10,0
27,1,1.5,50,43,7,1,1.06507605151273,-7,0
27,1,1.5,53,0,53,0,0.729250005038921,50,0
27,1,1.5,53,23,30,1,0.870618400833337,-27,0
27,1,1.5,80,45,35,1,0.902647461509332,-5,0
27,1,10,0,68,-68,0,1.26048821792938,-18,0
27,1,10,48,100,-52,1,4.43762859294657,50,0
27,1,10,28,85,-57,1,4.71895963652059,35,0
27,1,10,98,38,60,1,4.50125527611817,-12,0
27,1,10,30,100,-70,0,1.17188357401756,-50,0
27,1,1.5,48,60,-12,1,1.0075169945485,10,0
27,1,1.5,48,80,-32,NaN,NaN,0,0
27,1,1.5,100,15,85,0,1.19529083589441,35,0
27,1,1.5,100,0,100,0,0.933798983547604,50,0
27,1,1.5,50,100,-50,1,1.31528306487598,50,0
27,1,1.5,78,47,31,1,0.914819003082812,-3,0
27,1,1.5,96,10,86,0,1.26458523102337,40,0
27,1,1.5,32,87,-55,0,1.29667367401998,-37,0
27,1,1.5,48,96,-48,1,1.45559760785545,46,0
27,1,1.5,31,78,-47,0,0.992510497279,-28,0
27,1,10,48,85,-37,0,1.7712618924852,-35,0
27,1,10,48,78,-30,0,1.19143355137203,-28,0
27,1,10,64,38,26,1,0.938724416570039,-12,0
27,1,10,40,61,-21,0,1.00018071284285,-11,0
27,1,10,40,100,-60,0,1.54665965322056,-50,0
27,1,10,33,64,-31,0,2.22079883873812,-14,0
27,1,10,94,11,83,0,1.80717023112811,39,0
27,1,10,71,42,29,1,1.60201533310465,-8,0
27,1,10,63,36,27,0,2.13310399051988,14,0
27,1,10,22,50,-28,0,1.27413148782216,0,0
27,1,1.5,88,33,55,1,1.16139269853011,-17,0
27,1,1.5,78,34,44,1,0.926454637607094,-16,0
27,1,1.5,24,51,-27,0,1.13246434769826,-1,0
27,1,1.5,97,4,93,0,0.993930541037116,46,0
27,1,1.5,95,13,82,0,0.661313338845503,37,0
27,1,1.5,100,9,91,0,0.854457247478422,41,0
27,1,1.5,8,70,-62,0,0.77545714302687,-20,0
27,1,1.5,84,16,68,1,0.866911404882558,-34,0
27,1,1.5,99,3,96,0,0.603231204324402,47,0
27,1,1.5,6,57,-51,0,1.00597232126165,-7,0
27,1,10,96,9,87,0,9.10413861740381,41,0
27,1,10,8,60,-52,0,2.82308872340946,-10,0
27,1,10,85,37,48,1,6.55315175294527,-13,0
27,1,10,1,59,-58,0,1.04608617399936,-9,0
27,1,10,98,9,89,0,1.88620772448485,41,0
27,1,10,50,50,0,1,2.07535395710147,0,0
27,1,10,97,5,92,0,1.24352173777879,45,0
27,1,10,100,1,99,0,1.59727721093805,49,0
27,1,10,16,91,-75,1,3.00767791326507,41,0
27,1,10,98,7,91,0,2.08261069579748,43,0
27,1,1.5,54,47,7,1,1.37794276938075,-3,0
27,1,1.5,82,17,65,0,0.853030972270062,33,0
27,1,1.5,42,72,-30,NaN,NaN,0,0
27,1,1.5,64,31,33,0,0.822653986222576,19,0
27,1,1.5,100,48,52,NaN,NaN,0,0
27,1,10,69,41,28,1,1.04737865572679,-9,0
27,1,10,88,48,40,0,1.35212062671781,2,0
27,1,10,78,2,76,0,0.725240599160315,48,0
27,1,10,44,83,-39,1,1.12312079718686,33,0
27,1,10,93,9,84,0,1.51303790020756,41,0
27,1,1.5,72,15,57,1,0.806376634165645,-35,0
27,1,1.5,52,25,27,1,1.16934479679912,-25,0
27,1,1.5,61,4,57,0,0.605583403754281,46,0
27,1,1.5,94,7,87,0,0.695636682881741,43,0
27,1,1.5,95,8,87,0,0.541730554599781,42,0
27,1,1.5,43,57,-14,1,0.872182501654606,7,0
27,1,1.5,95,20,75,0,0.591601068153977,30,0
27,1,1.5,48,96,-48,1,1.13901289732894,46,0
27,1,1.5,5,55,-50,0,0.80875559229753,-5,0
27,1,1.5,41,60,-19,0,0.626731205236865,-10,0
27,1,10,50,74,-24,1,2.50024614334689,24,0
27,1,10,100,10,90,0,1.07447898434475,40,0
27,1,10,44,76,-32,0,1.1064358332078,-26,0
27,1,10,8,99,-91,0,0.696980116073973,-49,0
27,1,10,64,31,33,1,3.69499484071275,-19,0
27,1,1.5,85,27,58,0,0.928118442068808,23,0
27,1,1.5,91,10,81,0,0.716800246300409,40,0
27,1,1.5,98,6,92,0,0.810603408608586,44,0
27,1,1.5,82,3,79,0,0.812867267697584,47,0
27,1,1.5,59,39,20,NaN,NaN,0,0
27,1,10,86,38,48,1,1.21391415590188,-12,0
27,1,10,14,57,-43,0,0.62346957664704,-7,0
27,1,10,98,13,85,0,1.89768940483918,37,0
27,1,10,15,78,-63,0,0.694816693750909,-28,0
27,1,10,48,64,-16,1,1.38119963271311,14,0
27,1,10,99,4,95,0,0.799329566361848,46,0
27,1,10,100,3,97,0,0.817131064453861,47,0
27,1,10,77,10,67,0,1.22711169190006,40,0
27,1,10,90,8,82,0,1.14888135818182,42,0
27,1,10,57,40,17,1,1.23211043642368,-10,0
27,1,1.5,59,23,36,0,0.969068412465276,27,0
27,1,1.5,68,40,28,NaN,NaN,0,0
27,1,1.5,34,85,-51,1,0.708343031845288,35,0
27,1,1.5,94,12,82,0,0.627115357463481,38,0
27,1,1.5,73,42,31,1,0.788295086123981,-8,0
27,1,10,26,69,-43,0,0.950903655873844,-19,0
27,1,10,3,75,-72,0,0.890831480704946,-25,0
27,1,10,100,7,93,0,0.745432052150136,43,0
27,1,10,91,46,45,0,1.31028358722688,4,0
27,1,10,44,68,-24,1,1.11615767102921,18,0
27,1,1.5,97,12,85,0,0.577088323858334,38,0
27,1,1.5,65,35,30,1,0.796572687424487,-15,0
27,1,1.5,79,40,39,0,0.670762457913952,10,0
27,1,1.5,96,12,84,0,0.99854440020863,38,0
27,1,1.5,92,37,55,0,0.680556507606525,13,0
27,1,10,55,38,17,1,1.45380807414767,-12,0
27,1,10,97,9,88,0,4.71747654490173,41,0
27,1,10,36,85,-49,0,5.60329241940053,-35,0
27,1,10,10,65,-55,0,0.989400256949011,-15,0
27,1,10,67,21,46,0,2.01588293618988,29,0
27,1,1.5,35,74,-39,1,0.697150931868237,24,0
27,1,1.5,44,71,-27,0,1.25514967460185,-21,0
27,1,1.5,90,14,76,0,0.831100937095471,36,0
27,1,1.5,23,74,-51,0,1.47040909648058,-24,0
27,1,1.5,92,14,78,0,0.637955562240677,36,0
27,1,1.5,100,15,85,0,0.705869501864072,35,0
27,1,1.5,40,98,-58,0,1.08050592264044,-48,0
27,1,1.5,96,48,48,1,1.27088232222013,-2,0
27,1,1.5,52,48,4,1,1.05437220612657,-2,0
27,1,1.5,14,66,-52,0,0.701598373969318,-16,0
27,1,10,53,47,6,1,5.21130499965511,-3,0
27,1,10,99,6,93,0,1.10878876573406,44,0
27,1,10,93,44,49,0,0.435229474154767,6,0
27,1,10,98,18,80,0,3.08331998452195,32,0
27,1,10,19,71,-52,1,1.64966414167429,21,0
27,1,1.5,43,57,-14,1,1.07311978915823,7,0
27,1,1.5,5,79,-74,0,0.664589629712282,-29,0
27,1,1.5,99,10,89,0,0.72001055686269,40,0
27,1,1.5,37,77,-40,1,1.20541075515212,27,0
27,1,1.5,96,16,80,0,1.00755035126349,34,0
27,1,10,44,86,-42,0,1.33698656750494,-36,0
27,1,10,75,15,60,0,1.35777477608644,35,0
27,1,10,58,50,8,1,2.05789885579725,0,0
27,1,10,84,18,66,0,1.08188821095973,32,0
27,1,10,99,2,97,0,0.800093472149456,48,0
27,1,1.5,58,43,15,1,1.42429579724558,-7,0
27,1,1.5,79,18,61,0,1.19299911841517,32,0
27,1,1.5,8,88,-80,0,1.09158805533662,-38,0
27,1,1.5,27,80,-53,0,0.729821101587731,-30,0
27,1,1.5,100,12,88,0,1.10246198342065,38,0
27,1,10,93,18,75,0,2.48394899719278,32,0
27,1,10,61,36,25,1,1.96227793488652,-14,0
27,1,10,95,7,88,0,1.26964812312508,43,0
27,1,10,30,95,-65,0,1.97271309362259,-45,0
27,1,10,97,10,87,0,0.759984018106479,40,0
27,1,1.5,39,85,-46,NaN,NaN,0,0
27,1,1.5,39,71,-32,0,0.817167720233556,-21,0
27,1,1.5,75,29,46,1,0.954854779090965,-21,0
27,1,1.5,7,83,-76,0,0.622945765993791,-33,0
27,1,1.5,97,20,77,0,1.16037183592562,30,0
27,1,10,53,40,13,0,1.07578722803737,10,0
27,1,10,51,42,9,0,1.21922190839541,8,0
27,1,10,95,20,75,1,0.97243414336117,-30,0
27,1,10,53,20,33,1,0.616302277951036,-30,0
27,1,10,85,27,58,0,1.37681487196824,23,0
27,1,1.5,82,17,65,0,1.02872124584974,33,0
27,1,1.5,81,15,66,0,0.797628006461309,35,0
27,1,1.5,34,85,-51,0,1.08775862923358,-35,0
27,1,1.5,16,100,-84,0,0.598563094623387,-50,0
27,1,1.5,11,90,-79,0,0.688351352699101,-40,0
27,1,10,1,88,-87,0,0.766796489129774,-38,0
27,1,10,94,7,87,0,2.51419035697472,43,0
27,1,10,96,45,51,1,4.18295580966515,-5,0
27,1,10,41,92,-51,0,7.06501520297024,-42,0
27,1,10,11,65,-54,0,4.24791199687752,-15,0
27,1,10,89,12,77,0,0.934045310190413,38,0
27,1,10,5,63,-58,0,1.05099437886383,-13,0
27,1,10,22,96,-74,0,1.95438851794461,-46,0
27,1,10,8,62,-54,0,1.39777389634401,-12,0
27,1,10,61,42,19,1,0.951151448738528,-8,0
27,1,1.5,95,14,81,0,0.682772347645368,36,0
27,1,1.5,23,70,-47,0,0.79271210389561,-20,0
27,1,1.5,92,15,77,0,0.755506518296897,35,0
27,1,1.5,61,37,24,1,0.558973785635317,-13,0
27,1,1.5,82,42,40,1,0.859826581639936,-8,0
27,1,10,22,50,-28,0,0.984493518335512,0,0
27,1,10,80,14,66,0,0.851358370447997,36,0
27,1,10,3,98,-95,0,0.73907301275176,-48,0
27,1,10,97,20,77,0,0.783739876147592,30,0
27,1,10,0,84,-84,0,0.801533676567487,-34,0
27,1,1.5,84,18,66,0,0.634294385963585,32,0
27,1,1.5,72,12,60,0,0.747070930694463,38,0
27,1,1.5,93,11,82,0,0.895254363422282,39,0
27,1,1.5,74,48,26,1,1.06826326894225,-2,0
27,1,1.5,91,49,42,NaN,NaN,0,0
27,1,1.5,3,78,-75,0,0.585509615717456,-28,0
27,1,1.5,17,100,-83,0,0.675552631233586,-50,0
27,1,1.5,15,62,-47,0,0.866783842880977,-12,0
27,1,1.5,42,56,-14,0,1.16963767627021,-6,0
27,1,1.5,45,73,-28,1,1.00458123555291,23,0
27,1,10,26,78,-52,1,1.04575407289667,28,0
27,1,10,93,8,85,0,0.734634734602878,42,0
27,1,10,93,44,49,1,1.35436322548776,-6,0
27,1,10,70,29,41,0,1.54206338879885,21,0
27,1,10,93,13,80,0,0.714248639618745,37,0
28,1,10,25,55,-30,0,1.43599031560007,-5,0
28,1,10,53,23,30,0,1.78122975923179,27,0
28,1,10,53,40,13,1,1.5364501602744,-10,0
28,1,10,28,85,-57,0,0.853771221314673,-35,0
28,1,10,98,38,60,0,0.974250530125573,12,0
28,1,1.5,50,100,-50,0,0.72964137980307,-50,0
28,1,1.5,53,0,53,0,0.767011779287714,50,0
28,1,1.5,3,100,-97,0,0.682939926948166,-50,0
28,1,1.5,48,100,-52,0,0.73012046868098,-50,0
28,1,1.5,30,100,-70,0,0.615500193365733,-50,0
28,1,1.5,100,15,85,0,0.928683935126173,35,0
28,1,1.5,85,15,70,0,0.790023074718192,35,0
28,1,1.5,0,68,-68,0,0.681379497415037,-18,0
28,1,1.5,100,0,100,0,0.704723259274033,50,0
28,1,1.5,48,60,-12,0,1.32703259967093,-10,0
28,1,10,48,80,-32,0,1.03587485039316,-30,0
28,1,10,5,83,-78,0,0.717008755193092,-33,0
28,1,10,75,0,75,0,1.56309182781843,50,0
28,1,10,80,45,35,1,1.07095060839492,-5,0
28,1,10,50,43,7,0,1.96699675047421,7,0
28,1,10,45,85,-40,0,1.27893126888375,-35,0
28,1,10,10,87,-77,0,0.942256043141242,-37,0
28,1,10,8,90,-82,0,0.94736070408544,-40,0
28,1,10,83,46,37,1,1.00003005760664,-4,0
28,1,10,50,49,1,0,1.75447739173251,1,0
28,1,1.5,86,0,86,0,0.694549859879771,50,0
28,1,1.5,96,15,81,0,1.2536953441886,35,0
28,1,1.5,97,32,65,1,1.27794669906143,-18,0
28,1,1.5,50,14,36,0,0.917120921381866,36,0
28,1,1.5,95,33,62,1,1.16338837174408,-17,0
28,1,10,20,95,-75,0,0.868466823914787,-45,0
28,1,10,33,95,-62,0,1.55623576158541,-45,0
28,1,10,89,17,72,0,1.40898099222977,33,0
28,1,10,68,40,28,1,1.58743225585204,-10,0
28,1,10,15,78,-63,0,0.814868617104366,-28,0
28,1,1.5,83,19,64,0,0.751465033288696,31,0
28,1,1.5,72,29,43,NaN,NaN,0,0
28,1,1.5,96,11,85,0,0.556777531586704,39,0
28,1,1.5,2,77,-75,0,0.521506032600882,-27,0
28,1,1.5,92,46,46,1,0.631350081283017,-4,0
28,1,10,90,33,57,1,1.18100029506604,-17,0
28,1,10,49,74,-25,0,1.52034551583347,-24,0
28,1,10,84,18,66,0,0.950375994958449,32,0
28,1,10,18,92,-74,0,1.31485890338081,-42,0
28,1,10,15,90,-75,0,0.880920935669565,-40,0
28,1,1.5,100,9,91,0,0.511533872529981,41,0
28,1,1.5,86,16,70,0,0.653513898898382,34,0
28,1,1.5,34,80,-46,0,0.621977240531123,-30,0
28,1,1.5,92,21,71,0,1.02408127282979,29,0
28,1,1.5,67,42,25,1,0.849754132461385,-8,0
28,1,1.5,96,47,49,1,0.59317839005962,-3,0
28,1,1.5,98,13,85,0,0.788379436940886,37,0
28,1,1.5,65,21,44,1,0.783787954598665,-29,0
28,1,1.5,94,14,80,0,0.715213729738025,36,0
28,1,1.5,58,11,47,0,0.697101090685464,39,0
28,1,10,96,19,77,0,0.727084650643519,31,0
28,1,10,91,45,46,1,2.53290079707222,-5,0
28,1,10,72,31,41,0,2.80217587731022,19,0
28,1,10,4,76,-72,0,0.924724029042409,-26,0
28,1,10,91,18,73,0,1.02686416711367,32,0
28,1,10,78,14,64,0,0.818755211963435,36,0
28,1,10,91,14,77,0,1.14866930953576,36,0
28,1,10,75,40,35,1,1.66532690393797,-10,0
28,1,10,96,12,84,0,1.37742930506647,38,0
28,1,10,86,17,69,0,1.14125827730459,33,0
28,1,1.5,65,23,42,1,0.945792210302898,-27,0
28,1,1.5,38,69,-31,0,0.870460156264016,-19,0
28,1,1.5,48,75,-27,1,1.08629061671672,25,0
28,1,1.5,59,6,53,0,0.877691209432669,44,0
28,1,1.5,72,1,71,0,0.580560427697492,49,0
28,1,1.5,96,13,83,0,0.508915561964386,37,0
28,1,1.5,58,11,47,0,0.555553234022227,39,0
28,1,1.5,29,98,-69,1,1.03212278166029,48,0
28,1,1.5,100,5,95,0,0.48138572886819,45,0
28,1,1.5,13,56,-43,0,1.08077467976545,-6,0
28,1,10,61,1,60,0,0.791131907055387,49,0
28,1,10,23,59,-36,0,1.10658316517947,-9,0
28,1,10,84,18,66,0,1.08129592261685,32,0
28,1,10,11,52,-41,0,0.856613864249084,-2,0
28,1,10,36,84,-48,0,1.8646513409476,-34,0
28,1,10,78,44,34,1,1.4182024453039,-6,0
28,1,10,33,87,-54,0,1.70744420557457,-37,0
28,1,10,90,15,75,0,1.48958778927044,35,0
28,1,10,88,15,73,0,0.776195477068541,35,0
28,1,10,85,44,41,1,1.87602301240258,-6,0
28,1,1.5,19,69,-50,0,0.553988405838027,-19,0
28,1,1.5,37,57,-20,1,1.42212936133728,7,0
28,1,1.5,60,29,31,1,0.943341782447533,-21,0
28,1,1.5,93,13,80,0,0.844444566624588,37,0
28,1,1.5,37,55,-18,0,1.07792213979701,-5,0
28,1,10,92,13,79,0,0.667095170807443,37,0
28,1,10,97,15,82,0,0.602447128854692,35,0
28,1,10,78,18,60,0,0.669192971661687,32,0
28,1,10,62,5,57,0,0.644411943139858,45,0
28,1,10,97,6,91,0,0.892141219417681,44,0
28,1,1.5,53,47,6,1,0.881336243794067,-3,0
28,1,1.5,71,4,67,0,0.927998108571046,46,0
28,1,1.5,34,56,-22,0,0.700831166061107,-6,0
28,1,1.5,9,57,-48,0,0.57054574713402,-7,0
28,1,1.5,50,93,-43,0,0.598003002087353,-43,0
28,1,1.5,98,48,50,1,0.830728402055684,-2,0
28,1,1.5,91,10,81,0,0.958512075274484,40,0
28,1,1.5,94,15,79,0,0.530367160958122,35,0
28,1,1.5,50,49,1,0,1.20792860952497,1,0
28,1,1.5,26,72,-46,0,1.0578729846311,-22,0
28,1,10,79,32,47,0,1.16097569915291,18,0
28,1,10,78,45,33,0,1.44492328896013,5,0
28,1,10,34,96,-62,0,1.541004986997,-46,0
28,1,10,88,16,72,0,0.921502733588568,34,0
28,1,10,99,15,84,0,1.45547314152645,35,0
28,1,10,14,58,-44,0,0.877305958929355,-8,0
28,1,10,100,8,92,0,0.668546733169933,42,0
28,1,10,16,69,-53,0,1.41201607714174,-19,0
28,1,10,60,30,30,0,1.92536953440867,20,0
28,1,10,90,8,82,0,1.70668433466926,42,0
28,1,1.5,89,15,74,0,0.847942611973849,35,0
28,1,1.5,90,12,78,0,0.679919137721299,38,0
28,1,1.5,84,16,68,0,0.806489510068786,34,0
28,1,1.5,92,31,61,0,0.672567487577908,19,0
28,1,1.5,95,27,68,0,1.04776116667199,23,0
28,1,1.5,48,69,-21,1,0.875436155998614,19,0
28,1,1.5,10,57,-47,0,0.707026698117261,-7,0
28,1,1.5,76,4,72,0,0.913049948780099,46,0
28,1,1.5,34,86,-52,NaN,NaN,0,0
28,1,1.5,89,19,70,0,0.53419693961041,31,0
28,1,10,61,19,42,0,1.40204171775258,31,0
28,1,10,80,0,80,0,0.972136234267964,50,0
28,1,10,98,5,93,1,1.39133241328818,-45,0
28,1,10,14,97,-83,0,1.14531018897833,-47,0
28,1,10,97,17,80,0,1.08516125721508,33,0
28,1,10,100,8,92,0,1.04978309040598,42,0
28,1,10,46,88,-42,1,1.77780722445459,38,0
28,1,10,72,43,29,1,1.00513105299615,-7,0
28,1,10,28,88,-60,0,1.26300220482517,-38,0
28,1,10,32,71,-39,0,1.11826274378109,-21,0
28,1,1.5,97,49,48,1,0.914212664880324,-1,0
28,1,1.5,95,15,80,0,0.607486909371801,35,0
28,1,1.5,14,88,-74,0,0.472931844386039,-38,0
28,1,1.5,43,93,-50,0,0.79939151678991,-43,0
28,1,1.5,94,15,79,0,0.792652015414205,35,0
28,1,1.5,92,10,82,0,0.466078710596776,40,0
28,1,1.5,100,4,96,0,0.433317388145952,46,0
28,1,1.5,88,13,75,0,0.681976250823936,37,0
28,1,1.5,79,44,35,1,1.08042205274978,-6,0
28,1,1.5,14,97,-83,0,0.654249943647301,-47,0
28,1,10,3,77,-74,0,1.40520399765228,-27,0
28,1,10,96,8,88,0,1.36625630705385,42,0
28,1,10,53,12,41,0,0.720788315651589,38,0
28,1,10,82,6,76,0,0.974204344063764,44,0
28,1,10,89,18,71,0,0.921001284776139,32,0
28,1,1.5,68,6,62,0,0.58887465429143,44,0
28,1,1.5,99,5,94,0,0.479771415586583,45,0
28,1,1.5,29,83,-54,0,0.710132894935668,-33,0
28,1,1.5,18,85,-67,0,0.612074359582039,-35,0
28,1,1.5,99,6,93,0,0.684737884861534,44,0
28,1,10,41,89,-48,0,1.33004165910825,-39,0
28,1,10,84,32,52,1,1.46247729643073,-18,0
28,1,10,20,84,-64,0,0.933858608303126,-34,0
28,1,10,79,23,56,0,1.33770781442581,27,0
28,1,10,46,88,-42,1,1.11787089526479,38,0
28,1,10,8,63,-55,0,1.23430452385219,-13,0
28,1,10,11,79,-68,0,2.16317540261662,-29,0
28,1,10,58,27,31,0,1.87841112571186,23,0
28,1,10,23,100,-77,0,2.72514520205732,-50,0
28,1,10,94,17,77,0,2.18498512697988,33,0
28,1,1.5,3,72,-69,0,0.539199697959702,-22,0
28,1,1.5,56,10,46,0,0.679570176260313,40,0
28,1,1.5,38,74,-36,0,1.08617295218573,-24,0
28,1,1.5,98,11,87,0,0.924799906162662,39,0
28,1,1.5,85,16,69,0,1.26548342341266,34,0
28,1,10,95,13,82,0,0.853951566925389,37,0
28,1,10,73,31,42,1,1.42932192610169,-19,0
28,1,10,27,63,-36,0,0.861827025815728,-13,0
28,1,10,77,37,40,1,1.27631259175541,-13,0
28,1,10,36,75,-39,1,1.61184013019374,25,0
28,1,1.5,6,59,-53,0,0.723786744958488,-9,0
28,1,1.5,14,70,-56,0,1.32847169911838,-20,0
28,1,1.5,94,14,80,0,1.11629213791457,36,0
28,1,1.5,95,16,79,0,0.913459758536192,34,0
28,1,1.5,1,63,-62,0,1.40633555650129,-13,0
28,1,1.5,68,20,48,1,0.838172790899989,-30,0
28,1,1.5,99,4,95,0,0.590221748148906,46,0
28,1,1.5,0,63,-63,0,0.503884945355821,-13,0
28,1,1.5,9,88,-79,0,0.85333721882489,-38,0
28,1,1.5,94,3,91,0,0.660081485431874,47,0
28,1,10,29,74,-45,0,0.769733092136448,-24,0
28,1,10,22,62,-40,0,0.485033329110593,-12,0
28,1,10,98,5,93,0,1.09920255708857,45,0
28,1,10,86,18,68,0,1.62445589320851,32,0
28,1,10,5,91,-86,0,0.80978668264288,-41,0
28,1,1.5,98,39,59,1,1.1855191992945,-11,0
28,1,1.5,99,8,91,0,0.650353451768751,42,0
28,1,1.5,97,14,83,0,0.873734968903591,36,0
28,1,1.5,64,20,44,0,1.12022968407837,30,0
28,1,1.5,100,9,91,0,0.71678478938702,41,0
28,1,10,88,43,45,1,1.40091345792462,-7,0
28,1,10,7,84,-77,0,1.0188739761652,-34,0
28,1,10,4,82,-78,0,0.810690610116581,-32,0
28,1,10,15,84,-69,0,0.932093273877399,-34,0
28,1,10,27,71,-44,0,1.19240055790578,-21,0
29,1,1.5,53,40,13,1,1.10093416149994,-10,0
29,1,1.5,100,0,100,0,0.666652248896753,50,0
29,1,1.5,28,85,-57,1,0.89045036591142,35,0
29,1,1.5,50,43,7,1,0.689849584786316,-7,0
29,1,1.5,53,23,30,1,0.585445261654968,-27,0
29,1,10,85,15,70,0,2.86038821677266,35,0
29,1,10,48,100,-52,1,6.16497801595597,50,0
29,1,10,50,100,-50,1,0.936934476736496,50,0
29,1,10,48,60,-12,1,2.81417682172469,10,0
29,1,10,5,83,-78,0,1.63224167602857,-33,0
29,1,1.5,48,80,-32,1,0.832600898422243,30,0
29,1,1.5,98,38,60,0,0.978191901734135,12,0
29,1,1.5,80,45,35,1,0.933505002538368,-5,0
29,1,1.5,3,100,-97,0,0.810686499653457,-50,0
29,1,1.5,30,100,-70,0,0.708593662657222,-50,0
29,1,10,0,68,-68,0,1.2752680880385,-18,0
29,1,10,75,0,75,0,2.57128200240822,50,0
29,1,10,25,55,-30,0,3.6479001068501,-5,0
29,1,10,53,0,53,0,2.8083541199685,50,0
29,1,10,100,15,85,0,3.37901847979356,35,0
29,1,1.5,96,41,55,1,1.11579863752104,-9,0
29,1,1.5,39,92,-53,0,1.21782072969836,-42,0
29,1,1.5,79,47,32,1,1.10770843604496,-3,0
29,1,1.5,50,32,18,0,0.94640548510597,18,0
29,1,1.5,21,64,-43,0,0.879045788025905,-14,0
29,1,10,61,22,39,0,1.2371890481154,28,0
29,1,10,48,95,-47,1,1.24624805039366,45,0
29,1,10,24,81,-57,0,1.63088212923594,-31,0
29,1,10,47,63,-16,1,2.49601721335057,13,0
29,1,10,56,30,26,0,1.11911924533979,20,0
29,1,10,57,4,53,0,1.03447435317048,46,0
29,1,10,47,68,-21,1,2.97240145668366,18,0
29,1,10,77,33,44,0,2.94381541833809,17,0
29,1,10,40,51,-11,1,2.86123642148505,1,0
29,1,10,39,63,-24,1,1.88493117042344,13,0
29,1,1.5,49,64,-15,1,0.843714432859997,14,0
29,1,1.5,51,27,24,1,0.748802378198889,-23,0
29,1,1.5,3,85,-82,0,0.705940548694343,-35,0
29,1,1.5,94,10,84,0,0.648098045719962,40,0
29,1,1.5,33,92,-59,0,1.15308812128478,-42,0
29,1,10,5,60,-55,0,1.98195127404779,-10,0
29,1,10,32,96,-64,0,0.729435525995541,-46,0
29,1,10,48,62,-14,1,0.718123319581537,12,0
29,1,10,11,54,-43,1,0.628214353134354,4,0
29,1,10,47,84,-37,1,1.9740062277433,34,0
29,1,1.5,20,88,-68,0,0.744283140556945,-38,0
29,1,1.5,95,10,85,0,0.61326043806821,40,0
29,1,1.5,2,76,-74,0,0.702214899298269,-26,0
29,1,1.5,82,47,35,1,1.13297753210554,-3,0
29,1,1.5,79,24,55,0,1.42611070281146,26,0
29,1,1.5,90,24,66,0,0.889927660674402,26,0
29,1,1.5,1,64,-63,0,0.625182222889634,-14,0
29,1,1.5,88,43,45,0,0.563114091598436,7,0
29,1,1.5,17,93,-76,0,0.823227393273555,-43,0
29,1,1.5,26,59,-33,0,0.704399191382436,-9,0
29,1,10,95,19,76,0,0.94252038495415,31,0
29,1,10,44,58,-14,1,0.723804531699898,8,0
29,1,10,73,29,44,0,0.929699444488506,21,0
29,1,10,64,40,24,1,0.855093718556418,-10,0
29,1,10,79,47,32,1,0.855738486097835,-3,0
29,1,10,73,11,62,0,0.950210676602183,39,0
29,1,10,3,60,-57,0,0.634866198822237,-10,0
29,1,10,86,17,69,0,0.732153886474407,33,0
29,1,10,83,24,59,0,0.865477078495132,26,0
29,1,10,1,80,-79,0,0.625877208255588,-30,0
29,1,1.5,4,87,-83,0,0.970879160152435,-37,0
29,1,1.5,32,80,-48,0,0.502027957032624,-30,0
29,1,1.5,97,26,71,0,1.04402160466088,24,0
29,1,1.5,91,13,78,0,1.06932588985455,37,0
29,1,1.5,52,42,10,1,0.80457422066138,-8,0
29,1,1.5,69,12,57,0,0.669370609376529,38,0
29,1,1.5,35,74,-39,1,0.850778284639091,24,0
29,1,1.5,96,18,78,0,0.594377802988674,32,0
29,1,1.5,7,98,-91,0,0.589272446359246,-48,0
29,1,1.5,35,52,-17,1,0.967636628221044,2,0
29,1,10,95,2,93,0,0.978506038052728,48,0
29,1,10,100,26,74,0,1.0615677858159,24,0
29,1,10,11,67,-56,0,0.620805574544647,-17,0
29,1,10,58,19,39,0,1.36630603915182,31,0
29,1,10,41,61,-20,1,1.34630211703006,11,0
29,1,10,97,12,85,0,0.722222120401966,38,0
29,1,10,2,62,-60,0,0.455624487970454,-12,0
29,1,10,73,34,39,1,1.54341880749143,-16,0
29,1,10,43,59,-16,0,0.676933340419964,-9,0
29,1,10,16,59,-43,0,0.682915492931897,-9,0
29,1,1.5,45,61,-16,1,0.960719764379974,11,0
29,1,1.5,26,55,-29,0,0.71610764208981,-5,0
29,1,1.5,31,68,-37,1,0.937486872803674,18,0
29,1,1.5,72,16,56,0,0.854110255616433,34,0
29,1,1.5,97,34,63,NaN,NaN,0,0
29,1,1.5,31,96,-65,1,1.01183564475832,46,0
29,1,1.5,90,11,79,0,0.62892106820982,39,0
29,1,1.5,97,42,55,1,0.821733321359716,-8,0
29,1,1.5,86,22,64,0,0.519585867898058,28,0
29,1,1.5,81,25,56,0,0.572423816444825,25,0
29,1,10,3,91,-88,0,0.606989441427686,-41,0
29,1,10,46,61,-15,1,0.673002787639234,11,0
29,1,10,7,77,-70,0,0.664348826937385,-27,0
29,1,10,76,43,33,1,0.743674295255005,-7,0
29,1,10,25,68,-43,0,0.827990755521569,-18,0
29,1,1.5,46,65,-19,1,0.621032471138278,15,0
29,1,1.5,80,21,59,0,0.59014960879631,29,0
29,1,1.5,91,31,60,0,0.640778339622557,19,0
29,1,1.5,11,62,-51,0,0.521325530631657,-12,0
29,1,1.5,22,80,-58,0,0.478789200601568,-30,0
29,1,10,12,52,-40,0,1.22912340572202,-2,0
29,1,10,49,83,-34,1,1.50130034840913,33,0
29,1,10,89,20,69,0,3.97908739184368,30,0
29,1,10,96,14,82,0,0.725926143142715,36,0
29,1,10,60,30,30,0,3.93215791856255,20,0
29,1,1.5,7,93,-86,0,0.495530430352119,-43,0
29,1,1.5,46,50,-4,1,0.517769962043531,0,0
29,1,1.5,39,56,-17,0,0.515473871152608,-6,0
29,1,1.5,46,81,-35,1,0.664498014197306,31,0
29,1,1.5,95,38,57,0,0.760960956557938,12,0
29,1,10,35,64,-29,0,1.09872237790569,-14,0
29,1,10,16,50,-34,0,0.640258566812918,0,0
29,1,10,87,28,59,0,1.00096293594652,22,0
29,1,10,89,17,72,0,0.514780718554903,33,0
29,1,10,34,76,-42,0,1.38425909464968,-26,0
29,1,10,99,20,79,0,0.98994507196312,30,0
29,1,10,85,31,54,0,0.896849656264749,19,0
29,1,10,38,54,-16,1,0.9349198989039,4,0
29,1,10,81,25,56,0,0.899949965451924,25,0
29,1,10,56,8,48,0,0.881419588250537,42,0
29,1,1.5,91,33,58,0,0.687292141276885,17,0
29,1,1.5,91,30,61,0,0.566120929653152,20,0
29,1,1.5,74,6,68,0,0.753464205137789,44,0
29,1,1.5,9,74,-65,0,0.805295964430115,-24,0
29,1,1.5,12,97,-85,0,0.776022271788861,-47,0
29,1,1.5,49,63,-14,1,0.671214739847528,13,0
29,1,1.5,11,87,-76,0,0.454406797367483,-37,0
29,1,1.5,15,55,-40,0,0.549784741479016,-5,0
29,1,1.5,100,1,99,0,0.47392576925813,49,0
29,1,1.5,8,79,-71,0,0.641045923650381,-29,0
29,1,10,45,59,-14,1,0.697145098355577,9,0
29,1,10,86,17,69,0,0.679001435056307,33,0
29,1,10,59,27,32,0,0.829829021137812,23,0
29,1,10,71,16,55,0,0.542752046742862,34,0
29,1,10,56,49,7,1,0.730171565348428,-1,0
29,1,10,23,67,-44,0,1.13349400593415,-17,0
29,1,10,46,68,-22,0,0.618434340194653,-18,0
29,1,10,38,61,-23,1,1.19540085370318,11,0
29,1,10,54,2,52,0,0.685818962910162,48,0
29,1,10,97,11,86,0,0.731258396365774,39,0
29,1,1.5,12,91,-79,0,0.511316055224597,-41,0
29,1,1.5,49,90,-41,1,0.619926212788414,40,0
29,1,1.5,7,82,-75,0,0.62860180014377,-32,0
29,1,1.5,89,15,74,0,0.676673820568794,35,0
29,1,1.5,7,96,-89,0,0.579437816953941,-46,0
29,1,10,93,18,75,0,0.556203092611213,32,0
29,1,10,72,28,44,0,0.471188347998577,22,0
29,1,10,97,33,64,0,0.518224121783533,17,0
29,1,10,97,48,49,1,0.659058360809468,-2,0
29,1,10,70,40,30,0,0.739142961348989,10,0
29,1,1.5,93,44,49,1,0.487010994770571,-6,0
29,1,1.5,9,52,-43,0,0.541021181292308,-2,0
29,1,1.5,40,75,-35,1,0.633059090250754,25,0
29,1,1.5,99,4,95,0,1.18490826083143,46,0
29,1,1.5,16,87,-71,0,0.683065046744559,-37,0
29,1,10,86,32,54,0,1.148598574473,18,0
29,1,10,94,30,64,0,0.736352389837521,20,0
29,1,10,12,70,-58,0,0.604077907272767,-20,0
29,1,10,65,17,48,0,0.621599162791426,33,0
29,1,10,0,74,-74,0,0.758530340545803,-24,0
29,1,1.5,99,0,99,0,0.576604358687291,50,0
29,1,1.5,68,16,52,0,0.491999420845787,34,0
29,1,1.5,61,29,32,0,0.457989490912041,21,0
29,1,1.5,7,79,-72,0,0.553481799704059,-29,0
29,1,1.5,85,23,62,0,0.916431675351305,27,0
29,1,10,92,47,45,1,0.624338050265578,-3,0
29,1,10,13,86,-73,0,0.632498263453272,-36,0
29,1,10,15,81,-66,0,0.776590063102958,-31,0
29,1,10,25,79,-54,0,1.08237629278847,-29,0
29,1,10,5,58,-53,0,0.896309723014383,-8,0
29,1,1.5,84,25,59,0,0.757709260789852,25,0
29,1,1.5,47,61,-14,1,0.752967891749904,11,0
29,1,1.5,49,75,-26,1,0.892207256658367,25,0
29,1,1.5,50,98,-48,1,0.618289918130358,48,0
29,1,1.5,91,36,55,0,0.794242544760891,14,0
29,1,1.5,66,1,65,0,0.63353670941342,49,0
29,1,1.5,17,51,-34,0,0.474120042593313,-1,0
29,1,1.5,77,33,44,0,0.760836328380719,17,0
29,1,1.5,95,18,77,0,0.69938070792432,32,0
29,1,1.5,57,38,19,1,0.880700043803699,-12,0
29,1,10,4,79,-75,0,0.709457629168355,-29,0
29,1,10,67,15,52,0,0.538941356944633,35,0
29,1,10,45,82,-37,1,0.951376683166927,32,0
29,1,10,90,17,73,0,0.635022717150605,33,0
29,1,10,48,71,-23,1,0.570747934012616,21,0
29,1,1.5,9,96,-87,0,0.55599525679736,-46,0
29,1,1.5,14,89,-75,0,0.551376316614551,-39,0
29,1,1.5,20,52,-32,0,0.65053929178157,-2,0
29,1,1.5,93,15,78,0,0.641985766728794,35,0
29,1,1.5,77,44,33,1,0.641835479809743,-6,0
29,1,10,61,9,52,0,0.697104777474124,41,0
29,1,10,98,10,88,0,0.781648134334318,40,0
29,1,10,89,25,64,0,0.903549520457091,25,0
29,1,10,83,6,77,0,1.52491995388755,44,0
29,1,10,62,41,21,1,0.7456313241928,-9,0
30,1,10,50,43,7,1,2.02857687450887,-7,0
30,1,10,0,68,-68,0,1.84534046402041,-18,0
30,1,10,28,85,-57,0,2.43785947439937,-35,0
30,1,10,50,100,-50,0,2.70310892319321,-50,0
30,1,10,48,60,-12,1,1.88569470128641,10,0
30,1,1.5,98,38,60,1,1.08437987401521,-12,0
30,1,1.5,100,0,100,0,0.852032997143397,50,0
30,1,1.5,100,15,85,0,1.21217983845963,35,0
30,1,1.5,53,0,53,0,1.17468948339774,50,0
30,1,1.5,53,23,30,NaN,NaN,0,0
30,1,1.5,80,45,35,0,0.809580974409982,5,0
30,1,1.5,75,0,75,0,0.764112949784248,50,0
30,1,1.5,48,80,-32,1,0.664392813354425,30,0
30,1,1.5,48,100,-52,0,0.688205592507074,-50,0
30,1,1.5,30,100,-70,0,0.551399409483565,-50,0
30,1,10,53,40,13,1,0.939450133149876,-10,0
30,1,10,5,83,-78,0,0.848969343300269,-33,0
30,1,10,85,15,70,0,1.16952547821347,35,0
30,1,10,3,100,-97,0,1.09317275848116,-50,0
30,1,10,25,55,-30,0,1.48457964565387,-5,0
30,1,1.5,52,50,2,1,0.75367497337902,0,0
30,1,1.5,49,84,-35,1,0.742339307544171,34,0
30,1,1.5,100,50,50,0,0.731601490406319,0,0
30,1,1.5,32,92,-60,1,0.840426448297876,42,0
30,1,1.5,1,51,-50,0,0.753667642309665,-1,0
30,1,10,46,55,-9,1,1.06965432175639,5,0
30,1,10,41,84,-43,1,1.61371166538083,34,0
30,1,10,15,55,-40,0,1.11169617116502,-5,0
30,1,10,42,64,-22,1,1.34953878410488,14,0
30,1,10,31,56,-25,1,1.35402026674092,6,0
30,1,1.5,36,77,-41,0,0.733533593707762,-27,0
30,1,1.5,33,52,-19,1,0.802863882203383,2,0
30,1,1.5,94,11,83,0,1.14150613152378,39,0
30,1,1.5,45,60,-15,0,0.96323945288168,-10,0
30,1,1.5,15,82,-67,0,0.958722414561635,-32,0
30,1,10,93,18,75,0,1.23486766503629,32,0
30,1,10,64,1,63,0,1.19605771750867,49,0
30,1,10,12,53,-41,0,1.40664268185174,-3,0
30,1,10,54,47,7,1,1.03321414236598,-3,0
30,1,10,5,84,-79,0,0.906558191278236,-34,0
30,1,1.5,84,23,61,0,0.561015573024633,27,0
30,1,1.5,48,92,-44,1,0.7419753199556,42,0
30,1,1.5,28,76,-48,0,0.915025209713349,-26,0
30,1,1.5,86,25,61,0,1.12142486662015,25,0
30,1,1.5,58,46,12,0,1.13495618769775,4,0
30,1,10,41,71,-30,0,1.06750265292976,-21,0
30,1,10,22,82,-60,0,1.28390775315529,-32,0
30,1,10,99,6,93,0,1.26696821798214,44,0
30,1,10,19,96,-77,0,1.24322838296757,-46,0
30,1,10,61,22,39,0,1.48420612767404,28,0
30,1,10,98,22,76,0,1.02553448076833,28,0
30,1,10,30,83,-53,1,1.19532754301144,33,0
30,1,10,35,75,-40,1,1.35774664924247,25,0
30,1,10,87,33,54,1,1.65068994525609,-17,0
30,1,10,6,98,-92,0,1.22721806082154,-48,0
30,1,1.5,87,27,60,0,0.683708714625027,23,0
30,1,1.5,23,73,-50,1,1.10729459718459,23,0
30,1,1.5,83,22,61,0,0.68178467549842,28,0
30,1,1.5,77,21,56,0,0.968956220687687,29,0
30,1,1.5,44,55,-11,1,1.06114478311974,5,0
30,1,1.5,98,24,74,0,0.963435558986021,26,0
30,1,1.5,75,20,55,0,1.12716326107875,30,0
30,1,1.5,0,71,-71,0,0.581345361175408,-21,0
30,1,1.5,43,53,-10,1,0.720413545617703,3,0
30,1,1.5,39,77,-38,0,0.837623413968686,-27,0
30,1,10,7,63,-56,0,1.07778301134749,-13,0
30,1,10,96,26,70,0,1.4455050465258,24,0
30,1,10,13,62,-49,0,1.36604248721051,-12,0
30,1,10,35,82,-47,0,1.40212857595907,-32,0
30,1,10,85,19,66,0,1.26088086462732,31,0
30,1,10,100,10,90,0,1.25943591087525,40,0
30,1,10,94,40,54,1,1.65138053197916,-10,0
30,1,10,45,88,-43,1,1.65956310492766,38,0
30,1,10,84,22,62,0,1.49938144102998,28,0
30,1,10,99,7,92,0,1.54410939421541,43,0
30,1,1.5,93,14,79,0,0.915629289820572,36,0
30,1,1.5,89,29,60,0,1.15258850891587,21,0
30,1,1.5,15,97,-82,0,0.644494458627378,-47,0
30,1,1.5,20,72,-52,0,1.03711133878278,-22,0
30,1,1.5,2,75,-73,0,1.12560980750459,-25,0
30,1,1.5,89,9,80,0,0.595628116849184,41,0
30,1,1.5,86,11,75,0,0.829536144919985,39,0
30,1,1.5,94,17,77,0,0.846854696374066,33,0
30,1,1.5,14,56,-42,0,0.967008722140235,-6,0
30,1,1.5,31,59,-28,0,1.34629331974611,-9,0
30,1,10,52,10,42,0,1.00559397239522,40,0
30,1,10,11,76,-65,0,1.3274707994351,-26,0
30,1,10,98,6,92,0,1.67631093264026,44,0
30,1,10,97,18,79,0,1.51455198919393,32,0
30,1,10,100,11,89,0,1.28002925096735,39,0
30,1,1.5,92,13,79,0,0.637754640107232,37,0
30,1,1.5,92,22,70,0,1.10996933780189,28,0
30,1,1.5,97,5,92,0,0.71604642766215,45,0
30,1,1.5,52,39,13,1,0.769076816775851,-11,0
30,1,1.5,77,25,52,0,0.869127217876667,25,0
30,1,10,4,74,-70,0,0.923086453467477,-24,0
30,1,10,12,80,-68,0,1.51289076890134,-30,0
30,1,10,85,18,67,0,1.749688337919,32,0
30,1,10,2,86,-84,0,1.88973412044652,-36,0
30,1,10,7,62,-55,0,1.40024522426575,-12,0
30,1,10,25,97,-72,0,1.45705697890298,-47,0
30,1,10,96,23,73,0,2.04082635812665,27,0
30,1,10,91,2,89,0,1.96167646891627,48,0
30,1,10,88,16,72,0,2.18880802312196,34,0
30,1,10,76,15,61,0,3.12706649096617,35,0
30,1,1.5,1,100,-99,0,1.3878722121317,-50,0
30,1,1.5,85,29,56,NaN,NaN,0,0
30,1,1.5,6,76,-70,0,0.646682782800781,-26,0
30,1,1.5,86,20,66,0,0.950668868430512,30,0
30,1,1.5,25,93,-68,0,0.834582119889092,-43,0
30,1,10,81,26,55,0,1.24221522919652,24,0
30,1,10,20,75,-55,0,0.962711615895387,-25,0
30,1,10,12,98,-86,0,0.909506380779931,-48,0
30,1,10,97,7,90,0,1.00360615296631,43,0
30,1,10,52,25,27,1,1.39701882068766,-25,0
30,1,1.5,34,53,-19,1,0.734064729676902,3,0
30,1,1.5,45,58,-13,1,0.898917017795611,8,0
30,1,1.5,86,20,66,0,0.712935121870032,30,0
30,1,1.5,10,79,-69,0,0.694148157243035,-29,0
30,1,1.5,34,98,-64,0,0.7969557734923,-48,0
30,1,10,43,98,-55,0,0.777439734029031,-48,0
30,1,10,8,80,-72,0,1.06032920166399,-30,0
30,1,10,90,14,76,0,1.11558860238802,36,0
30,1,10,100,9,91,0,1.08887015393339,41,0
30,1,10,94,26,68,0,1.18316529911681,24,0
30,1,1.5,98,18,80,0,0.569625180756702,32,0
30,1,1.5,64,46,18,1,0.89215557262105,-4,0
30,1,1.5,89,15,74,0,0.850283437466715,35,0
30,1,1.5,38,80,-42,0,0.65094909855361,-30,0
30,1,1.5,59,13,46,0,0.930148472480141,37,0
30,1,10,57,42,15,1,0.997373644438994,-8,0
30,1,10,51,31,20,0,1.02267829618722,19,0
30,1,10,84,26,58,0,1.41526805138346,24,0
30,1,10,15,100,-85,0,1.01621852451353,-50,0
30,1,10,55,49,6,1,0.905655736654808,-1,0
30,1,1.5,32,71,-39,0,0.694146691030255,-21,0
30,1,1.5,79,22,57,0,0.588951345525857,28,0
30,1,1.5,100,50,50,0,0.711820799342604,0,0
30,1,1.5,14,92,-78,0,0.869233884934147,-42,0
30,1,1.5,94,13,81,0,0.931388889397567,37,0
30,1,10,25,85,-60,0,0.90263790199424,-35,0
30,1,10,91,20,71,0,0.748535527278364,30,0
30,1,10,84,41,43,0,1.06451927429771,9,0
30,1,10,50,7,43,0,0.7912137134972,43,0
30,1,10,7,52,-45,0,1.06510942537352,-2,0
30,1,1.5,14,65,-51,0,0.495698678392728,-15,0
30,1,1.5,70,6,64,0,0.661196833711074,44,0
30,1,1.5,18,87,-69,0,0.715568075393094,-37,0
30,1,1.5,47,57,-10,1,0.712534478936504,7,0
30,1,1.5,96,27,69,0,0.87705833515065,23,0
30,1,10,63,9,54,0,1.04233032698539,41,0
30,1,10,18,83,-65,0,0.866292293398146,-33,0
30,1,10,75,20,55,0,0.521058313157482,30,0
30,1,10,91,30,61,0,0.59057407770706,20,0
30,1,10,28,74,-46,0,0.504222146060783,-24,0
30,1,1.5,97,32,65,0,0.525054845562408,18,0
30,1,1.5,91,5,86,0,0.53853558226001,45,0
30,1,1.5,36,66,-30,0,0.718800710381402,-16,0
30,1,1.5,86,39,47,0,1.09129600474989,11,0
30,1,1.5,49,64,-15,1,0.754107873017347,14,0
30,1,10,99,21,78,0,0.509859005209364,29,0
30,1,10,27,69,-42,0,1.10785359121473,-19,0
30,1,10,97,21,76,0,1.39335548538111,29,0
30,1,10,23,79,-56,0,0.955389710476084,-29,0
30,1,10,1,63,-62,0,0.823650762522448,-13,0
30,1,1.5,99,45,54,1,0.919289692699749,-5,0
30,1,1.5,100,23,77,0,0.604255685700991,27,0
30,1,1.5,18,72,-54,0,0.829628882946054,-22,0
30,1,1.5,21,86,-65,0,0.949631155577663,-36,0
30,1,1.5,16,76,-60,0,0.968856884697743,-26,0
30,1,10,99,19,80,0,1.12210665606108,31,0
30,1,10,52,10,42,0,1.51101034963722,40,0
30,1,10,6,82,-76,0,0.795826055718862,-32,0
30,1,10,94,14,80,0,1.16528812018623,36,0
30,1,10,24,83,-59,0,0.928052519780977,-33,0
30,1,1.5,49,53,-4,1,0.811996195176107,3,0
30,1,1.5,74,30,44,0,0.628678409817439,20,0
30,1,1.5,97,18,79,0,0.549586802610065,32,0
30,1,1.5,3,59,-56,0,0.504792869802259,-9,0
30,1,1.5,64,3,61,0,0.557032603097468,47,0
30,1,10,60,2,58,0,0.613902639734079,48,0
30,1,10,47,69,-22,1,1.14237413012233,19,0
30,1,10,61,7,54,0,0.530656882132462,43,0
30,1,10,97,9,88,0,0.845582755859141,41,0
30,1,10,100,33,67,0,1.03734080124923,17,0
30,1,1.5,63,24,39,0,0.548318527627998,26,0
30,1,1.5,83,20,63,0,0.335286085814005,30,0
30,1,1.5,17,93,-76,0,0.48347961870968,-43,0
30,1,1.5,9,59,-50,0,0.457703212658089,-9,0
30,1,1.5,84,2,82,0,0.60073677246146,48,0
30,1,10,10,58,-48,0,0.639364542916155,-8,0
30,1,10,99,29,70,0,1.19881016746149,21,0
30,1,10,96,21,75,0,0.792681393562816,29,0
30,1,10,19,65,-46,0,0.699491040517387,-15,0
30,1,10,4,53,-49,0,0.60078479096228,-3,0
30,1,1.5,89,21,68,0,0.666081158602537,29,0
30,1,1.5,88,12,76,0,0.528512910928839,38,0
30,1,1.5,85,27,58,0,0.820681679473637,23,0
30,1,1.5,50,30,20,1,0.965480927306999,-20,0
30,1,1.5,80,24,56,0,0.679928815317908,26,0
31,1,10,100,0,100,1,1.6826198597264,-50,0
31,1,10,48,100,-52,0,1.57746587807196,-50,0
31,1,10,53,40,13,1,1.30092060912284,-10,0
31,1,10,30,100,-70,0,1.13958875913522,-50,0
31,1,10,100,15,85,0,1.48900968994712,35,0
31,1,1.5,80,45,35,0,0.591834931838093,5,0
31,1,1.5,75,0,75,1,0.931327286351006,-50,0
31,1,1.5,50,100,-50,0,1.15246409110841,-50,0
31,1,1.5,0,68,-68,0,1.18949482878088,-18,0
31,1,1.5,48,80,-32,NaN,NaN,0,0
31,1,1.5,28,85,-57,0,1.22497209580615,-35,0
31,1,1.5,53,23,30,1,1.02718646961148,-27,0
31,1,1.5,5,83,-78,0,0.829363454598933,-33,0
31,1,1.5,48,60,-12,0,0.823175230994821,-10,0
31,1,1.5,98,38,60,1,1.25660270848311,-12,0
31,1,10,53,0,53,0,1.7362985390937,50,0
31,1,10,85,15,70,1,1.42174235775019,-35,0
31,1,10,25,55,-30,0,1.35162320823292,-5,0
31,1,10,50,43,7,0,1.86838716536295,7,0
31,1,10,3,100,-97,0,1.02069693576777,-50,0
31,1,10,34,90,-56,0,1.6014673296304,-40,0
31,1,10,49,99,-50,1,1.76409679316566,49,0
31,1,10,16,70,-54,0,1.24823200155515,-20,0
31,1,10,51,1,50,0,1.473072136665,49,0
31,1,10,16,69,-53,0,0.793242146028206,-19,0
31,1,1.5,51,3,48,0,0.571907766803633,47,0
31,1,1.5,97,3,94,0,0.823955631873105,47,0
31,1,1.5,37,83,-46,0,0.99406323482981,-33,0
31,1,1.5,96,24,72,0,0.70953067811206,26,0
31,1,1.5,49,98,-49,0,1.41202675137902,-48,0
31,1,1.5,93,4,89,0,0.894997773168143,46,0
31,1,1.5,43,84,-41,1,0.966370549314888,34,0
31,1,1.5,79,34,45,0,1.14634697965812,16,0
31,1,1.5,3,99,-96,0,0.871362879086519,-49,0
31,1,1.5,51,42,9,1,1.09544827233185,-8,0
31,1,10,61,20,41,0,0.941500723041827,30,0
31,1,10,58,21,37,0,1.03490470422548,29,0
31,1,10,49,99,-50,1,1.26040904151159,49,0
31,1,10,80,45,35,1,1.40513950263266,-5,0
31,1,10,97,3,94,0,0.695988578081597,47,0
31,1,10,15,82,-67,0,0.95603619387839,-32,0
31,1,10,63,35,28,1,1.50446631977684,-15,0
31,1,10,72,35,37,0,1.57551542564761,15,0
31,1,10,19,90,-71,0,1.02748887956841,-40,0
31,1,10,13,79,-66,0,0.837002146203304,-29,0
31,1,1.5,93,4,89,0,0.957739220000803,46,0
31,1,1.5,53,0,53,0,0.506521241099108,50,0
31,1,1.5,100,25,75,0,0.921287643170217,25,0
31,1,1.5,61,20,41,1,0.895403918868396,-30,0
31,1,1.5,62,38,24,1,1.23017354664626,-12,0
31,1,10,3,91,-88,0,0.846115865162574,-41,0
31,1,10,30,64,-34,1,1.16687823142274,14,0
31,1,10,30,95,-65,0,1.68293033391819,-45,0
31,1,10,3,51,-48,0,0.882550946902484,-1,0
31,1,10,100,25,75,0,1.09784519177629,25,0
31,1,1.5,50,43,7,1,0.719399872061331,-7,0
31,1,1.5,58,2,56,0,0.485566981951706,48,0
31,1,1.5,66,32,34,1,1.06062017861404,-18,0
31,1,1.5,1,90,-89,0,0.517003319197102,-40,0
31,1,1.5,51,3,48,0,0.899006079358514,47,0
31,1,10,86,6,80,0,1.52768150551128,44,0
31,1,10,49,99,-50,1,1.67026540593361,49,0
31,1,10,10,73,-63,0,0.821380932058673,-23,0
31,1,10,5,76,-71,0,0.76756186116836,-26,0
31,1,10,50,43,7,1,1.06764378675143,-7,0
31,1,1.5,71,24,47,0,0.930310822412139,26,0
31,1,1.5,27,96,-69,0,0.702972964558285,-46,0
31,1,1.5,80,45,35,1,1.29324306242052,-5,0
31,1,1.5,26,67,-41,0,1.27688580084941,-17,0
31,1,1.5,99,14,85,0,0.596096529247006,36,0
31,1,1.5,97,31,66,0,0.540769440849544,19,0
31,1,1.5,19,66,-47,0,0.713365236035315,-16,0
31,1,1.5,51,1,50,0,0.52754697893397,49,0
31,1,1.5,28,73,-45,0,0.749556557071628,-23,0
31,1,1.5,50,43,7,1,0.721174010337563,-7,0
31,1,10,53,45,8,1,1.02249673305778,-5,0
31,1,10,98,37,61,0,1.03208184495452,13,0
31,1,10,72,35,37,0,0.936787160229869,15,0
31,1,10,50,82,-32,0,1.46153877169127,-32,0
31,1,10,37,87,-50,0,0.941482395166531,-37,0
31,1,1.5,8,72,-64,0,0.780257579957834,-22,0
31,1,1.5,99,2,97,0,0.910966483817901,48,0
31,1,1.5,38,99,-61,0,0.965652463171864,-49,0
31,1,1.5,48,72,-24,0,0.98513389431173,-22,0
31,1,1.5,96,11,85,0,0.691986869904213,39,0
31,1,10,95,7,88,0,0.538613716227701,43,0
31,1,10,50,43,7,1,0.65543925500242,-7,0
31,1,10,63,19,44,0,0.575953461870085,31,0
31,1,10,29,99,-70,0,0.883726863336051,-49,0
31,1,10,28,67,-39,0,0.690768799366197,-17,0
31,1,10,94,9,85,0,0.769249125296483,41,0
31,1,10,75,31,44,0,1.39651550445706,19,0
31,1,10,44,89,-45,0,1.32745570610859,-39,0
31,1,10,10,92,-82,0,1.69338601984782,-42,0
31,1,10,79,46,33,0,2.06859390376485,4,0
31,1,1.5,72,35,37,0,0.850290588452481,15,0
31,1,1.5,45,95,-50,0,1.1551227325981,-45,0
31,1,1.5,25,76,-51,0,0.63097777380608,-26,0
31,1,1.5,95,7,88,0,0.495798701304011,43,0
31,1,1.5,82,13,69,0,0.69270788852009,37,0
31,1,10,100,14,86,0,1.4105616210727,36,0
31,1,10,100,8,92,0,1.50900540122529,42,0
31,1,10,61,44,17,1,1.00284338646452,-6,0
31,1,10,16,93,-77,0,1.05300677948981,-43,0
31,1,10,98,7,91,0,0.917151408386417,43,0
31,1,1.5,18,88,-70,0,0.690019555826439,-38,0
31,1,1.5,84,16,68,0,0.704841308092,34,0
31,1,1.5,89,8,81,0,0.494550572999287,42,0
31,1,1.5,17,65,-48,0,0.428623374988092,-15,0
31,1,1.5,87,4,83,0,0.597626173665049,46,0
31,1,10,46,84,-38,1,1.92575231342926,34,0
31,1,10,95,17,78,0,0.659020888269879,33,0
31,1,10,87,20,67,0,0.571376624982804,30,0
31,1,10,1,63,-62,0,0.494647710758727,-13,0
31,1,10,93,11,82,0,0.525405183492694,39,0
31,1,1.5,96,46,50,0,1.20224809710635,4,0
31,1,1.5,12,89,-77,0,0.484353676671162,-39,0
31,1,1.5,49,99,-50,1,1.19506210400141,49,0
31,1,1.5,92,19,73,0,0.941331373469438,31,0
31,1,1.5,33,79,-46,0,0.705604114249581,-29,0
31,1,1.5,100,16,84,0,0.782979635900119,34,0
31,1,1.5,66,34,32,1,1.0979012750613,-16,0
31,1,1.5,0,93,-93,0,0.584052549675107,-43,0
31,1,1.5,98,13,85,0,0.78683252169867,37,0
31,1,1.5,71,49,22,1,1.20545584172942,-1,0
31,1,10,12,79,-67,0,0.886836370569654,-29,0
31,1,10,100,4,96,0,1.13357538345736,46,0
31,1,10,28,91,-63,0,1.27462304144865,-41,0
31,1,10,86,5,81,0,1.28184129160945,45,0
31,1,10,53,8,45,0,1.84862678399077,42,0
31,1,10,59,33,26,0,2.15946937137051,17,0
31,1,10,5,100,-95,0,0.747487706568791,-50,0
31,1,10,97,18,79,0,0.879515117761912,32,0
31,1,10,35,54,-19,0,1.65440153074451,-4,0
31,1,10,24,68,-44,0,0.830596187443007,-18,0
31,1,1.5,95,22,73,NaN,NaN,0,0
31,1,1.5,97,47,50,0,0.678868510323809,3,0
31,1,1.5,89,6,83,0,0.74151025354513,44,0
31,1,1.5,37,56,-19,1,0.794366744434228,6,0
31,1,1.5,90,17,73,0,0.493072246666998,33,0
31,1,1.5,20,61,-41,0,0.649922198179411,-11,0
31,1,1.5,95,22,73,0,0.746001315943431,28,0
31,1,1.5,20,100,-80,0,0.638082391116768,-50,0
31,1,1.5,97,11,86,0,0.534661126759602,39,0
31,1,1.5,31,98,-67,0,0.843564991548192,-48,0
31,1,10,55,19,36,0,0.91504040377913,31,0
31,1,10,43,62,-19,1,1.07172613756848,12,0
31,1,10,86,35,51,0,1.42320932084112,15,0
31,1,10,93,17,76,0,0.583998299174709,33,0
31,1,10,56,8,48,0,0.55472025249037,42,0
31,1,10,45,56,-11,1,1.10080844254117,6,0
31,1,10,86,17,69,0,0.5069310523686,33,0
31,1,10,0,54,-54,0,0.760233643755782,-4,0
31,1,10,100,21,79,0,0.69160894912784,29,0
31,1,10,28,81,-53,0,0.744888447399717,-31,0
31,1,1.5,81,1,80,0,0.444706451584352,49,0
31,1,1.5,5,78,-73,0,0.460677361610578,-28,0
31,1,1.5,50,85,-35,1,0.86805763017037,35,0
31,1,1.5,91,10,81,0,0.985574129852466,40,0
31,1,1.5,67,36,31,NaN,NaN,0,0
31,1,10,14,62,-48,0,0.64924663270358,-12,0
31,1,10,4,98,-94,0,0.848417846224038,-48,0
31,1,10,72,35,37,1,1.62255648194696,-15,0
31,1,10,96,9,87,0,0.599110364972148,41,0
31,1,10,44,84,-40,0,1.31276444831747,-34,0
31,1,1.5,89,6,83,0,0.597616643150104,44,0
31,1,1.5,52,42,10,1,0.703595745755592,-8,0
31,1,1.5,5,89,-84,0,0.589179589354899,-39,0
31,1,1.5,81,49,32,0,0.831218235485721,1,0
31,1,1.5,30,72,-42,0,0.695208177174209,-22,0
31,1,10,90,16,74,0,0.674730076221749,34,0
31,1,10,74,49,25,1,1.37620931898709,-1,0
31,1,10,18,53,-35,0,0.611508805624908,-3,0
31,1,10,7,85,-78,0,0.637646187708015,-35,0
31,1,10,52,16,36,0,1.22978536225855,34,0
31,1,1.5,96,22,74,0,0.517909449292347,28,0
31,1,1.5,84,27,57,0,0.626535096962471,23,0
31,1,1.5,99,28,71,0,0.580034712998895,22,0
31,1,1.5,54,50,4,1,0.719117989356164,0,0
31,1,1.5,6,90,-84,0,0.61147434922168,-40,0
31,1,1.5,28,94,-66,0,0.530777083564317,-44,0
31,1,1.5,27,76,-49,0,0.950389009143692,-26,0
31,1,1.5,15,97,-82,0,0.953648804919794,-47,0
31,1,1.5,94,0,94,0,0.566056776093319,50,0
31,1,1.5,25,89,-64,0,0.880674172542058,-39,0
31,1,10,89,23,66,0,0.870064165908843,27,0
31,1,10,70,34,36,0,0.748736934532644,16,0
31,1,10,16,74,-58,0,0.640209157689242,-24,0
31,1,10,99,16,83,0,0.912242837017402,34,0
31,1,10,100,21,79,0,1.16502858232707,29,0
31,1,10,97,10,87,0,0.710658575524576,40,0
31,1,10,56,47,9,1,0.70867293360061,-3,0
31,1,10,29,91,-62,0,0.506857374304673,-41,0
31,1,10,82,13,69,0,0.895903170196107,37,0
31,1,10,58,39,19,0,1.39697956625605,11,0
31,1,1.5,88,23,65,0,0.510341503279051,27,0
31,1,1.5,80,12,68,0,0.452537219331134,38,0
31,1,1.5,69,48,21,1,0.691800658678403,-2,0
31,1,1.5,82,39,43,0,0.697352171962848,11,0
31,1,1.5,33,78,-45,0,0.941818161809351,-28,0
