subj,exp,tp,self,other,fair,resp,rt,given,gen
6,1,10,15,0,15,1,4.67360439862568,-10,0
6,1,2,16,9,7,1,1.18506739977056,-1,0
6,1,2,20,0,20,1,1.0445456128291,-10,0
6,1,2,10,20,-10,0,1.59695981672485,-10,0
6,1,2,20,3,17,1,0.91160705612856,-7,0
6,1,2,10,9,1,1,1.00551514318431,-1,0
6,1,10,10,16,-6,0,1.00782882016028,-6,0
6,1,10,11,5,6,1,1.20264577319722,-5,0
6,1,10,5,11,-6,0,0.925219335624206,-1,0
6,1,10,1,20,-19,0,0.867015257732419,-10,0
6,1,10,0,14,-14,0,0.891201099657337,-4,0
6,1,10,11,8,3,1,1.30626859106451,-2,0
6,1,10,17,3,14,1,0.993058969072081,-7,0
6,1,2,20,8,12,1,0.684146437572053,-2,0
6,1,10,10,20,-10,0,0.80353502863727,-10,0
6,1,2,11,0,11,1,0.71808403207433,-10,0
6,1,2,6,20,-14,0,0.756243573883694,-10,0
6,1,2,6,17,-11,0,0.856925910651626,-7,0
6,1,2,10,12,-2,1,0.969171867125624,2,0
6,1,10,1,17,-16,0,1.52553383734266,-7,0
6,1,2,9,10,-1,0,0.591385658648505,0,0
6,1,10,13,10,3,1,0.658402749140805,0,0
6,1,2,2,18,-16,0,1.23506327605901,-8,0
6,1,10,20,9,11,1,1.10845544100812,-1,0
6,1,2,8,14,-6,1,1.92291738831591,4,0
6,1,2,8,11,-3,0,1.28092884306898,-1,0
6,1,10,9,16,-7,1,1.48037131729689,6,0
6,1,2,11,1,10,0,1.34394208476442,9,0
6,1,10,9,20,-11,1,1.67612261168324,10,0
6,1,10,11,4,7,0,2.30031871706888,6,0
6,1,10,12,5,7,0,1.6346794959918,5,0
6,1,10,19,2,17,1,1.14798955326478,-8,0
6,1,2,9,19,-10,1,1.07248128293213,9,0
6,1,2,9,16,-7,NaN,NaN,0,0
6,1,2,13,5,8,1,0.909356059564743,-5,0
6,1,10,3,19,-16,0,0.971883253150736,-9,0
6,1,2,11,4,7,1,1.0396389461639,-6,0
6,1,10,11,3,8,1,0.865442382588299,-7,0
6,1,10,5,16,-11,0,1.43319569301275,-6,0
6,1,2,11,2,9,1,0.722397983963674,-8,0
6,1,2,15,5,10,0,0.914042428406901,5,0
6,1,10,17,9,8,1,0.544267949599089,-1,0
6,1,10,19,1,18,0,0.89261525773145,9,0
6,1,2,9,19,-10,1,1.43616623138587,9,0
6,1,2,13,10,3,1,0.845344696448592,0,0
6,1,10,9,17,-8,1,0.926193631155911,7,0
6,1,2,14,2,12,0,1.24412701030815,8,0
6,1,10,11,1,10,0,1.31666180985121,9,0
6,1,2,7,16,-9,0,1.06643830469693,-6,0
6,1,10,11,4,7,0,1.05052371134116,6,0
6,1,10,13,8,5,1,0.723127422679681,-2,0
6,1,2,20,4,16,1,0.905230148911869,-6,0
6,1,2,19,4,15,1,1.75971958762966,-6,0
6,1,10,9,18,-9,1,1.41212591065232,8,0
6,1,2,16,1,15,1,1.10238973653941,-9,0
6,1,10,11,0,11,0,1.03604563573936,10,0
6,1,10,18,0,18,1,0.885759266895548,-10,0
6,1,2,11,4,7,0,0.86051555555423,6,0
6,1,2,9,20,-11,1,1.13277177548662,10,0
6,1,10,18,3,15,1,0.913990378006929,-7,0
6,1,10,11,2,9,0,0.806981351659488,8,0
6,1,2,6,20,-14,1,1.30596728522323,10,0
6,1,2,9,19,-10,1,1.02423899198038,9,0
6,1,10,11,4,7,0,0.738503550974201,6,0
6,1,10,0,13,-13,0,0.743833951888519,-3,0
6,1,2,9,18,-9,1,1.41302946162614,8,0
6,1,10,13,2,11,0,0.958738327606625,8,0
6,1,10,19,0,19,0,1.30741663230219,10,0
6,1,2,10,20,-10,1,0.85005379152426,10,0
6,1,2,9,12,-3,0,0.930668132876235,-2,0
6,1,10,7,14,-7,0,0.727453837342182,-4,0
6,1,10,4,14,-10,0,1.14940774341267,-4,0
6,1,10,11,3,8,0,1.31390753722917,7,0
6,1,2,17,1,16,0,1.07176247422649,9,0
6,1,10,3,11,-8,0,0.775948682703529,-1,0
6,1,2,9,20,-11,1,0.851612004582421,10,0
6,1,2,11,4,7,0,0.692242474227896,6,0
6,1,2,11,1,10,0,1.30692068728422,9,0
6,1,2,9,16,-7,1,0.841766781213664,6,0
6,1,10,9,18,-9,1,1.03478762886698,8,0
6,1,10,17,6,11,1,1.21675876288646,-4,0
6,1,10,9,16,-7,1,0.834723482244954,6,0
6,1,10,20,10,10,1,0.691892783504954,0,0
6,1,2,5,18,-13,1,1.36361823596781,8,0
6,1,2,9,18,-9,1,1.02325479954197,8,0
6,1,10,17,2,15,0,1.23343321878565,8,0
6,1,2,3,16,-13,0,0.842718350515497,-6,0
6,1,10,11,4,7,0,0.924014478809113,6,0
6,1,2,0,17,-17,0,0.689645452463083,-7,0
6,1,2,11,3,8,0,0.760734936997324,7,0
6,1,10,20,6,14,1,0.763535028636397,-4,0
6,1,10,9,20,-11,1,1.10311477663163,10,0
6,1,2,0,13,-13,0,0.821749369988538,-3,0
6,1,2,3,15,-12,0,0.775004810995597,-5,0
6,1,10,16,10,6,1,0.706745475372372,0,0
6,1,2,11,3,8,0,0.649564444443968,7,0
6,1,2,11,2,9,0,0.841911202749543,8,0
6,1,10,11,4,7,0,0.843273310423683,6,0
6,1,10,11,8,3,0,0.860991706758796,2,0
6,1,2,9,18,-9,0,0.700699564718889,-8,0
6,1,10,9,20,-11,1,0.883161512028892,10,0
6,1,2,12,6,6,0,1.15494597938232,4,0
6,1,10,1,19,-18,0,0.831224009163634,-9,0
6,1,10,11,4,7,0,0.872685819014805,6,0
6,1,10,8,12,-4,0,0.904516471937313,-2,0
6,1,2,11,2,9,0,0.798873218785957,8,0
6,1,2,9,18,-9,1,1.03354245131777,8,0
6,1,10,10,19,-9,1,0.747029186713917,9,0
6,1,2,12,0,12,0,1.15164187857954,10,0
6,1,2,13,9,4,1,1.13998882016131,-1,0
6,1,10,3,19,-16,0,1.07286542955262,-9,0
6,1,10,9,19,-10,1,1.23209970217795,9,0
6,1,2,11,0,11,0,1.08918323024045,10,0
6,1,2,9,11,-2,0,1.11258941580854,-1,0
6,1,10,9,13,-4,1,1.21446671248668,3,0
6,1,10,6,18,-12,1,1.52034089347217,8,0
6,1,2,9,20,-11,1,0.822425292095431,10,0
6,1,2,9,16,-7,1,0.936320366552536,6,0
6,1,10,5,19,-14,1,1.58086524627652,9,0
6,1,2,5,12,-7,0,1.16038231385937,-2,0
6,1,2,9,20,-11,1,0.803191202749076,10,0
6,1,10,1,14,-13,0,0.885684123712053,-4,0
6,1,10,11,3,8,0,1.21999065292221,7,0
6,1,2,20,5,15,1,1.30202245131659,-5,0
6,1,10,11,1,10,0,0.724862680412116,9,0
6,1,2,18,5,13,1,1.9057572508591,-5,0
6,1,2,5,12,-7,0,0.904734936997556,-2,0
6,1,2,18,3,15,0,1.26324783505152,7,0
6,1,10,9,19,-10,1,1.08664192439755,9,0
6,1,10,19,8,11,1,0.861961603666714,-2,0
6,1,10,11,3,8,0,0.877165819014408,7,0
6,1,10,15,10,5,1,0.892649347078986,0,0
6,1,2,17,0,17,0,0.834544971363357,10,0
6,1,10,12,3,9,0,0.755742130582803,7,0
6,1,10,9,17,-8,1,0.919825887744082,7,0
6,1,10,11,2,9,0,1.00533333333442,8,0
6,1,2,10,0,10,0,1.0396499427261,10,0
6,1,2,11,4,7,0,0.624096036655828,6,0
6,1,2,3,14,-11,0,0.841477938143726,-4,0
6,1,2,12,5,7,0,0.946065154639655,5,0
6,1,10,20,9,11,1,0.85381388316091,-1,0
6,1,2,9,19,-10,1,0.878750057274374,9,0
6,1,10,7,12,-5,0,1.42925599083537,-2,0
6,1,2,9,18,-9,1,0.910352348224478,8,0
6,1,2,11,0,11,0,1.42132233677148,10,0
6,1,10,17,10,7,1,0.751076655211364,0,0
6,1,10,11,3,8,0,0.778838946162068,7,0
6,1,10,19,7,12,1,1.40635234822366,-3,0
6,1,2,5,17,-12,0,1.71278515463928,-7,0
6,1,2,1,20,-19,0,1.02272146620817,-10,0
6,1,2,7,13,-6,0,1.12809127147739,-3,0
6,1,2,9,16,-7,1,0.900487331042314,6,0
6,1,10,20,9,11,1,0.906973104238205,-1,0
6,1,10,9,18,-9,1,0.961476471935384,8,0
6,1,2,9,19,-10,1,1.26066950744644,9,0
6,1,10,6,16,-10,0,1.36433374570515,-6,0
6,1,10,10,9,1,0,0.760485681557839,1,0
6,1,2,11,3,8,0,1.13165379152451,7,0
6,1,10,12,5,7,0,0.889165269187288,5,0
6,1,2,11,2,9,0,0.727747445589557,8,0
6,1,10,7,18,-11,1,1.85349681557818,8,0
6,1,10,10,0,10,0,0.981753035508518,10,0
6,1,2,10,4,6,0,0.992292142038423,6,0
6,1,2,9,16,-7,1,0.93887413516677,6,0
6,1,2,9,20,-11,1,0.895263230240744,10,0
6,1,10,4,20,-16,0,0.957387216494681,-10,0
6,1,2,11,2,9,0,1.29021287514297,8,0
6,1,10,13,3,10,0,0.680664925543169,7,0
6,1,2,9,18,-9,1,1.2231166093934,8,0
6,1,10,11,0,11,0,0.839697227949728,10,0
6,1,10,11,1,10,0,0.591988270332877,9,0
6,1,2,11,0,11,0,1.02652591065271,10,0
6,1,10,18,10,8,1,0.603853928980243,0,0
6,1,10,15,4,11,0,0.829564261168343,6,0
6,1,2,11,3,8,0,0.742418694157095,7,0
6,1,2,10,13,-3,1,0.706359129439079,3,0
6,1,10,9,16,-7,0,0.855997434135134,-6,0
6,1,2,19,2,17,0,0.967982405498333,8,0
6,1,2,19,1,18,0,0.939601741123624,9,0
6,1,10,3,19,-16,0,0.864116197022668,-9,0
6,1,2,9,19,-10,1,1.07879074455923,9,0
6,1,2,1,17,-16,0,0.957411408935513,-7,0
6,1,2,12,0,12,0,0.929288797251502,10,0
6,1,10,8,13,-5,0,1.44581681557975,-3,0
6,1,10,19,4,15,1,1.83786813287406,-6,0
6,1,10,7,16,-9,1,2.15847880870569,6,0
6,1,2,1,14,-13,0,1.0426017869413,-4,0
6,1,2,9,18,-9,1,0.923213195876087,8,0
6,1,10,11,1,10,0,1.27231596792626,9,0
6,1,10,11,0,11,0,1.2316334478819,10,0
6,1,10,9,15,-6,1,1.09557846506323,5,0
6,1,2,0,12,-12,0,0.686112256586057,-2,0
6,1,10,18,2,16,0,1.01290336769853,8,0
6,1,2,1,16,-15,0,0.942313493700567,-6,0
6,1,10,9,20,-11,1,1.09051857960912,10,0
6,1,10,11,1,10,0,0.80917919816784,9,0
6,1,2,11,3,8,0,0.643466116838681,7,0
6,1,2,12,3,9,0,0.61191624284038,7,0
6,1,10,11,2,9,0,0.613498648339373,8,0
6,1,2,14,6,8,0,0.757848339060729,4,0
7,1,10,0,14,-14,0,4.81429129117532,-4,0
7,1,2,5,11,-6,0,0.375458699203591,-1,0
7,1,10,10,20,-10,0,0.779845276651031,-10,0
7,1,10,1,17,-16,0,7.0468905958187,-7,0
7,1,2,10,20,-10,0,0.520061434810486,-10,0
7,1,10,20,0,20,1,4.3421292147068,-10,0
7,1,2,11,0,11,0,0.80360507973819,10,0
7,1,2,16,9,7,0,0.430161706244689,1,0
7,1,2,20,8,12,0,0.280414721630223,2,0
7,1,10,17,3,14,0,3.49587202791736,7,0
7,1,10,11,8,3,0,0.926443543939968,2,0
7,1,2,6,17,-11,0,0.261378361090465,-7,0
7,1,2,1,20,-19,0,0.270100564677705,-10,0
7,1,10,11,5,6,0,0.638210179633461,5,0
7,1,10,6,20,-14,0,2.50333804358161,-10,0
7,1,2,10,9,1,0,0.262130534312746,1,0
7,1,10,20,3,17,1,2.08620191012596,-7,0
7,1,2,10,12,-2,0,0.261663175220747,-2,0
7,1,10,15,0,15,0,0.40572267461539,10,0
7,1,2,10,16,-6,0,0.273474714038457,-6,0
7,1,10,9,16,-7,0,0.254803809984878,-6,0
7,1,10,11,3,8,0,0.279467173979356,7,0
7,1,2,9,19,-10,0,0.278608332919248,-9,0
7,1,2,1,12,-11,0,0.254967294029484,-2,0
7,1,2,18,3,15,0,0.239446573526948,7,0
7,1,2,7,12,-5,0,0.216815396823222,-2,0
7,1,10,17,3,14,0,0.234831631598354,7,0
7,1,2,11,0,11,0,0.25258357938219,10,0
7,1,10,7,11,-4,0,0.229379841977789,-1,0
7,1,10,2,10,-8,0,0.294423031456972,0,0
7,1,10,16,5,11,0,0.285827656294714,5,0
7,1,2,17,9,8,0,0.229492374717665,1,0
7,1,10,9,19,-10,0,0.270641601557145,-9,0
7,1,2,18,10,8,0,0.279030972160399,0,0
7,1,2,9,16,-7,0,0.230134214532882,-6,0
7,1,10,19,5,14,0,0.287745111516415,5,0
7,1,10,11,3,8,0,0.231241214107285,7,0
7,1,2,11,1,10,0,0.240596460167581,9,0
7,1,2,17,3,14,0,0.265715086901764,7,0
7,1,10,7,10,-3,0,2.12976270987565,0,0
7,1,2,2,18,-16,0,0.423094137117005,-8,0
7,1,10,11,5,6,0,2.76099256074303,5,0
7,1,2,9,16,-7,0,0.869581154616753,-6,0
7,1,10,11,3,8,0,1.30199058317157,7,0
7,1,10,10,2,8,0,0.596467498380662,8,0
7,1,2,9,17,-8,0,0.199243428105547,-7,0
7,1,10,10,5,5,0,0.289916223591717,5,0
7,1,10,11,10,1,0,0.321275835336564,0,0
7,1,2,11,2,9,0,0.239398921225074,8,0
7,1,2,0,16,-16,0,0.257006812447798,-6,0
7,1,2,9,17,-8,0,0.297628931541112,-7,0
7,1,10,15,9,6,0,0.263696565078135,1,0
7,1,10,3,10,-7,0,0.312338096729945,0,0
7,1,2,1,11,-10,0,0.214429482843116,-1,0
7,1,2,9,18,-9,0,0.224814385128411,-8,0
7,1,10,4,16,-12,0,0.234472773125162,-6,0
7,1,10,11,3,8,0,0.259962721236661,7,0
7,1,2,10,11,-1,0,0.245541669188242,-1,0
7,1,10,9,16,-7,0,0.238408853063447,-6,0
7,1,2,20,1,19,0,0.231676682811667,9,0
7,1,2,4,19,-15,0,0.344156636776461,-9,0
7,1,2,0,17,-17,0,0.261591330214287,-7,0
7,1,2,9,18,-9,0,0.238325644815632,-8,0
7,1,10,4,16,-12,0,0.263784802213195,-6,0
7,1,10,9,19,-10,0,0.287851046243304,-9,0
7,1,10,12,0,12,0,0.271405138017144,10,0
7,1,10,11,2,9,0,0.311539004324004,8,0
7,1,2,20,7,13,0,0.213307454469032,3,0
7,1,10,3,15,-12,0,0.431628663955053,-5,0
7,1,2,11,1,10,0,0.35283265428734,9,0
7,1,2,6,18,-12,0,0.213731926491164,-8,0
7,1,2,14,6,8,0,0.215926864719222,4,0
7,1,10,11,4,7,0,0.497978992665594,6,0
7,1,2,9,16,-7,0,0.56871150014922,-6,0
7,1,2,15,8,7,0,0.388726565608522,2,0
7,1,10,11,1,10,0,0.335902158833051,9,0
7,1,10,9,20,-11,0,0.397308011633868,-10,0
7,1,10,1,10,-9,0,2.72830308328776,0,0
7,1,2,6,14,-8,0,0.269788991954556,-4,0
7,1,10,10,13,-3,0,0.237613059660362,-3,0
7,1,10,20,6,14,0,1.3354058418081,4,0
7,1,10,1,19,-18,0,0.364851297330461,-9,0
7,1,2,11,2,9,0,0.193048262615775,8,0
7,1,10,5,20,-15,0,0.748484198680671,-10,0
7,1,2,5,10,-5,0,0.249368881948612,0,0
7,1,2,11,0,11,0,0.218102008911956,10,0
7,1,2,18,3,15,0,0.227754165451188,7,0
7,1,2,2,13,-11,0,0.534151853218646,-3,0
7,1,10,11,4,7,0,0.93945152203014,6,0
7,1,10,9,18,-9,0,0.336775295581901,-8,0
7,1,2,11,4,7,0,0.285048724475928,6,0
7,1,10,9,15,-6,0,0.348186555085704,-5,0
7,1,2,6,13,-7,0,0.281183389874059,-3,0
7,1,2,3,20,-17,0,0.288335266915965,-10,0
7,1,2,10,15,-5,0,0.199766503734281,-5,0
7,1,10,11,2,9,0,0.226717544661369,8,0
7,1,10,6,16,-10,0,0.227806216425961,-6,0
7,1,10,9,16,-7,0,0.26129881840825,-6,0
7,1,10,19,4,15,0,0.245329799730825,6,0
7,1,2,9,17,-8,0,0.237386161406903,-7,0
7,1,2,9,16,-7,0,0.222485653910553,-6,0
7,1,10,0,19,-19,0,0.343468244322139,-9,0
7,1,10,9,18,-9,0,0.268487717617973,-8,0
7,1,10,10,13,-3,0,0.268312137224711,-3,0
7,1,2,18,0,18,0,0.276021546171251,10,0
7,1,2,9,19,-10,0,0.227374779835372,-9,0
7,1,2,10,8,2,0,0.220490855343087,2,0
7,1,10,11,2,9,0,0.245935717048269,8,0
7,1,10,3,18,-15,0,0.246040918660583,-8,0
7,1,2,15,1,14,0,0.222377519843576,9,0
7,1,10,11,0,11,0,0.223729378922144,10,0
7,1,2,14,3,11,0,0.233559315198363,7,0
7,1,10,11,2,9,0,0.250948372398852,8,0
7,1,10,10,9,1,0,0.483227673521469,1,0
7,1,2,9,18,-9,0,0.217751581232733,-8,0
7,1,10,19,3,16,0,0.315809750027256,7,0
7,1,2,17,2,15,0,0.297889186411339,8,0
7,1,2,9,19,-10,0,0.288842947185913,-9,0
7,1,10,11,8,3,0,0.199360726073792,2,0
7,1,2,20,7,13,0,0.233378969576734,3,0
7,1,2,9,20,-11,0,0.390788077394973,-10,0
7,1,10,10,18,-8,0,0.273673020918068,-8,0
7,1,2,9,17,-8,0,0.313896326922986,-7,0
7,1,10,8,15,-7,0,0.37571455539728,-5,0
7,1,2,13,5,8,0,0.252026047481195,5,0
7,1,10,9,16,-7,0,0.300767751854437,-6,0
7,1,10,11,8,3,0,0.283487561831862,2,0
7,1,2,9,19,-10,0,0.266025193403038,-9,0
7,1,2,14,1,13,0,0.242411279665248,9,0
7,1,10,2,13,-11,0,0.195479996116774,-3,0
7,1,2,3,19,-16,0,0.181587884588225,-9,0
7,1,2,11,1,10,0,0.168947562309768,9,0
7,1,2,12,5,7,0,0.180991497727518,5,0
7,1,10,19,5,14,0,0.280625857969426,5,0
7,1,2,9,17,-8,0,0.215270729207987,-7,0
7,1,10,9,20,-11,0,0.168486801227118,-10,0
7,1,10,11,0,11,0,0.540815110911353,10,0
7,1,2,13,9,4,0,0.289329000639555,1,0
7,1,10,10,2,8,0,0.22410216652861,8,0
7,1,10,7,12,-5,0,0.249726274196291,-2,0
7,1,2,14,3,11,0,0.193485564104776,7,0
7,1,2,14,9,5,0,0.180342693347484,1,0
7,1,10,18,10,8,0,0.511672430762701,0,0
7,1,10,11,4,7,0,0.236706932861125,6,0
7,1,10,4,16,-12,0,0.31733792261366,-6,0
7,1,2,7,11,-4,0,0.242486057119095,-1,0
7,1,2,11,0,11,0,0.23548813366142,10,0
7,1,10,11,1,10,0,0.267970506891288,9,0
7,1,10,10,19,-9,0,0.284305348606722,-9,0
7,1,2,11,3,8,0,0.266780665631813,7,0
7,1,2,2,14,-12,0,0.274438023603579,-4,0
7,1,2,13,2,11,0,0.434239276859444,8,0
7,1,2,14,4,10,0,0.531281718562241,6,0
7,1,10,11,0,11,0,0.712638306216832,10,0
7,1,10,1,12,-11,0,0.950698930941144,-2,0
7,1,2,20,4,16,0,0.298553752712905,6,0
7,1,10,9,20,-11,0,0.296587912078394,-10,0
7,1,10,9,17,-8,0,0.607384273640491,-7,0
7,1,10,9,16,-7,0,0.346407658093085,-6,0
7,1,2,8,13,-5,0,0.318389205654967,-3,0
7,1,2,13,5,8,0,0.554393083821196,5,0
7,1,2,13,6,7,0,0.230693579218496,4,0
7,1,10,9,20,-11,0,0.287440136798978,-10,0
7,1,10,10,19,-9,0,2.27054373106512,-9,0
7,1,10,16,0,16,0,1.35888376321236,10,0
7,1,10,18,10,8,0,1.69074867260497,0,0
7,1,2,9,19,-10,0,0.225806652630126,-9,0
7,1,10,16,2,14,0,2.13915791055479,8,0
7,1,2,9,16,-7,0,0.215700699569425,-6,0
7,1,2,9,18,-9,0,0.449293004825449,-8,0
7,1,10,9,17,-8,0,2.75339458486269,-7,0
7,1,10,7,14,-7,0,0.301525423419662,-4,0
7,1,2,9,18,-9,0,0.203387345383817,-8,0
7,1,2,3,19,-16,0,0.181538032949902,-9,0
7,1,2,14,2,12,0,0.56896735634291,8,0
7,1,2,16,0,16,0,0.38056959160167,10,0
7,1,10,11,0,11,0,0.255481572305143,10,0
7,1,10,7,16,-9,0,0.327281857855269,-6,0
7,1,2,11,1,10,0,0.276372706961411,9,0
7,1,10,11,2,9,0,0.291879131775204,8,0
7,1,2,11,2,9,0,0.202182475313748,8,0
7,1,10,2,11,-9,0,0.187310559198522,-1,0
7,1,2,11,1,10,0,0.238351670304837,9,0
7,1,10,9,19,-10,0,0.326983114591712,-9,0
7,1,2,16,4,12,0,0.54038880610824,6,0
7,1,10,17,3,14,0,0.553591792075167,7,0
7,1,10,12,8,4,0,0.573874443522072,2,0
7,1,2,9,16,-7,0,0.481038600195461,-6,0
7,1,10,11,5,6,0,0.607728469865833,5,0
7,1,2,2,10,-8,0,0.602084238271345,0,0
7,1,10,17,8,9,0,0.44409303928478,2,0
7,1,2,4,15,-11,0,0.508906398052204,-5,0
7,1,2,11,2,9,0,0.307468398277706,8,0
7,1,2,9,18,-9,0,0.329474230184132,-8,0
7,1,10,3,14,-11,0,0.478221249628405,-4,0
7,1,10,3,13,-10,0,0.756465592290624,-3,0
7,1,10,9,20,-11,0,0.392417786035367,-10,0
7,1,2,20,0,20,0,0.539327992610197,10,0
7,1,10,20,7,13,0,0.816111242460465,3,0
7,1,2,9,16,-7,0,0.393550077984401,-6,0
8,1,2,6,20,-14,0,1.04930581112421,-10,0
8,1,10,11,5,6,0,1.93791998463712,5,0
8,1,10,17,3,14,0,0.975382284064835,7,0
8,1,10,5,11,-6,0,0.859156416459882,-1,0
8,1,2,10,20,-10,1,0.95638794520346,10,0
8,1,2,20,8,12,1,0.961764628264064,-2,0
8,1,10,20,3,17,0,0.605699034771533,7,0
8,1,10,10,9,1,0,1.40027843798453,1,0
8,1,2,1,20,-19,0,0.755315834314388,-10,0
8,1,2,10,12,-2,1,0.544449274872022,2,0
8,1,2,11,8,3,0,0.701949285867158,2,0
8,1,10,1,17,-16,0,0.94099394591467,-7,0
8,1,2,20,0,20,0,0.994035356787208,10,0
8,1,2,15,0,15,0,0.589671255496796,10,0
8,1,2,10,16,-6,1,0.664883602948976,6,0
8,1,10,10,20,-10,1,2.04108976435964,10,0
8,1,10,11,0,11,0,1.00191233675287,10,0
8,1,10,6,17,-11,0,2.9325722597132,-7,0
8,1,10,0,14,-14,0,0.754063303218572,-4,0
8,1,2,16,9,7,0,0.598685667115205,1,0
8,1,2,10,2,8,0,0.446643348645011,8,0
8,1,10,12,3,9,0,1.17570588209492,7,0
8,1,2,9,20,-11,0,0.515926242529531,-10,0
8,1,10,4,20,-16,0,0.713796096584701,-10,0
8,1,10,11,3,8,0,0.887847699254053,7,0
8,1,10,14,3,11,0,0.582903482158144,7,0
8,1,2,9,18,-9,1,0.850097651236865,8,0
8,1,2,12,9,3,0,0.603155850498297,1,0
8,1,10,4,13,-9,0,0.981448097489192,-3,0
8,1,2,11,4,7,0,0.67277231279877,6,0
8,1,10,6,13,-7,0,2.59266750633105,-3,0
8,1,2,11,2,9,0,1.19587834063714,8,0
8,1,2,11,3,8,0,0.654606030038849,7,0
8,1,10,17,0,17,0,0.759527593800158,10,0
8,1,10,20,5,15,1,4.47597244357894,-5,0
8,1,10,9,19,-10,1,1.82769871514029,9,0
8,1,10,5,15,-10,0,0.974296903754293,-5,0
8,1,2,11,4,7,0,0.65795784281363,6,0
8,1,2,10,5,5,0,0.611186418558646,5,0
8,1,2,11,5,6,0,0.589840239052137,5,0
8,1,2,11,1,10,0,0.661423655350518,9,0
8,1,2,8,12,-4,1,0.717625901917927,2,0
8,1,10,9,17,-8,1,1.05975200104149,7,0
8,1,2,2,12,-10,0,0.819313318257628,-2,0
8,1,10,7,11,-4,0,1.1093147698266,-1,0
8,1,2,6,12,-6,0,0.707345763090416,-2,0
8,1,2,9,18,-9,1,0.977801938075572,8,0
8,1,10,11,3,8,0,1.12512261389202,7,0
8,1,10,9,20,-11,1,1.13907127220591,10,0
8,1,10,10,17,-7,1,0.736320762327523,7,0
8,1,2,14,2,12,0,0.438142119208351,8,0
8,1,10,0,10,-10,0,0.814891154055658,0,0
8,1,2,11,3,8,0,0.777050566044636,7,0
8,1,2,4,19,-15,0,0.565118787017127,-9,0
8,1,2,3,14,-11,0,0.528854034855613,-4,0
8,1,10,0,11,-11,0,0.686605505128682,-1,0
8,1,10,9,17,-8,1,1.10946102674643,7,0
8,1,10,20,2,18,0,0.684047291935713,8,0
8,1,2,11,2,9,0,0.851563886048098,8,0
8,1,10,11,1,10,0,2.69992881430517,9,0
8,1,2,11,1,10,0,0.458835091107176,9,0
8,1,2,3,17,-14,0,0.659674437221838,-7,0
8,1,10,13,8,5,1,2.25874499096972,-2,0
8,1,2,4,14,-10,0,0.97147036959359,-4,0
8,1,10,9,16,-7,1,0.83132361414755,6,0
8,1,10,14,5,9,0,1.49689891337766,5,0
8,1,2,16,2,14,0,0.559327526068955,8,0
8,1,10,9,17,-8,1,0.79588215284457,7,0
8,1,10,16,8,8,1,1.47020097680797,-2,0
8,1,2,11,2,9,0,0.941496497900516,8,0
8,1,2,11,1,10,0,0.586134697128728,9,0
8,1,10,11,2,9,0,0.677708758848894,8,0
8,1,2,8,11,-3,NaN,NaN,0,0
8,1,2,5,13,-8,0,0.618273097963538,-3,0
8,1,10,9,16,-7,1,0.868261368086678,6,0
8,1,2,9,20,-11,1,0.635899806307862,10,0
8,1,2,11,3,8,0,0.629283788279281,7,0
8,1,10,5,11,-6,0,0.558413328661118,-1,0
8,1,10,9,10,-1,1,0.547174272272969,0,0
8,1,10,2,17,-15,0,0.695789633420645,-7,0
8,1,10,7,10,-3,0,0.781850285697146,0,0
8,1,10,14,3,11,0,0.705165105369815,7,0
8,1,10,9,17,-8,1,0.751759848331858,7,0
8,1,10,11,3,8,0,0.764513891845127,7,0
8,1,10,12,7,5,0,0.672065221056982,3,0
8,1,2,14,8,6,0,1.48801792911399,2,0
8,1,2,11,1,10,0,0.591354493051767,9,0
8,1,2,9,16,-7,1,0.762708956790448,6,0
8,1,2,7,16,-9,0,0.51055835688021,-6,0
8,1,2,3,13,-10,0,0.493246889018337,-3,0
8,1,2,18,9,9,1,0.636790177399234,-1,0
8,1,2,9,16,-7,1,0.57378863345366,6,0
8,1,10,20,1,19,0,0.641523183367099,9,0
8,1,10,11,0,11,0,0.618858858768363,10,0
8,1,10,11,2,9,0,0.548679728868592,8,0
8,1,10,12,6,6,0,0.617210077725758,4,0
8,1,2,8,13,-5,0,1.20327402902331,-3,0
8,1,2,9,17,-8,1,0.605529318097979,7,0
8,1,2,9,10,-1,0,0.784455784960301,0,0
8,1,10,13,1,12,0,0.763530781405279,9,0
8,1,2,19,9,10,0,0.598792702257924,1,0
8,1,2,15,4,11,0,0.897610257190536,6,0
8,1,2,9,19,-10,1,0.808258640892745,9,0
8,1,10,5,20,-15,0,1.30694636073167,-10,0
8,1,10,16,10,6,1,0.793760877633758,0,0
8,1,10,10,14,-4,1,0.731925723477616,4,0
8,1,2,10,13,-3,1,0.488534776894085,3,0
8,1,10,9,16,-7,1,0.695859279578144,6,0
8,1,2,11,0,11,0,0.614514405024238,10,0
8,1,10,11,2,9,0,0.624634724255884,8,0
8,1,2,9,16,-7,1,0.554310437102686,6,0
8,1,2,17,10,7,1,0.623180219314236,0,0
8,1,10,11,1,10,0,0.625011180040019,9,0
8,1,2,9,18,-9,1,0.667309488446335,8,0
8,1,10,18,10,8,1,0.570225316303549,0,0
8,1,10,11,3,8,0,0.614236553527007,7,0
8,1,10,13,10,3,1,0.591509180827416,0,0
8,1,10,11,4,7,0,0.546114184500766,6,0
8,1,2,19,10,9,1,0.598114935215563,0,0
8,1,2,15,9,6,1,0.657031548973464,-1,0
8,1,10,9,19,-10,1,0.841309406336222,9,0
8,1,2,8,13,-5,0,1.12259995689237,-3,0
8,1,2,11,0,11,0,0.808824607520364,10,0
8,1,10,11,2,9,0,0.594755058140436,8,0
8,1,2,0,16,-16,0,0.685404658812331,-6,0
8,1,10,10,14,-4,1,0.531721990148071,4,0
8,1,10,9,16,-7,1,0.849043794973113,6,0
8,1,2,3,16,-13,0,0.656929645658238,-6,0
8,1,10,14,9,5,1,0.681643766525667,-1,0
8,1,2,3,14,-11,0,0.577178934894619,-4,0
8,1,10,12,4,8,0,0.660230506771768,6,0
8,1,2,11,2,9,0,0.589258876949316,8,0
8,1,2,8,18,-10,1,0.663234455343627,8,0
8,1,2,9,10,-1,0,0.606754357278987,0,0
8,1,10,11,1,10,0,0.569691973396402,9,0
8,1,2,9,16,-7,1,0.557351774659764,6,0
8,1,10,11,4,7,0,0.537554305672529,6,0
8,1,2,12,2,10,0,0.614959040729445,8,0
8,1,10,14,10,4,1,0.560866706058732,0,0
8,1,10,9,19,-10,1,0.820987758408592,9,0
8,1,2,11,2,9,0,0.462013521617337,8,0
8,1,2,14,10,4,1,0.525070049370697,0,0
8,1,10,11,4,7,0,0.650634733050538,6,0
8,1,2,11,1,10,0,0.610378889738058,9,0
8,1,10,14,5,9,0,0.597237760237476,5,0
8,1,10,6,19,-13,0,1.99904694737052,-9,0
8,1,2,8,18,-10,0,1.44111527684436,-8,0
8,1,2,9,18,-9,1,0.513490093384462,8,0
8,1,10,16,1,15,0,0.790798350193654,9,0
8,1,10,16,5,11,0,0.713929157398525,5,0
8,1,10,10,6,4,0,0.83897919266019,4,0
8,1,2,19,10,9,1,0.599607195697899,0,0
8,1,2,11,1,10,0,0.61774378719565,9,0
8,1,10,12,4,8,0,0.643001514617936,6,0
8,1,2,12,10,2,1,0.731411808177654,0,0
8,1,2,4,17,-13,0,0.43192271769658,-7,0
8,1,10,9,20,-11,1,1.29679488401598,10,0
8,1,10,11,4,7,0,0.678416583701619,6,0
8,1,2,18,7,11,0,0.469049249360978,3,0
8,1,10,11,2,9,0,0.748388607942616,8,0
8,1,10,9,18,-9,1,0.666871084242302,8,0
8,1,2,9,16,-7,1,0.530838583676086,6,0
8,1,2,1,15,-14,0,0.631695377989672,-5,0
8,1,10,10,14,-4,1,0.592105938398163,4,0
8,1,2,11,1,10,0,0.578780429874314,9,0
8,1,2,11,2,9,0,0.670369520492386,8,0
8,1,10,17,1,16,0,0.637668452051003,9,0
8,1,2,0,15,-15,0,0.725983806907607,-5,0
8,1,10,9,19,-10,1,0.779431364819175,9,0
8,1,10,13,2,11,0,0.725916360097472,8,0
8,1,10,20,6,14,0,1.33912031776708,4,0
8,1,10,0,15,-15,0,0.76884478291322,-5,0
8,1,2,11,3,8,0,0.779711415663769,7,0
8,1,2,9,20,-11,1,0.70266077631095,10,0
8,1,2,9,16,-7,1,0.676764870193438,6,0
8,1,2,18,2,16,0,0.68384348530526,8,0
8,1,10,11,1,10,0,0.666604229503719,9,0
8,1,10,7,10,-3,0,0.865908794330608,0,0
8,1,2,12,7,5,0,0.593197183661687,3,0
8,1,10,20,1,19,0,0.907456023953273,9,0
8,1,10,7,18,-11,0,1.3051333613912,-8,0
8,1,2,10,2,8,0,0.790728704036155,8,0
8,1,10,9,17,-8,1,0.705575284562656,7,0
8,1,2,17,8,9,0,0.847648672541254,2,0
8,1,2,9,18,-9,1,0.560293408248981,8,0
8,1,2,11,2,9,0,0.675909688732645,8,0
8,1,2,11,1,10,0,0.586481828220712,9,0
8,1,10,8,13,-5,0,0.909376058436465,-3,0
8,1,10,8,19,-11,1,1.47506301144313,9,0
8,1,10,20,8,12,1,1.04232653342478,-2,0
8,1,10,11,4,7,0,0.818964354366472,6,0
8,1,2,1,10,-9,0,0.547879164660117,0,0
8,1,2,14,1,13,0,0.608261280111037,9,0
8,1,2,8,19,-11,1,0.866511783395254,9,0
8,1,10,20,2,18,0,0.609837482530565,8,0
8,1,2,11,3,8,0,0.58746273930592,7,0
8,1,10,4,12,-8,0,1.04611418450077,-2,0
8,1,2,11,0,11,0,0.614052174496464,10,0
8,1,10,6,15,-9,0,0.743334863102064,-5,0
8,1,10,9,18,-9,1,0.667878387546807,8,0
9,1,2,5,11,-6,NaN,NaN,0,0
9,1,2,10,9,1,0,1.13911825887772,1,0
9,1,10,20,3,17,1,1.12042410080176,-7,0
9,1,2,10,20,-10,0,1.58234355097375,-10,0
9,1,10,0,14,-14,0,1.29814432989588,-4,0
9,1,2,11,0,11,0,1.28941452462823,10,0
9,1,10,10,16,-6,0,0.8894636426121,-6,0
9,1,10,11,8,3,0,1.4653034593357,2,0
9,1,10,17,3,14,1,2.8821820847661,-7,0
9,1,2,6,20,-14,0,0.64203766323044,-10,0
9,1,10,20,8,12,1,0.80325974799598,-2,0
9,1,2,20,0,20,1,0.81456274914126,-10,0
9,1,2,1,20,-19,0,0.616609942726427,-10,0
9,1,2,16,9,7,NaN,NaN,0,0
9,1,10,15,0,15,0,1.55125040091662,10,0
9,1,10,10,12,-2,0,0.619680183277524,-2,0
9,1,2,1,17,-16,0,0.773690355097642,-7,0
9,1,2,10,20,-10,0,0.609450080184615,-10,0
9,1,10,11,5,6,0,0.692256403206557,5,0
9,1,10,6,17,-11,0,0.523518900345152,-7,0
9,1,2,11,8,3,0,0.506167422679937,2,0
9,1,10,17,0,17,1,0.824629003436712,-10,0
9,1,2,0,16,-16,0,0.626706987399302,-6,0
9,1,10,20,6,14,1,0.788609759449173,-4,0
9,1,2,11,5,6,0,0.575959312714986,5,0
9,1,10,14,3,11,0,0.731982588775281,7,0
9,1,10,9,16,-7,0,0.513175532645619,-6,0
9,1,2,3,11,-8,0,0.511108178692666,-1,0
9,1,10,9,13,-4,0,0.533137227950647,-3,0
9,1,2,15,0,15,0,0.83449585337803,10,0
9,1,10,13,9,4,0,1.50633127147739,1,0
9,1,10,13,8,5,0,0.776958900343743,2,0
9,1,10,11,5,6,0,0.588894203894597,5,0
9,1,10,20,2,18,1,0.616243757160191,-8,0
9,1,2,5,15,-10,0,0.762024467354422,-5,0
9,1,2,14,3,11,0,0.958133150055801,7,0
9,1,2,20,4,16,1,0.642707353950755,-6,0
9,1,10,8,17,-9,0,0.587358350514478,-7,0
9,1,2,15,3,12,0,1.09465585337966,7,0
9,1,2,0,18,-18,1,0.957244994273424,8,0
9,1,10,7,20,-13,0,0.991155097364754,-10,0
9,1,10,11,0,11,0,0.698443436425805,10,0
9,1,2,19,1,18,1,0.993108087055589,-9,0
9,1,2,14,9,5,0,1.68436416953045,1,0
9,1,2,19,4,15,1,0.843628865979554,-6,0
9,1,2,15,9,6,0,1.30083628865941,1,0
9,1,10,7,12,-5,0,1.00355885452518,-2,0
9,1,2,13,4,9,0,0.758126552120302,6,0
9,1,10,10,17,-7,0,1.09083198167173,-7,0
9,1,10,15,8,7,0,0.890025200458695,2,0
9,1,10,4,13,-9,0,1.10333837342478,-3,0
9,1,2,7,13,-6,0,0.413995693012112,-3,0
9,1,2,15,9,6,0,0.687898465062972,1,0
9,1,10,13,4,9,0,0.63109608247396,6,0
9,1,2,20,0,20,1,1.16846882016034,-10,0
9,1,10,19,10,9,1,0.868434180985787,0,0
9,1,10,11,0,11,0,0.772397892324079,10,0
9,1,10,5,17,-12,0,0.800413470789863,-7,0
9,1,2,4,12,-8,0,0.778952943870536,-2,0
9,1,2,6,11,-5,0,1.16611702176306,-1,0
9,1,2,20,7,13,1,0.848856632301249,-3,0
9,1,2,14,7,7,NaN,NaN,0,0
9,1,10,4,14,-10,0,1.26205030927849,-4,0
9,1,10,11,3,8,0,1.04599239404342,7,0
9,1,2,15,0,15,1,1.1826221305837,-10,0
9,1,10,10,9,1,0,0.905265337914898,1,0
9,1,2,10,1,9,0,0.927901030927387,9,0
9,1,10,5,12,-7,0,0.749853104238355,-2,0
9,1,10,0,18,-18,0,0.650454066437305,-8,0
9,1,2,5,18,-13,0,0.459108728522551,-8,0
9,1,10,9,10,-1,0,0.450463596791451,0,0
9,1,10,12,8,4,0,1.1630218556711,2,0
9,1,2,9,12,-3,0,0.598971454754064,-2,0
9,1,10,12,9,3,0,1.27356517754924,1,0
9,1,2,12,10,2,1,0.977476105383175,0,0
9,1,10,15,4,11,0,0.773490584191677,6,0
9,1,2,3,11,-8,0,0.945593035508864,-1,0
9,1,2,18,6,12,1,0.606055807560551,-4,0
9,1,2,11,5,6,0,1.22457218785712,5,0
9,1,10,14,7,7,0,1.18658565864826,3,0
9,1,10,5,18,-13,0,4.29432595647268,-8,0
9,1,2,11,0,11,0,1.04023539880654,10,0
9,1,10,11,5,6,0,2.56185516779988,5,0
9,1,2,3,18,-15,0,1.08619033499963,-8,0
9,1,10,19,5,14,1,1.02954593828508,-5,0
9,1,2,17,9,8,0,1.93546803001482,1,0
9,1,2,12,8,4,0,1.18051023244516,2,0
9,1,2,2,12,-10,0,1.13615001021572,-2,0
9,1,10,7,13,-6,0,1.17342269203436,-3,0
9,1,10,12,10,2,0,0.977360957509518,0,0
9,1,10,7,14,-7,0,1.04375397255535,-4,0
9,1,10,11,10,1,0,1.221197964167,0,0
9,1,2,9,13,-4,0,0.975177081885704,-3,0
9,1,10,15,3,12,0,1.42697691538888,7,0
9,1,2,5,10,-5,0,0.820981975475661,0,0
9,1,10,8,15,-7,0,0.662727293896751,-5,0
9,1,2,11,8,3,0,0.655680409356137,2,0
9,1,2,12,9,3,0,0.648348265407549,1,0
9,1,10,10,0,10,0,1.44878153192076,10,0
9,1,2,0,18,-18,0,0.881424837554732,-8,0
9,1,2,10,9,1,0,0.534798446875357,1,0
9,1,10,19,7,12,1,1.6120049017627,-3,0
9,1,10,19,5,14,1,1.22261504799462,-5,0
9,1,10,1,18,-17,0,0.760519563311391,-8,0
9,1,2,17,9,8,1,1.43710920714148,-1,0
9,1,2,2,19,-17,0,0.6458710833449,-9,0
9,1,10,16,6,10,0,1.44647886484017,4,0
9,1,2,6,13,-7,0,0.863747772116767,-3,0
9,1,2,11,8,3,0,0.975722877990847,2,0
9,1,10,0,14,-14,0,0.818835867110465,-4,0
9,1,2,1,14,-13,0,1.23554441614215,-4,0
9,1,2,15,0,15,0,1.39683545554362,10,0
9,1,2,7,10,-3,0,1.00741481330624,0,0
9,1,10,13,10,3,0,1.17806949990882,0,0
9,1,2,16,6,10,0,1.55794443185005,4,0
9,1,2,8,15,-7,0,0.906506728058957,-5,0
9,1,10,9,14,-5,0,1.20932752701265,-4,0
9,1,10,11,5,6,1,2.29993047835342,-5,0
9,1,10,6,17,-11,0,0.641925174533753,-7,0
9,1,10,13,8,5,0,1.2263661700581,2,0
9,1,10,17,7,10,1,1.8836209160454,-3,0
9,1,10,7,17,-10,0,0.834971218122519,-7,0
9,1,2,16,1,15,NaN,NaN,0,0
9,1,2,14,9,5,0,1.12081626487998,1,0
9,1,2,1,16,-15,0,0.790148871772544,-6,0
9,1,10,15,8,7,0,0.896590918157017,2,0
9,1,10,15,0,15,0,0.687413038624072,10,0
9,1,10,15,2,13,0,0.549981543110334,8,0
9,1,2,3,20,-17,0,0.68203892184647,-10,0
9,1,2,17,5,12,1,1.04118615404877,-5,0
9,1,10,10,2,8,0,1.00917492708322,8,0
9,1,2,15,0,15,0,1.10782329756148,10,0
9,1,2,6,15,-9,0,1.01828981394283,-5,0
9,1,10,2,19,-17,0,0.932360662969586,-9,0
9,1,10,11,10,1,1,1.21701995836702,0,0
9,1,10,18,5,13,1,1.51424048076478,-5,0
9,1,10,19,1,18,1,1.28760861655246,-9,0
9,1,2,10,10,0,0,1.21481631367897,0,0
9,1,2,12,9,3,1,0.736131172303431,-1,0
9,1,2,4,11,-7,0,0.717458338991491,-1,0
9,1,2,15,4,11,1,1.5932804226868,-6,0
9,1,10,9,13,-4,0,1.53977168133861,-3,0
9,1,2,12,9,3,1,1.01648631180251,-1,0
9,1,10,10,1,9,0,0.594559799070339,9,0
9,1,10,9,20,-11,0,0.605163418775192,-10,0
9,1,2,11,9,2,0,1.39920013658593,1,0
9,1,2,1,10,-9,0,0.841111417408683,0,0
9,1,10,1,13,-12,0,0.561672633453782,-3,0
9,1,2,10,10,0,0,0.645412162972207,0,0
9,1,10,17,6,11,0,1.25408114912534,4,0
9,1,10,4,12,-8,0,0.621621170963408,-2,0
9,1,10,5,12,-7,0,0.558880657374175,-2,0
9,1,10,17,3,14,1,1.2988111890827,-7,0
9,1,10,4,17,-13,0,0.720804573293208,-7,0
9,1,2,7,14,-7,0,0.678600135513989,-4,0
9,1,2,16,6,10,1,1.05396970585934,-4,0
9,1,10,13,9,4,0,0.982041883302372,1,0
9,1,2,10,0,10,1,1.8484851588255,-10,0
9,1,2,7,12,-5,0,0.784476998518585,-2,0
9,1,2,20,10,10,0,0.683037139424414,0,0
9,1,2,6,18,-12,0,1.49626715647355,-8,0
9,1,10,7,20,-13,0,1.8706963492823,-10,0
9,1,10,17,1,16,1,1.4702876207939,-9,0
9,1,10,12,10,2,1,1.34964198636044,0,0
9,1,2,14,5,9,0,1.75339274853832,5,0
9,1,10,11,3,8,0,1.07721547205438,7,0
9,1,10,12,8,4,0,1.36459878760252,2,0
9,1,2,15,9,6,1,1.03199284124639,-1,0
9,1,2,13,2,11,0,1.63164743299603,8,0
9,1,2,3,11,-8,0,1.03247483728774,-1,0
9,1,10,3,14,-11,0,0.638982353213578,-4,0
9,1,10,13,8,5,0,0.679751475721787,2,0
9,1,10,13,2,11,0,0.975116864512529,8,0
9,1,2,11,9,2,0,1.08226749613095,1,0
9,1,2,7,19,-12,NaN,NaN,0,0
9,1,2,2,16,-14,0,0.908269024937908,-6,0
9,1,10,6,19,-13,0,0.690226853592321,-9,0
9,1,2,7,13,-6,0,0.520795834119781,-3,0
9,1,2,13,3,10,0,1.5100570214272,7,0
9,1,10,1,17,-16,0,1.02803287587994,-7,0
9,1,2,11,2,9,0,0.772035428413801,8,0
9,1,2,2,15,-13,0,0.742492009305352,-5,0
9,1,10,14,8,6,0,1.03525581680333,2,0
9,1,2,6,19,-13,0,0.603881257544344,-9,0
9,1,10,10,1,9,0,0.693850131794534,9,0
9,1,10,16,0,16,0,0.692377472953012,10,0
9,1,10,14,3,11,0,1.61036007957955,7,0
9,1,2,5,19,-14,0,1.85229908221299,-9,0
9,1,10,5,15,-10,0,0.403625102353544,-5,0
9,1,2,11,3,8,0,0.741523880413297,7,0
9,1,10,15,9,6,0,1.18481499956397,1,0
9,1,2,11,3,8,0,1.07542720229321,7,0
9,1,10,15,5,10,0,1.53869347444015,5,0
9,1,2,12,3,9,0,0.76739593349339,7,0
9,1,10,14,10,4,0,0.754028452736748,0,0
9,1,2,10,15,-5,0,1.06192861869749,-5,0
9,1,2,14,3,11,0,1.1658861367323,7,0
9,1,10,13,3,10,0,0.889073526390348,7,0
9,1,2,9,17,-8,0,1.05510363055328,-7,0
9,1,10,20,10,10,1,0.966952254075295,0,0
10,1,2,0,14,-14,0,1.82805657427525,-4,0
10,1,2,20,0,20,0,0.964975193313876,10,0
10,1,10,16,9,7,1,1.06487677298719,-1,0
10,1,10,20,8,12,1,1.34492053979193,-2,0
10,1,10,11,8,3,0,1.80640043693347,2,0
10,1,10,1,20,-19,0,1.36935370652645,-10,0
10,1,10,6,20,-14,1,1.19790586471572,10,0
10,1,2,10,20,-10,1,1.04148719161458,10,0
10,1,2,11,0,11,0,1.79544334049933,10,0
10,1,2,10,12,-2,1,0.870844673663669,2,0
10,1,2,6,17,-11,1,1.25505270161011,7,0
10,1,10,1,17,-16,0,1.24779012460931,-7,0
10,1,2,10,20,-10,1,0.728597794430243,10,0
10,1,2,5,11,-6,0,1.14994932361151,-1,0
10,1,2,15,0,15,0,0.86679312853812,10,0
10,1,10,20,3,17,0,1.23478691174751,7,0
10,1,10,10,9,1,1,1.94005010822366,-1,0
10,1,10,11,5,6,0,1.11413055630328,5,0
10,1,10,10,16,-6,1,0.912429002655699,6,0
10,1,2,17,3,14,0,0.926517588279239,7,0
10,1,2,10,14,-4,1,0.835911139460222,4,0
10,1,10,14,3,11,0,0.869362687149987,7,0
10,1,2,7,18,-11,1,1.03719701843147,8,0
10,1,10,18,6,12,1,1.69488122664552,-4,0
10,1,10,8,20,-12,1,0.94941451818886,10,0
10,1,2,19,8,11,1,1.56213584937359,-2,0
10,1,2,7,13,-6,1,1.16621965144077,3,0
10,1,10,1,16,-15,0,1.41057404525782,-6,0
10,1,2,18,1,17,0,1.30860325611866,9,0
10,1,10,17,6,11,0,1.29937557159792,4,0
10,1,2,5,19,-14,1,1.31278419556475,9,0
10,1,2,1,11,-10,0,1.30290404109837,-1,0
10,1,10,9,20,-11,1,0.901670946208469,10,0
10,1,10,20,5,15,1,3.66014306686338,-5,0
10,1,10,8,16,-8,1,0.901022508380265,6,0
10,1,2,14,6,8,0,1.49970693835712,4,0
10,1,10,5,16,-11,1,1.5305775641973,6,0
10,1,2,14,3,11,0,1.3918811478361,7,0
10,1,10,9,13,-4,1,0.723349076917657,3,0
10,1,2,10,2,8,0,0.881775378056773,8,0
10,1,10,2,11,-9,0,1.04002903125001,-1,0
10,1,2,7,10,-3,0,1.21723986884535,0,0
10,1,2,16,6,10,0,0.771337874961318,4,0
10,1,2,8,19,-11,1,0.879591436514602,9,0
10,1,10,4,13,-9,0,1.40684177054209,-3,0
10,1,2,10,14,-4,1,0.68954893432965,4,0
10,1,2,6,18,-12,1,0.848952107608056,8,0
10,1,10,9,17,-8,1,0.810074429227825,7,0
10,1,10,19,8,11,0,1.4205238453942,2,0
10,1,10,4,17,-13,0,2.30246783927942,-7,0
10,1,2,15,5,10,1,0.980222096368379,-5,0
10,1,10,1,16,-15,0,1.24770545014326,-6,0
10,1,2,8,20,-12,1,1.00813974586708,10,0
10,1,10,9,12,-3,1,1.22690118928949,2,0
10,1,10,10,11,-1,1,0.69320276603321,1,0
10,1,2,8,11,-3,1,0.756438100579544,1,0
10,1,10,6,14,-8,1,1.0493234289861,4,0
10,1,2,18,3,15,0,1.32183373379667,7,0
10,1,2,15,1,14,0,0.87999758073056,9,0
10,1,10,4,20,-16,1,1.08781475718206,10,0
10,1,2,10,16,-6,1,1.38146032304576,6,0
10,1,10,5,17,-12,1,1.22501965657648,7,0
10,1,2,10,12,-2,1,0.763154142357962,2,0
10,1,2,9,15,-6,1,0.92709454766009,5,0
10,1,10,4,12,-8,0,1.26910389851037,-2,0
10,1,10,6,16,-10,0,2.74134148554003,-6,0
10,1,10,20,0,20,0,1.42666805957924,10,0
10,1,10,11,3,8,0,1.54078102118729,7,0
10,1,2,10,17,-7,1,0.810215919897018,7,0
10,1,2,19,4,15,0,1.26890339229067,6,0
10,1,2,17,0,17,0,0.955758138923557,10,0
10,1,10,19,1,18,0,0.79246910389702,9,0
10,1,10,12,1,11,0,0.948107378957502,9,0
10,1,10,19,3,16,0,1.02457355774095,7,0
10,1,2,7,13,-6,1,0.922816470832913,3,0
10,1,2,0,10,-10,0,1.63273383075284,0,0
10,1,10,14,3,11,0,0.994201448262174,7,0
10,1,10,1,20,-19,0,1.94160100729641,-10,0
10,1,2,4,20,-16,NaN,NaN,0,0
10,1,2,14,7,7,1,1.16784789385929,-3,0
10,1,10,16,10,6,1,0.897874524165672,0,0
10,1,10,12,0,12,0,0.824683891140012,10,0
10,1,2,1,19,-18,0,0.63452335787224,-9,0
10,1,2,14,1,13,0,0.748114710080699,9,0
10,1,2,19,3,16,0,0.696718772622262,7,0
10,1,10,0,13,-13,0,0.73562650860913,-3,0
10,1,10,12,7,5,0,0.820864009503566,3,0
10,1,10,5,15,-10,1,0.943081894143688,5,0
10,1,2,5,20,-15,1,1.13253350781451,10,0
10,1,2,8,14,-6,1,1.00192405323105,4,0
10,1,2,0,15,-15,0,1.2921060300323,-5,0
10,1,10,6,18,-12,1,1.09145942498071,8,0
10,1,2,6,16,-10,1,1.29865492220779,6,0
10,1,10,4,12,-8,0,1.24158689488468,-2,0
10,1,10,15,4,11,0,1.65080688172748,6,0
10,1,2,7,15,-8,1,1.41988383835633,5,0
10,1,10,10,20,-10,1,0.853721369672712,10,0
10,1,2,7,14,-7,1,0.758450860397716,4,0
10,1,10,11,2,9,0,1.04327671873762,8,0
10,1,2,2,14,-12,0,1.27661976580566,-4,0
10,1,10,11,8,3,0,1.25137724309388,2,0
10,1,2,5,19,-14,1,1.30745740159546,9,0
10,1,10,11,1,10,0,0.778195407416206,9,0
10,1,2,8,16,-8,1,1.10959369083503,6,0
10,1,10,3,14,-11,0,1.02835934965697,-4,0
10,1,10,1,15,-14,0,1.15794134735188,-5,0
10,1,2,2,17,-15,NaN,NaN,0,0
10,1,10,7,13,-6,1,1.03929115371648,3,0
10,1,2,11,0,11,0,0.848697351080773,10,0
10,1,2,15,8,7,0,1.10561582349692,2,0
10,1,2,7,14,-7,1,1.0876523728075,4,0
10,1,10,8,11,-3,1,1.35895524166335,1,0
10,1,10,11,6,5,0,1.34804139885091,4,0
10,1,10,6,17,-11,1,1.1526680705756,7,0
10,1,2,9,12,-3,1,1.33268416239298,2,0
10,1,2,2,19,-17,0,1.57737762064789,-9,0
10,1,2,5,18,-13,NaN,NaN,0,0
10,1,10,13,8,5,1,1.87346225113288,-2,0
10,1,2,8,17,-9,1,1.32961535430513,7,0
10,1,10,15,9,6,1,0.830375408480904,-1,0
10,1,10,9,16,-7,1,0.901580406840367,6,0
10,1,2,4,15,-11,1,0.747586869223596,5,0
10,1,2,9,14,-5,1,0.728301250506775,4,0
10,1,10,7,18,-11,1,0.629039677871333,8,0
10,1,2,11,1,10,0,0.701950628554187,9,0
10,1,10,7,12,-5,1,0.827979230925848,2,0
10,1,2,19,1,18,0,0.646277713934978,9,0
10,1,2,3,13,-10,0,1.21403323564664,-3,0
10,1,10,17,8,9,1,0.96808505568697,-2,0
10,1,10,9,12,-3,1,0.731513382048433,2,0
10,1,2,0,19,-19,0,0.735868069110438,-9,0
10,1,2,8,10,-2,0,0.877009048439504,0,0
10,1,2,9,14,-5,1,1.03710537939696,4,0
10,1,10,1,17,-16,0,0.645782863131899,-7,0
10,1,2,14,3,11,0,1.04664793564734,7,0
10,1,2,13,0,13,0,0.71075494071556,10,0
10,1,10,10,10,0,1,0.709018930792809,0,0
10,1,10,16,4,12,1,1.11472694316035,-6,0
10,1,10,11,1,10,0,0.616970816630783,9,0
10,1,10,15,0,15,0,0.570476834567671,10,0
10,1,10,10,5,5,0,1.07704826994814,5,0
10,1,2,4,10,-6,0,0.877130011969712,0,0
10,1,2,7,18,-11,1,1.46117932110064,8,0
10,1,10,6,20,-14,1,0.909229334021802,10,0
10,1,2,5,20,-15,1,0.891777229167928,10,0
10,1,10,17,7,10,1,1.4663635247307,-3,0
10,1,10,10,18,-8,1,0.834311488419189,8,0
10,1,2,2,17,-15,0,0.827103528285079,-7,0
10,1,10,8,17,-9,1,0.796629882755951,7,0
10,1,2,1,17,-16,0,0.798367358907853,-7,0
10,1,10,8,18,-10,1,0.591959590849001,8,0
10,1,10,0,13,-13,0,0.570536216666369,-3,0
10,1,10,7,12,-5,1,1.21423080941167,2,0
10,1,2,6,18,-12,1,1.56758543965771,8,0
10,1,10,6,12,-6,1,0.770951158228854,2,0
10,1,10,20,5,15,0,0.711126262100152,5,0
10,1,2,7,15,-8,1,0.772948156129132,5,0
10,1,2,9,10,-1,0,0.704589466273319,0,0
10,1,2,5,17,-12,0,1.04642470295221,-7,0
10,1,2,13,5,8,0,0.814702933730587,5,0
10,1,2,7,16,-9,1,1.32541498738283,6,0
10,1,2,8,20,-12,1,0.666687193814141,10,0
10,1,10,20,10,10,1,0.666066614248848,0,0
10,1,2,2,13,-11,0,0.665549036966695,-3,0
10,1,10,7,10,-3,0,0.94439929694272,0,0
10,1,10,18,3,15,0,0.893169409424445,7,0
10,1,10,7,11,-4,0,1.65168918237759,-1,0
10,1,10,5,19,-14,0,1.41978046952136,-9,0
10,1,2,6,16,-10,1,1.35724635688894,6,0
10,1,2,8,16,-8,1,0.8257245440509,6,0
10,1,10,1,19,-18,0,0.626230391535501,-9,0
10,1,2,8,19,-11,1,0.67550250266504,9,0
10,1,10,4,20,-16,1,1.77086611720006,10,0
10,1,2,2,11,-9,0,1.15028582215746,-1,0
10,1,2,6,20,-14,1,1.01037610493586,10,0
10,1,2,15,0,15,0,0.947782610208378,10,0
10,1,10,10,10,0,1,0.855887716519646,0,0
10,1,10,8,20,-12,0,0.663933257455938,-10,0
10,1,10,0,16,-16,0,1.86348092716798,-6,0
10,1,2,7,18,-11,1,1.14275345982969,8,0
10,1,2,10,18,-8,1,0.698217254164774,8,0
10,1,10,18,1,17,0,1.94428566454008,9,0
10,1,10,13,1,12,0,0.773052258078678,9,0
10,1,10,10,14,-4,1,0.736441362929327,4,0
10,1,10,3,10,-7,0,0.901488034691283,0,0
10,1,2,14,6,8,1,1.00353433439886,-4,0
10,1,10,8,15,-7,1,0.903395959448972,5,0
10,1,2,0,11,-11,0,1.03740265643137,-1,0
10,1,2,2,13,-11,0,0.734346494533384,-3,0
10,1,2,11,6,5,0,1.01097835669134,4,0
10,1,2,15,8,7,1,0.859810966994701,-2,0
10,1,2,15,5,10,1,1.18783766694105,-5,0
10,1,2,0,15,-15,0,0.982748767914018,-5,0
10,1,10,11,5,6,0,1.30529948553885,5,0
10,1,2,12,0,12,0,0.743530925425148,10,0
10,1,10,11,6,5,0,0.652081397456641,4,0
10,1,10,20,0,20,0,0.660168725797121,10,0
10,1,10,6,20,-14,1,1.25234055265901,10,0
10,1,10,7,14,-7,1,1.12452535560806,4,0
10,1,2,0,14,-14,0,0.817684501456824,-4,0
11,1,2,11,0,11,0,1.1107933895546,10,0
11,1,2,5,11,-6,0,0.820601479790639,-1,0
11,1,10,6,20,-14,1,1.27116698221653,10,0
11,1,2,20,0,20,0,1.39911586980452,10,0
11,1,2,16,9,7,1,0.641769286739873,-1,0
11,1,10,10,9,1,0,1.07581379749172,1,0
11,1,10,20,3,17,1,0.884609646629542,-7,0
11,1,10,20,8,12,1,0.723883428232512,-2,0
11,1,10,0,14,-14,0,1.1860962096398,-4,0
11,1,2,10,12,-2,1,0.925476841977797,2,0
11,1,2,11,8,3,0,1.11550361881382,2,0
11,1,10,10,20,-10,1,0.873706107347971,10,0
11,1,10,11,5,6,0,1.08172559340892,5,0
11,1,10,10,16,-6,1,0.929278381881886,6,0
11,1,2,15,0,15,0,0.966399753669975,10,0
11,1,2,10,20,-10,1,0.842661114584189,10,0
11,1,10,17,3,14,1,0.812183182104491,-7,0
11,1,10,1,20,-19,1,1.58230859882315,10,0
11,1,2,1,17,-16,0,0.889570965940948,-7,0
11,1,2,6,17,-11,1,1.11292857129592,7,0
11,1,2,10,16,-6,1,0.669667773050605,6,0
11,1,2,8,12,-4,0,0.845781595649896,-2,0
11,1,10,10,12,-2,1,0.678533634156338,2,0
11,1,10,12,7,5,1,1.7665097201243,-3,0
11,1,10,10,14,-4,1,0.762680688610999,4,0
11,1,2,1,18,-17,0,0.74266129785974,-8,0
11,1,2,8,13,-5,0,1.20418202377914,-3,0
11,1,10,20,9,11,1,0.926881480001612,-1,0
11,1,10,3,14,-11,0,0.76498851767974,-4,0
11,1,2,11,10,1,1,0.505047642960562,0,0
11,1,2,7,15,-8,1,1.22313730593305,5,0
11,1,2,15,9,6,1,0.513080691554933,-1,0
11,1,10,8,15,-7,1,1.16722890063829,5,0
11,1,2,1,14,-13,0,0.635346513416152,-4,0
11,1,10,8,20,-12,1,1.3967842146958,10,0
11,1,10,13,7,6,1,0.695546542381635,-3,0
11,1,2,16,3,13,0,1.35826810184517,7,0
11,1,2,1,20,-19,0,1.17899311060319,-10,0
11,1,10,17,7,10,1,0.814554058597423,-3,0
11,1,10,3,18,-15,0,4.63226891927479,-8,0
11,1,2,10,17,-7,1,1.00348593622039,7,0
11,1,2,0,16,-16,0,0.838193544608657,-6,0
11,1,10,10,16,-6,1,0.671437499651802,6,0
11,1,10,16,3,13,1,1.06365554111835,-7,0
11,1,2,11,5,6,0,1.18373156458256,5,0
11,1,10,5,12,-7,0,1.02720863015566,-2,0
11,1,2,5,15,-10,0,0.74992898000346,-5,0
11,1,2,4,11,-7,0,0.746680937867495,-1,0
11,1,10,8,20,-12,1,1.67928580461012,10,0
11,1,10,7,17,-10,0,1.34269098879304,-7,0
11,1,2,4,18,-14,NaN,NaN,0,0
11,1,2,9,19,-10,1,0.832395380668459,9,0
11,1,10,8,20,-12,1,1.03365119744558,10,0
11,1,10,3,10,-7,0,0.891222295322223,0,0
11,1,10,7,15,-8,1,1.87455908038828,5,0
11,1,2,19,5,14,1,0.914717358755297,-5,0
11,1,10,1,11,-10,0,0.944810042128665,-1,0
11,1,2,1,15,-14,0,0.877661233709659,-5,0
11,1,10,6,19,-13,1,0.917022255380289,9,0
11,1,2,9,16,-7,1,0.875024238441256,6,0
11,1,2,10,12,-2,1,1.21836806133797,2,0
11,1,10,6,13,-7,0,1.22850440139882,-3,0
11,1,10,9,15,-6,1,1.98992230869771,5,0
11,1,10,4,16,-12,0,0.94536977133248,-6,0
11,1,2,10,5,5,0,0.598092082233052,5,0
11,1,2,3,17,-14,0,0.59280746159493,-7,0
11,1,2,0,14,-14,0,0.708275891141966,-4,0
11,1,10,19,6,13,1,0.707020440939232,-4,0
11,1,10,7,15,-8,1,1.21778780508612,5,0
11,1,2,1,10,-9,0,0.651872270304011,0,0
11,1,2,1,20,-19,NaN,NaN,0,0
11,1,2,11,6,5,0,0.641380005530664,4,0
11,1,2,10,12,-2,1,0.77879663722706,2,0
11,1,10,18,8,10,1,1.32621911546448,-2,0
11,1,10,6,20,-14,0,0.620258384486078,-10,0
11,1,2,14,4,10,0,1.07029714765667,6,0
11,1,10,15,0,15,0,1.19024121139955,10,0
11,1,2,0,15,-15,0,0.601721341372468,-5,0
11,1,10,20,9,11,1,0.724640363914659,-1,0
11,1,10,3,10,-7,0,0.94666700878588,0,0
11,1,2,17,7,10,1,0.62614158912038,-3,0
11,1,2,20,2,18,1,0.5481805135787,-8,0
11,1,2,10,16,-6,1,0.800930316094309,6,0
11,1,10,13,10,3,1,0.554980838351185,0,0
11,1,10,3,19,-16,1,1.27974583089235,9,0
11,1,10,14,4,10,0,0.975147950681276,6,0
11,1,10,0,18,-18,0,0.995083766945754,-8,0
11,1,2,6,17,-11,0,1.19063305847521,-7,0
11,1,10,6,11,-5,0,0.706027443957282,-1,0
11,1,2,3,11,-8,0,0.552793972368818,-1,0
11,1,2,9,20,-11,1,1.16487745156337,10,0
11,1,10,20,6,14,1,0.848979786329437,-4,0
11,1,10,4,12,-8,0,0.865647399929003,-2,0
11,1,10,16,6,10,1,0.593770401072106,-4,0
11,1,10,8,15,-7,1,0.788982462196145,5,0
11,1,2,2,17,-15,0,0.712550653290236,-7,0
11,1,2,5,16,-11,1,0.718656356708379,6,0
11,1,2,7,18,-11,1,0.796743893661187,8,0
11,1,10,16,9,7,1,0.839536601415602,-1,0
11,1,2,8,20,-12,1,1.51287798673729,10,0
11,1,10,10,15,-5,1,0.59773762372788,5,0
11,1,2,19,1,18,1,0.616398562371614,-9,0
11,1,10,9,20,-11,1,0.87464228834142,10,0
11,1,2,20,6,14,1,0.69838550935674,-4,0
11,1,10,15,9,6,1,0.5452700684109,-1,0
11,1,10,6,17,-11,1,0.822705137805315,7,0
11,1,2,2,10,-8,0,0.808787051806576,0,0
11,1,10,10,9,1,0,1.03562069640611,1,0
11,1,2,6,20,-14,1,0.73292083699198,10,0
11,1,2,5,16,-11,1,0.874361873909947,6,0
11,1,2,7,20,-13,1,0.720933761709603,10,0
11,1,2,6,19,-13,1,0.591142569654039,9,0
11,1,2,20,0,20,0,1.07437323710474,10,0
11,1,2,14,0,14,0,0.969920146031654,10,0
11,1,10,20,2,18,1,0.725380438074353,-8,0
11,1,2,10,9,1,0,0.931448386341799,1,0
11,1,10,11,5,6,0,0.696071815429605,5,0
11,1,10,10,20,-10,1,0.686916376027511,10,0
11,1,10,7,19,-12,1,0.86242318386212,9,0
11,1,10,3,19,-16,1,1.0377720065735,9,0
11,1,10,16,9,7,1,0.70750979159493,-1,0
11,1,2,9,15,-6,1,0.761583956627874,5,0
11,1,10,19,8,11,1,0.620948973737541,-2,0
11,1,10,15,0,15,0,0.887089389885659,10,0
11,1,2,6,20,-14,1,0.742544000328053,10,0
11,1,2,14,10,4,1,0.619199041087995,0,0
11,1,10,20,9,11,1,0.644647108521895,-1,0
11,1,2,19,4,15,1,0.589269108037115,-6,0
11,1,10,16,3,13,0,1.03998526450596,7,0
11,1,2,10,20,-10,1,0.584866418255842,10,0
11,1,10,11,0,11,0,1.11490136926295,10,0
11,1,2,8,11,-3,0,0.82501443309593,-1,0
11,1,2,3,12,-9,0,0.674349777589669,-2,0
11,1,2,12,10,2,1,0.513850456627551,0,0
11,1,10,11,6,5,0,2.55213270751119,4,0
11,1,10,18,4,14,1,0.796536790192476,-6,0
11,1,10,5,19,-14,1,1.05477245194197,9,0
11,1,2,14,0,14,0,0.702704624636681,10,0
11,1,10,16,8,8,1,0.524903550263843,-2,0
11,1,2,11,8,3,0,0.778320482524578,2,0
11,1,10,12,4,8,0,1.03630322146637,6,0
11,1,10,17,7,10,1,0.677142925211228,-3,0
11,1,10,11,5,6,0,0.83654661384935,5,0
11,1,2,6,18,-12,1,1.23732554282469,8,0
11,1,2,7,14,-7,1,1.27804868214298,4,0
11,1,2,5,11,-6,0,1.19746600663348,-1,0
11,1,10,12,6,6,0,1.81552396260668,4,0
11,1,2,5,16,-11,1,1.03353280024021,6,0
11,1,10,9,11,-2,0,1.0422359110089,-1,0
11,1,2,6,13,-7,0,1.2911288238538,-3,0
11,1,10,0,17,-17,0,0.785167726309737,-7,0
11,1,2,10,3,7,0,0.651997632056009,7,0
11,1,10,14,0,14,0,0.668053832239821,10,0
11,1,10,17,10,7,1,0.547495056089247,0,0
11,1,10,14,8,6,1,0.631500253846752,-2,0
11,1,10,16,4,12,1,1.27225821586035,-6,0
11,1,2,2,19,-17,1,1.24747837784525,9,0
11,1,2,8,19,-11,1,0.839581321095466,9,0
11,1,2,16,2,14,0,0.945179162823479,8,0
11,1,2,12,6,6,0,0.709245795151219,4,0
11,1,10,10,17,-7,1,0.977370372478617,7,0
11,1,2,16,2,14,0,0.868621992180124,8,0
11,1,10,9,10,-1,0,0.77217299187032,0,0
11,1,2,14,3,11,0,1.18339873282821,7,0
11,1,2,9,20,-11,0,0.562241555948276,-10,0
11,1,10,17,4,13,1,1.19777098021586,-6,0
11,1,2,10,8,2,0,0.800514276401373,2,0
11,1,10,5,20,-15,1,0.914537380333059,10,0
11,1,10,8,15,-7,1,1.70465359654918,5,0
11,1,2,16,10,6,1,0.518755693061394,0,0
11,1,10,20,10,10,1,0.595445923085208,0,0
11,1,2,16,2,14,0,0.653516268619569,8,0
11,1,10,13,3,10,0,0.677670764140203,7,0
11,1,10,7,20,-13,1,0.733084320439957,10,0
11,1,2,17,4,13,1,0.697637737554032,-6,0
11,1,2,17,1,16,0,1.40783877452486,9,0
11,1,2,10,9,1,0,0.721941787429387,1,0
11,1,10,12,4,8,0,1.3119707635924,6,0
11,1,2,19,8,11,1,0.629937630699715,-2,0
11,1,10,15,4,11,0,0.798831423278898,6,0
11,1,10,1,13,-12,0,0.776272907372913,-3,0
11,1,10,14,4,10,0,1.0201964367152,6,0
11,1,2,2,15,-13,0,0.725731231024838,-5,0
11,1,10,1,20,-19,1,1.19506543919852,10,0
11,1,10,12,6,6,0,1.14994657464558,4,0
11,1,2,18,0,18,0,1.35396034976293,10,0
11,1,2,19,5,14,1,0.749460522958543,-5,0
11,1,2,19,1,18,1,0.705437657277798,-9,0
11,1,10,13,2,11,0,1.27158742057509,8,0
11,1,2,9,13,-4,1,1.71829163466464,3,0
11,1,10,15,0,15,0,0.914412018595613,10,0
11,1,2,1,13,-12,0,0.87111383175943,-3,0
11,1,10,17,7,10,1,0.798508855048567,-3,0
11,1,2,8,16,-8,1,1.20000733109191,6,0
11,1,2,9,15,-6,0,0.538025112677133,-5,0
11,1,10,1,17,-16,0,0.81538943698979,-7,0
11,1,2,11,10,1,1,0.832754970935639,0,0
11,1,10,17,9,8,1,0.617642282828456,-1,0
11,1,10,12,6,6,0,0.963040645438014,4,0
11,1,2,10,12,-2,1,0.974426937376847,2,0
12,1,2,6,20,-14,0,1.61719508597162,-10,0
12,1,2,5,11,-6,0,1.6752097151475,-1,0
12,1,2,10,20,-10,1,1.35520956851542,10,0
12,1,10,11,5,6,0,1.47183337883325,5,0
12,1,2,1,20,-19,0,1.23160178953549,-10,0
12,1,10,16,9,7,1,1.18566807365278,-1,0
12,1,10,10,9,1,0,0.573686130112037,1,0
12,1,10,17,3,14,0,1.4421695646015,7,0
12,1,2,20,0,20,1,1.43553308979608,-10,0
12,1,10,11,8,3,0,1.26073959760834,2,0
12,1,2,10,20,-10,1,1.3974157886114,10,0
12,1,10,20,8,12,1,1.63196247944143,-2,0
12,1,2,15,0,15,0,1.57731282332679,10,0
12,1,10,20,3,17,0,0.845304341288283,7,0
12,1,2,10,12,-2,1,1.30990449414821,2,0
12,1,2,0,14,-14,0,0.748565029585734,-4,0
12,1,10,6,17,-11,0,0.841072466049809,-7,0
12,1,10,1,17,-16,0,1.83430843020324,-7,0
12,1,10,10,16,-6,1,1.2036864417023,6,0
12,1,2,11,0,11,0,1.96615452849073,10,0
12,1,2,2,14,-12,0,0.746724924421869,-4,0
12,1,10,9,18,-9,0,1.4632391348714,-8,0
12,1,2,7,10,-3,1,1.0713260670309,0,0
12,1,2,18,1,17,0,0.919452147150878,9,0
12,1,10,8,13,-5,0,1.07734856242314,-3,0
12,1,10,3,14,-11,0,1.34934322541812,-4,0
12,1,2,5,18,-13,0,1.17782636667835,-8,0
12,1,10,9,17,-8,0,1.17392109177308,-7,0
12,1,10,4,18,-14,0,0.961799124313984,-8,0
12,1,2,6,16,-10,0,1.33380570024019,-6,0
12,1,10,4,17,-13,0,1.50625910662347,-7,0
12,1,2,10,16,-6,1,1.24079828307731,6,0
12,1,10,4,18,-14,0,1.07415770291118,-8,0
12,1,2,8,18,-10,0,1.09824072022457,-8,0
12,1,10,15,0,15,0,2.32885867659934,10,0
12,1,2,11,0,11,0,1.57394051912706,10,0
12,1,10,1,14,-13,0,1.65798860380892,-4,0
12,1,2,20,3,17,0,1.08261485537514,7,0
12,1,10,19,6,13,0,1.09795444086194,4,0
12,1,2,15,4,11,1,1.04852599150036,-6,0
12,1,2,10,12,-2,1,1.14558933762601,2,0
12,1,2,19,6,13,0,0.966339272155892,4,0
12,1,10,9,12,-3,0,1.37818888935726,-2,0
12,1,10,1,11,-10,0,2.08555792388506,-1,0
12,1,10,8,15,-7,0,1.61280669178814,-5,0
12,1,2,5,14,-9,0,1.29462099150987,-4,0
12,1,2,11,5,6,0,1.4612421442871,5,0
12,1,2,17,10,7,1,0.925190562673379,0,0
12,1,10,1,10,-9,0,1.93141209741589,0,0
12,1,10,17,3,14,0,1.21648433618248,7,0
12,1,10,10,20,-10,1,1.26583507604664,10,0
12,1,2,9,16,-7,0,0.585856482794043,-6,0
12,1,10,10,12,-2,1,1.17306005448336,2,0
12,1,10,14,9,5,1,1.72106718766736,-1,0
12,1,10,10,9,1,0,1.43897797190584,1,0
12,1,2,5,12,-7,0,0.952220680657774,-2,0
12,1,10,6,19,-13,0,1.01291849103291,-9,0
12,1,2,11,1,10,0,0.750851598451845,9,0
12,1,2,9,15,-6,0,0.899483341025189,-5,0
12,1,2,15,8,7,0,0.770041842246428,2,0
12,1,10,10,11,-1,1,1.35725860990351,1,0
12,1,10,20,6,14,1,1.48987813881831,-4,0
12,1,10,15,8,7,0,0.913266168267,2,0
12,1,2,11,5,6,0,1.91115921130404,5,0
12,1,2,19,9,10,NaN,NaN,0,0
12,1,2,2,14,-12,0,0.745627092779614,-4,0
12,1,10,16,7,9,0,0.98238081013551,3,0
12,1,10,14,10,4,1,0.985521818278357,0,0
12,1,2,11,8,3,0,0.756787953549065,2,0
12,1,2,20,8,12,1,1.36946011980763,-2,0
12,1,10,18,1,17,0,0.812679497292265,9,0
12,1,2,11,5,6,0,0.854691443324555,5,0
12,1,10,15,10,5,1,0.951238680339884,0,0
12,1,10,13,1,12,0,0.787882064643782,9,0
12,1,2,0,15,-15,0,0.919299293833319,-5,0
12,1,2,12,5,7,0,0.901177190709859,5,0
12,1,2,10,9,1,0,0.699864924536087,1,0
12,1,2,10,6,4,0,1.1943378279102,4,0
12,1,10,6,13,-7,0,0.805099877063185,-3,0
12,1,10,7,19,-12,0,0.799684396304656,-9,0
12,1,10,16,7,9,0,1.33139230340021,3,0
12,1,10,10,9,1,1,1.18479310732801,-1,0
12,1,2,10,14,-4,1,0.892014053708408,4,0
12,1,10,18,3,15,0,0.811398388294037,7,0
12,1,10,10,20,-10,1,1.1893255574978,10,0
12,1,2,9,19,-10,0,0.672596546006389,-9,0
12,1,2,7,11,-4,0,0.808538527693599,-1,0
12,1,2,1,19,-18,0,1.13119546353118,-9,0
12,1,2,6,11,-5,0,0.552387096511666,-1,0
12,1,10,19,6,13,0,0.893136811093427,4,0
12,1,2,3,20,-17,0,0.659752832143568,-10,0
12,1,10,15,1,14,0,0.892338454723358,9,0
12,1,10,3,10,-7,0,1.41961618041387,0,0
12,1,10,17,3,14,0,0.805488425132353,7,0
12,1,2,10,7,3,0,1.26420867233537,3,0
12,1,10,15,8,7,0,0.52017132769106,2,0
12,1,2,2,19,-17,0,0.613921751501039,-9,0
12,1,2,18,3,15,0,0.568030555965379,7,0
12,1,10,4,17,-13,0,1.22801541729132,-7,0
12,1,2,2,20,-18,0,0.909914391115308,-10,0
12,1,10,20,3,17,0,0.867881918034982,7,0
12,1,10,18,9,9,1,1.60367581160972,-1,0
12,1,10,7,10,-3,0,1.49445860774722,0,0
12,1,2,3,17,-14,0,0.901757080457173,-7,0
12,1,10,18,1,17,0,0.860229719895869,9,0
12,1,2,11,9,2,0,1.50889316940447,1,0
12,1,2,6,19,-13,0,1.43542935483856,-9,0
12,1,10,7,13,-6,0,0.892196231463458,-3,0
12,1,2,15,2,13,0,0.723526770423632,8,0
12,1,2,20,9,11,1,1.49740350904176,-1,0
12,1,10,19,5,14,0,0.647344218799844,5,0
12,1,10,20,9,11,1,1.56003636220703,-1,0
12,1,2,12,0,12,0,0.700610130501445,10,0
12,1,2,11,9,2,0,0.69854459410999,1,0
12,1,10,2,15,-13,0,0.712423458811827,-5,0
12,1,2,7,20,-13,0,1.14250807795906,-10,0
12,1,2,20,10,10,1,1.01912426389754,0,0
12,1,2,20,3,17,0,0.772227975074202,7,0
12,1,10,14,2,12,0,1.01630215847399,8,0
12,1,10,15,1,14,0,0.777494268026203,9,0
12,1,10,7,20,-13,0,0.871463891642634,-10,0
12,1,10,15,0,15,0,1.8553002908593,10,0
12,1,2,13,0,13,0,1.2000476521207,10,0
12,1,2,11,0,11,0,1.09070948517183,10,0
12,1,10,14,7,7,0,1.13729456893634,3,0
12,1,2,7,10,-3,0,1.1019084675936,0,0
12,1,2,18,1,17,0,0.692427894100547,9,0
12,1,10,10,13,-3,1,0.971146638446953,3,0
12,1,10,15,1,14,0,0.750482477771584,9,0
12,1,2,16,0,16,0,1.17026800650638,10,0
12,1,2,4,18,-14,0,0.485730571206659,-8,0
12,1,2,16,6,10,0,0.748318704718258,4,0
12,1,2,10,7,3,1,1.4641892448999,-3,0
12,1,10,19,3,16,0,0.824115640716627,7,0
12,1,10,20,1,19,0,0.945393963949755,9,0
12,1,2,4,13,-9,0,0.95013461727649,-3,0
12,1,2,8,18,-10,1,1.90605493559269,8,0
12,1,10,6,17,-11,0,0.904015791136771,-7,0
12,1,10,20,2,18,0,1.01394924317719,8,0
12,1,10,15,5,10,0,1.20787652966101,5,0
12,1,2,10,20,-10,1,1.1930493877735,10,0
12,1,10,18,3,15,0,0.843705062638037,7,0
12,1,2,18,7,11,0,1.029078426247,3,0
12,1,10,3,20,-17,0,0.797687039128505,-10,0
12,1,10,11,5,6,0,1.05633800750365,5,0
12,1,2,10,1,9,0,1.28825760004111,9,0
12,1,2,0,11,-11,0,1.22290234430693,-1,0
12,1,10,2,12,-10,0,1.31206020293757,-2,0
12,1,10,18,1,17,0,1.06192833487876,9,0
12,1,2,10,4,6,0,1.08607733203098,6,0
12,1,2,16,7,9,0,0.739996810967568,3,0
12,1,10,19,2,17,0,0.769306166737806,8,0
12,1,10,17,4,13,0,1.37255164299859,6,0
12,1,10,16,2,14,0,0.80027198366588,8,0
12,1,10,15,0,15,0,1.14669779938413,10,0
12,1,2,5,12,-7,0,0.878451159340329,-2,0
12,1,2,20,8,12,1,1.46885622071568,-2,0
12,1,2,0,16,-16,0,1.09287472441792,-6,0
12,1,10,11,8,3,0,1.29956324992236,2,0
12,1,2,5,17,-12,0,1.19358052569441,-7,0
12,1,2,8,12,-4,0,1.42790984956082,-2,0
12,1,2,10,7,3,0,1.29322295146994,3,0
12,1,10,7,14,-7,0,0.851899028813932,-4,0
12,1,2,18,1,17,0,0.747707657923456,9,0
12,1,2,6,12,-6,0,1.55250072851777,-2,0
12,1,10,12,0,12,0,1.14026219665539,10,0
12,1,10,11,9,2,0,0.769070105394349,1,0
12,1,2,5,20,-15,0,1.28418077749666,-10,0
12,1,10,4,11,-7,0,1.85081439313944,-1,0
12,1,10,10,10,0,0,1.44270766706904,0,0
12,1,2,10,14,-4,1,1.08286227984354,4,0
12,1,2,18,7,11,0,0.913318219012581,3,0
12,1,2,7,12,-5,NaN,NaN,0,0
12,1,2,15,4,11,0,0.914792502473574,6,0
12,1,10,13,6,7,1,0.871790125383995,-4,0
12,1,10,17,6,11,0,1.7750563119771,4,0
12,1,10,0,14,-14,0,0.962394775880966,-4,0
12,1,2,15,1,14,0,0.526426585507579,9,0
12,1,10,10,13,-3,1,1.00364941963926,3,0
12,1,10,19,5,14,0,0.981657230935525,5,0
12,1,10,10,12,-2,1,1.03094785573194,2,0
12,1,2,1,18,-17,0,0.879416664713062,-8,0
12,1,2,16,2,14,1,1.37475207151147,-8,0
12,1,10,16,7,9,0,1.30619385984028,3,0
12,1,2,11,8,3,0,0.952028972504195,2,0
12,1,10,6,11,-5,0,0.836038202338386,-1,0
12,1,2,6,16,-10,1,1.30868973152246,6,0
12,1,10,14,7,7,1,1.66655865515349,-3,0
12,1,10,13,9,4,1,1.56183321389835,-1,0
12,1,2,3,15,-12,1,1.67715758737177,5,0
12,1,10,0,18,-18,0,0.635761820012704,-8,0
12,1,2,3,10,-7,0,1.53241205890663,0,0
12,1,2,13,1,12,0,0.841608002607245,9,0
12,1,2,17,3,14,0,0.970766887650825,7,0
12,1,10,1,12,-11,0,1.2622490702779,-2,0
12,1,10,13,10,3,1,0.861572043562774,0,0
12,1,2,4,11,-7,0,1.05276116571622,-1,0
12,1,10,0,17,-17,0,1.27672065410297,-7,0
12,1,2,7,12,-5,0,0.772014640213456,-2,0
12,1,10,18,1,17,0,1.14323202369269,9,0
13,1,2,17,3,14,0,1.4463141997835,7,0
13,1,10,10,20,-10,1,3.22232868602941,10,0
13,1,10,10,20,-10,0,2.38411754679555,-10,0
13,1,2,6,20,-14,NaN,NaN,0,0
13,1,2,1,17,-16,0,1.16816288229393,-7,0
13,1,10,5,11,-6,1,1.83608658757657,1,0
13,1,2,11,0,11,1,1.43804362368746,-10,0
13,1,10,0,14,-14,0,1.20003812169989,-4,0
13,1,10,11,8,3,1,1.0826397810938,-2,0
13,1,2,11,5,6,0,1.5144571048404,5,0
13,1,10,10,9,1,1,1.95253188568631,-1,0
13,1,2,20,3,17,1,1.65306943830956,-7,0
13,1,2,20,0,20,0,1.41375313633489,10,0
13,1,2,15,0,15,1,0.975680921372259,-10,0
13,1,10,10,16,-6,0,1.39560500787184,-6,0
13,1,10,6,17,-11,0,0.902241299363595,-7,0
13,1,2,16,9,7,1,0.476891102065565,-1,0
13,1,10,1,20,-19,0,0.700798906200362,-10,0
13,1,2,10,12,-2,1,0.875475833957807,2,0
13,1,10,20,8,12,1,0.795397537851386,-2,0
13,1,10,10,20,-10,0,1.22259407170895,-10,0
13,1,2,6,10,-4,1,1.39265130924196,0,0
13,1,10,18,1,17,1,0.988686652456636,-9,0
13,1,2,1,12,-11,0,0.895880107253561,-2,0
13,1,10,11,5,6,1,0.742295109608676,-5,0
13,1,2,4,19,-15,0,0.804325713269918,-9,0
13,1,10,10,12,-2,0,1.11128164055253,-2,0
13,1,10,2,17,-15,0,0.861529156685719,-7,0
13,1,2,2,20,-18,0,0.669484862203262,-10,0
13,1,2,14,0,14,1,0.605494656547307,-10,0
13,1,10,9,17,-8,0,0.735542803521184,-7,0
13,1,10,4,20,-16,0,0.813040553791325,-10,0
13,1,2,2,20,-18,0,0.694702733215763,-10,0
13,1,2,14,8,6,0,0.86963185067998,2,0
13,1,10,9,16,-7,0,0.85358408125785,-6,0
13,1,10,9,10,-1,0,1.10995581181805,0,0
13,1,10,11,2,9,1,1.00463435241682,-8,0
13,1,2,11,1,10,0,0.919271802221829,9,0
13,1,2,12,1,11,1,0.829172264263889,-9,0
13,1,2,6,12,-6,0,0.566275491595661,-2,0
13,1,2,6,13,-7,0,0.847540692165694,-3,0
13,1,10,20,5,15,0,1.23224252732234,5,0
13,1,10,11,1,10,1,1.03349211265686,-9,0
13,1,10,18,4,14,1,1.3547847315258,-6,0
13,1,2,7,18,-11,0,0.959350171639471,-8,0
13,1,2,9,17,-8,0,0.764003218351263,-7,0
13,1,2,11,4,7,0,0.944006187445211,6,0
13,1,10,5,13,-8,0,1.10056980944637,-3,0
13,1,10,13,0,13,0,1.24336013459924,10,0
13,1,2,9,18,-9,0,0.635805806594817,-8,0
13,1,2,18,4,14,1,0.565143570353484,-6,0
13,1,10,9,19,-10,1,1.83305297999868,9,0
13,1,2,9,18,-9,0,0.778345774814625,-8,0
13,1,2,9,16,-7,0,0.6374534704496,-6,0
13,1,10,7,15,-8,0,0.631054523194962,-5,0
13,1,10,16,10,6,0,0.952233143518697,0,0
13,1,10,7,16,-9,0,1.24461705102976,-6,0
13,1,2,11,4,7,0,0.72531555786918,6,0
13,1,10,20,6,14,1,0.499628863258295,-4,0
13,1,2,3,10,-7,0,0.665988295904754,0,0
13,1,2,0,20,-20,0,0.841335652403359,-10,0
13,1,2,6,10,-4,0,0.563074001917357,0,0
13,1,2,4,18,-14,0,0.57517690851364,-8,0
13,1,10,13,4,9,0,0.899212823553171,6,0
13,1,10,0,10,-10,0,0.681630289157056,0,0
13,1,10,6,20,-14,0,0.569130586982737,-10,0
13,1,2,13,6,7,1,0.653198832156704,-4,0
13,1,10,11,5,6,1,1.00556246918677,-5,0
13,1,10,20,0,20,0,0.896236398525616,10,0
13,1,2,19,8,11,0,0.710983264940296,2,0
13,1,10,2,10,-8,0,1.18798616622189,0,0
13,1,2,4,20,-16,0,0.575347723053255,-10,0
13,1,2,2,18,-16,0,0.531560552104565,-8,0
13,1,2,19,1,18,NaN,NaN,0,0
13,1,10,4,14,-10,0,0.853408501505783,-4,0
13,1,10,8,10,-2,0,0.62206146757535,0,0
13,1,2,18,4,14,0,1.20002345950752,6,0
13,1,2,6,10,-4,0,0.962485681453018,0,0
13,1,10,20,5,15,0,1.09430868679874,5,0
13,1,10,14,8,6,1,0.532840561488229,-2,0
13,1,2,9,14,-5,0,0.796203225315821,-4,0
13,1,2,13,4,9,0,0.686948266287345,6,0
13,1,10,7,18,-11,0,0.654106055302236,-8,0
13,1,10,7,20,-13,0,0.478592282921909,-10,0
13,1,10,3,11,-8,0,0.566195216093092,-1,0
13,1,2,14,8,6,1,0.521842817633569,-2,0
13,1,10,9,19,-10,0,0.592057123901213,-9,0
13,1,10,19,3,16,1,0.611111375845212,-7,0
13,1,2,9,12,-3,0,0.62988924546562,-2,0
13,1,2,18,4,14,1,0.407137188634351,-6,0
13,1,10,11,0,11,1,1.2730855300656,-10,0
13,1,2,14,9,5,1,0.745020811149061,-1,0
13,1,10,11,3,8,0,1.16571649551588,7,0
13,1,2,9,17,-8,0,1.1055828129779,-7,0
13,1,10,10,14,-4,0,0.960042960223291,-4,0
13,1,2,9,20,-11,1,0.700776179802688,10,0
13,1,10,4,19,-15,0,0.851603952193727,-9,0
13,1,2,15,10,5,1,0.564108053025848,0,0
13,1,2,18,9,9,1,0.815957596940279,-1,0
13,1,10,11,8,3,1,0.745970554652558,-2,0
13,1,2,1,15,-14,0,0.677950078900722,-5,0
13,1,10,14,2,12,1,0.405782768625158,-8,0
13,1,10,9,16,-7,0,1.00035079294958,-6,0
13,1,2,11,2,9,1,0.707322482089239,-8,0
13,1,10,0,12,-12,0,0.825566464633994,-2,0
13,1,10,11,10,1,1,1.38768998993828,0,0
13,1,2,9,20,-11,0,1.05504516871633,-10,0
13,1,10,11,0,11,0,0.911420198269752,10,0
13,1,2,15,7,8,1,1.2055815300364,-3,0
13,1,2,13,8,5,1,1.31234574915561,-2,0
13,1,2,9,20,-11,0,0.670314009174945,-10,0
13,1,2,10,9,1,0,1.27790572576941,1,0
13,1,10,8,13,-5,0,0.98937577549259,-3,0
13,1,2,11,3,8,0,0.856716658632649,7,0
13,1,10,15,1,14,0,1.17726920334826,9,0
13,1,10,9,19,-10,0,1.20520654446955,-9,0
13,1,10,7,19,-12,0,0.655161366589255,-9,0
13,1,10,12,9,3,1,0.382958500497352,-1,0
13,1,2,9,16,-7,0,0.610387430102492,-6,0
13,1,2,10,18,-8,0,0.693096123499345,-8,0
13,1,10,20,4,16,0,1.01047027148888,6,0
13,1,10,1,18,-17,0,0.612264923820931,-8,0
13,1,2,16,6,10,0,1.205508219075,4,0
13,1,2,9,20,-11,0,1.07178536016772,-10,0
13,1,2,9,17,-8,0,0.662905203429091,-7,0
13,1,10,18,6,12,0,1.96579090614205,4,0
13,1,2,9,16,-7,0,0.729484752236203,-6,0
13,1,2,15,4,11,1,0.510543399172548,-6,0
13,1,10,2,13,-11,0,0.612583459947473,-3,0
13,1,10,11,3,8,1,0.542523473253368,-7,0
13,1,2,9,16,-7,0,0.810965487032263,-6,0
13,1,10,14,5,9,1,0.476549106430866,-5,0
13,1,2,17,1,16,1,0.572423715362675,-9,0
13,1,2,18,0,18,1,0.480577177198029,-10,0
13,1,10,15,3,12,1,0.487862820529244,-7,0
13,1,10,11,4,7,1,0.462217546612465,-6,0
13,1,2,9,18,-9,0,0.637491225594204,-8,0
13,1,10,6,13,-7,0,0.550189233918445,-3,0
13,1,2,11,3,8,1,0.369996022880514,-7,0
13,1,10,0,13,-13,0,0.574000267584779,-3,0
13,1,2,9,20,-11,0,0.625621081299869,-10,0
13,1,10,1,17,-16,0,0.650672169876088,-7,0
13,1,10,5,20,-15,0,0.64260246581398,-10,0
13,1,2,7,15,-8,1,1.54718605038988,5,0
13,1,2,11,2,9,1,0.903045154053416,-8,0
13,1,2,16,3,13,1,0.693184463208127,-7,0
13,1,10,9,18,-9,0,1.04296242263399,-8,0
13,1,2,11,1,10,0,1.67561732411332,9,0
13,1,10,5,14,-9,1,2.11563484543285,4,0
13,1,10,14,5,9,1,1.28903469624538,-5,0
13,1,2,8,16,-8,0,1.58378801402432,-6,0
13,1,2,17,7,10,1,1.26618660205531,-3,0
13,1,10,11,0,11,0,0.778095051326545,10,0
13,1,10,9,18,-9,1,1.30080367141272,8,0
13,1,2,15,4,11,1,1.25057906495522,-6,0
13,1,10,9,19,-10,1,1.01106372372033,9,0
13,1,10,19,7,12,0,1.08526101451389,3,0
13,1,10,10,1,9,1,1.60440892121096,-9,0
13,1,2,11,1,10,NaN,NaN,0,0
13,1,2,13,0,13,1,0.994394277346601,-10,0
13,1,2,9,20,-11,1,1.13717727140283,10,0
13,1,10,0,19,-19,0,0.781524538095255,-9,0
13,1,10,20,10,10,0,0.94440023386187,0,0
13,1,2,3,11,-8,0,0.772220277445285,-1,0
13,1,10,11,2,9,0,1.46356206964174,8,0
13,1,10,19,1,18,1,1.23864514012485,-9,0
13,1,2,9,16,-7,0,0.679337122288416,-6,0
13,1,10,20,5,15,1,0.917955137357239,-5,0
13,1,2,4,19,-15,0,0.475470335635691,-9,0
13,1,2,9,19,-10,1,1.02645829247786,9,0
13,1,2,20,3,17,0,1.20290018162768,7,0
13,1,10,11,3,8,0,0.765184991046681,7,0
13,1,10,11,2,9,1,0.616229580606159,-8,0
13,1,10,9,19,-10,0,0.746321347602134,-9,0
13,1,2,8,11,-3,1,1.26228425958652,1,0
13,1,2,10,19,-9,1,1.34976916211099,9,0
13,1,10,9,20,-11,1,1.29735439068509,10,0
13,1,2,18,6,12,1,1.20741540373274,-4,0
13,1,2,20,5,15,0,0.849424050760717,5,0
13,1,10,4,19,-15,0,0.906016813868973,-9,0
13,1,10,0,16,-16,0,0.81478755399803,-6,0
13,1,10,20,3,17,1,1.07987669096337,-7,0
13,1,2,16,6,10,1,0.814547094045338,-4,0
13,1,2,10,7,3,0,0.951879051575816,3,0
13,1,10,11,3,8,0,1.36378621790573,7,0
13,1,10,7,20,-13,0,1.09597137940045,-10,0
13,1,2,19,10,9,1,0.814283541139503,0,0
13,1,2,1,14,-13,0,0.65544508000994,-4,0
13,1,2,18,7,11,0,1.22351669015643,3,0
13,1,10,19,3,16,0,0.776707641384746,7,0
13,1,10,10,9,1,1,1.12349158115239,-1,0
13,1,10,20,3,17,0,1.30412539106828,7,0
13,1,2,3,14,-11,0,0.90989129817217,-4,0
13,1,10,7,14,-7,0,1.09201735270426,-4,0
13,1,2,19,0,19,0,0.890635441084669,10,0
13,1,10,5,14,-9,0,0.737414432362584,-4,0
13,1,2,7,13,-6,0,0.782179571534016,-3,0
13,1,2,5,18,-13,0,0.823823496529712,-8,0
13,1,2,19,5,14,1,0.825105338687536,-5,0
13,1,10,18,7,11,1,0.586322373955682,-3,0
14,1,10,0,14,-14,0,2.79103253747599,-4,0
14,1,2,17,3,14,0,1.4905089100962,7,0
14,1,2,10,20,-10,NaN,NaN,0,0
14,1,2,10,16,-6,1,0.934760830399455,6,0
14,1,10,5,11,-6,0,2.06018544143603,-1,0
14,1,10,10,9,1,0,1.18075829748705,1,0
14,1,10,20,3,17,1,1.27231886103255,-7,0
14,1,2,11,8,3,1,1.52895382658539,-2,0
14,1,10,20,0,20,0,1.29451648317399,10,0
14,1,2,15,0,15,0,1.2705575522757,10,0
14,1,2,1,17,-16,1,1.49467263666634,7,0
14,1,10,1,20,-19,0,1.17466977751792,-10,0
14,1,10,10,12,-2,1,1.64286889887967,2,0
14,1,2,11,0,11,0,1.29285964330302,10,0
14,1,2,6,20,-14,0,1.12433776806802,-10,0
14,1,2,10,20,-10,0,1.71442018852053,-10,0
14,1,10,11,5,6,0,3.80040761193277,5,0
14,1,2,6,17,-11,0,1.57932982293437,-7,0
14,1,10,16,9,7,1,1.64678629881405,-1,0
14,1,10,20,8,12,0,3.07946526592832,2,0
14,1,10,1,17,-16,1,2.49019770278414,7,0
14,1,2,17,10,7,0,1.51366544664097,0,0
14,1,2,0,19,-19,0,0.479828890961926,-9,0
14,1,2,20,8,12,0,0.383310270757647,2,0
14,1,2,12,10,2,0,0.450647982009286,0,0
14,1,2,19,6,13,0,0.883388897340183,4,0
14,1,10,13,2,11,0,0.658798387880097,8,0
14,1,10,11,0,11,0,2.4033880909135,10,0
14,1,10,1,13,-12,0,3.32618851685334,-3,0
14,1,10,5,16,-11,1,1.80442764796567,6,0
14,1,2,6,11,-5,0,0.446568930220337,-1,0
14,1,10,13,2,11,0,1.3752254786782,8,0
14,1,2,5,16,-11,1,0.33124884305289,6,0
14,1,2,16,10,6,0,0.680733921413776,0,0
14,1,10,0,19,-19,0,4.56012954141829,-9,0
14,1,10,3,20,-17,1,1.06963346083444,10,0
14,1,10,5,11,-6,1,1.27042339223294,1,0
14,1,2,0,15,-15,0,0.318493741947123,-5,0
14,1,2,6,19,-13,0,0.228424700843334,-9,0
14,1,10,11,0,11,0,1.63844381681656,10,0
14,1,2,4,18,-14,0,0.363338752275013,-8,0
14,1,2,16,10,6,0,0.599351193236316,0,0
14,1,10,11,7,4,0,3.75423053167333,3,0
14,1,2,20,4,16,0,0.567115394131861,6,0
14,1,10,3,18,-15,0,0.987077382119651,-8,0
14,1,10,15,5,10,0,2.30247004767079,5,0
14,1,10,11,5,6,0,1.05318529298029,5,0
14,1,2,19,6,13,0,0.509976045467738,4,0
14,1,2,10,20,-10,1,0.52483042133963,10,0
14,1,10,1,20,-19,0,0.770845483186804,-10,0
14,1,10,15,0,15,0,1.91016189011725,10,0
14,1,10,20,4,16,0,0.933031778701888,6,0
14,1,10,7,13,-6,1,1.36246707855503,3,0
14,1,2,15,7,8,0,0.518513169494327,3,0
14,1,10,20,1,19,0,0.876590355505869,9,0
14,1,10,0,18,-18,0,1.33286866061712,-8,0
14,1,2,3,20,-17,1,0.554117631965482,10,0
14,1,2,1,19,-18,0,0.566858070771332,-9,0
14,1,2,1,17,-16,0,0.354758007906639,-7,0
14,1,2,1,20,-19,1,0.783554398048636,10,0
14,1,2,17,5,12,0,0.578323622614562,5,0
14,1,10,4,20,-16,1,1.30977883753621,10,0
14,1,2,8,18,-10,1,0.468528656548415,8,0
14,1,10,20,7,13,1,2.5566135219392,-3,0
14,1,2,4,11,-7,0,0.609397801021487,-1,0
14,1,10,9,15,-6,1,1.30808350912821,5,0
14,1,2,10,9,1,0,0.314880951289979,1,0
14,1,2,0,18,-18,0,0.384994235883369,-8,0
14,1,10,15,3,12,0,1.49235086150179,7,0
14,1,10,13,2,11,0,0.923691160649241,8,0
14,1,10,8,11,-3,1,2.44920154613965,1,0
14,1,2,19,2,17,0,0.593984424972177,8,0
14,1,2,3,18,-15,1,0.621520957008443,8,0
14,1,2,18,6,12,0,0.535436395860188,4,0
14,1,10,0,13,-13,0,1.78073667059493,-3,0
14,1,2,12,8,4,1,0.992285430989114,-2,0
14,1,10,12,1,11,0,0.683554581327144,9,0
14,1,10,10,20,-10,1,1.36306859940214,10,0
14,1,2,15,6,9,0,0.575170128496666,4,0
14,1,10,12,10,2,1,1.12327511789408,0,0
14,1,10,12,10,2,1,0.958075353223876,0,0
14,1,10,2,11,-9,1,0.906751072639054,1,0
14,1,2,0,13,-13,1,1.13738501549619,3,0
14,1,10,3,18,-15,0,0.630873671458176,-8,0
14,1,2,1,15,-14,0,0.8484816272221,-5,0
14,1,2,19,5,14,0,1.81701193327922,5,0
14,1,2,1,19,-18,1,1.24306134156382,9,0
14,1,2,5,16,-11,0,0.436477235863322,-6,0
14,1,10,20,3,17,1,5.57392603236326,-7,0
14,1,10,9,15,-6,1,1.15405311784639,5,0
14,1,10,10,20,-10,1,1.07006599867668,10,0
14,1,2,0,18,-18,0,0.70236081353778,-8,0
14,1,10,20,3,17,0,1.93299585606746,7,0
14,1,2,0,20,-20,0,0.282572207244357,-10,0
14,1,2,19,6,13,0,0.361893416077692,4,0
14,1,2,7,13,-6,1,0.678653341080008,3,0
14,1,2,1,20,-19,0,0.550741637448937,-10,0
14,1,10,13,3,10,1,0.979330189491748,-7,0
14,1,10,12,1,11,0,0.894895870180108,9,0
14,1,10,6,10,-4,0,1.82226910085274,0,0
14,1,10,3,10,-7,0,0.951596816081747,0,0
14,1,10,10,16,-6,1,1.02846685495501,6,0
14,1,2,14,1,13,0,0.80650859485695,9,0
14,1,2,0,15,-15,0,1.72926943258744,-5,0
14,1,10,15,0,15,0,0.726704629804544,10,0
14,1,10,18,5,13,0,0.691992368272849,5,0
14,1,2,3,20,-17,1,0.491540036325659,10,0
14,1,10,14,10,4,0,1.06686668487237,0,0
14,1,2,0,13,-13,0,1.13894068549916,-3,0
14,1,2,14,3,11,NaN,NaN,0,0
14,1,2,9,17,-8,1,0.563763225852654,7,0
14,1,2,19,5,14,0,0.479927128370264,5,0
14,1,2,6,10,-4,0,0.791369770370238,0,0
14,1,10,10,20,-10,1,0.77869531191277,10,0
14,1,10,12,10,2,0,0.822694307545589,0,0
14,1,10,14,5,9,0,1.61692359292329,5,0
14,1,10,9,15,-6,1,1.52288656695077,5,0
14,1,2,13,8,5,0,0.497198950912434,2,0
14,1,2,0,13,-13,0,0.759028402707372,-3,0
14,1,10,2,16,-14,0,0.595911417716025,-6,0
14,1,10,6,15,-9,0,0.67537705020186,-5,0
14,1,10,11,4,7,0,0.779494407249103,6,0
14,1,10,19,8,11,0,0.54289400806806,2,0
14,1,2,10,16,-6,1,0.452275497281107,6,0
14,1,2,2,11,-9,0,0.484345978956071,-1,0
14,1,2,12,0,12,0,0.995746833401654,10,0
14,1,2,0,13,-13,0,1.50971212407239,-3,0
14,1,10,15,5,10,0,1.75660948980681,5,0
14,1,2,10,9,1,0,0.600701957600222,1,0
14,1,10,10,8,2,0,0.667449511287259,2,0
14,1,10,8,13,-5,1,1.35407327850862,3,0
14,1,2,19,2,17,0,0.702297032533806,8,0
14,1,10,2,20,-18,0,1.18834530448999,-10,0
14,1,2,12,1,11,0,0.519069237212307,9,0
14,1,2,0,13,-13,0,0.700506032619842,-3,0
14,1,2,20,8,12,0,0.474596282740322,2,0
14,1,10,17,8,9,0,0.762001183980601,2,0
14,1,2,10,9,1,0,0.870018712759929,1,0
14,1,10,15,3,12,0,0.61419860451565,7,0
14,1,10,11,9,2,0,0.967527038197204,1,0
14,1,10,2,12,-10,0,0.570191911175698,-2,0
14,1,2,0,13,-13,1,0.733605807736694,3,0
14,1,2,20,10,10,1,0.427119389608379,0,0
14,1,10,2,11,-9,0,0.796534565455204,-1,0
14,1,2,8,11,-3,0,0.374517656157877,-1,0
14,1,10,10,6,4,0,1.05798059811195,4,0
14,1,2,0,15,-15,0,0.738037854392587,-5,0
14,1,10,5,19,-14,1,1.1667920904224,9,0
14,1,2,19,6,13,0,1.17820815700406,4,0
14,1,10,1,17,-16,1,0.996852370802117,7,0
14,1,10,0,13,-13,1,1.10219476299335,3,0
14,1,2,19,5,14,0,0.516492338032094,5,0
14,1,10,4,20,-16,1,0.746556283987047,10,0
14,1,10,15,6,9,0,0.566639602504893,4,0
14,1,2,13,2,11,0,0.714012210029978,8,0
14,1,10,2,13,-11,1,1.48739976943534,3,0
14,1,2,11,9,2,0,0.486096657545659,1,0
14,1,2,4,15,-11,0,0.661586057618933,-5,0
14,1,10,16,6,10,0,0.756940857781501,4,0
14,1,2,17,6,11,0,0.544926935927379,4,0
14,1,2,20,9,11,0,1.24836139636409,1,0
14,1,2,17,5,12,1,1.08041245049208,-5,0
14,1,10,0,10,-10,0,1.7120218028399,0,0
14,1,10,0,13,-13,0,1.29408431188904,-3,0
14,1,10,14,9,5,1,1.48467331479787,-1,0
14,1,10,13,4,9,0,1.16357518185805,6,0
14,1,2,13,5,8,0,0.335000559000036,5,0
14,1,2,1,20,-19,1,0.483774149265628,10,0
14,1,2,19,3,16,0,0.474378181031625,7,0
14,1,10,10,6,4,0,1.60189290289691,4,0
14,1,10,3,20,-17,0,0.715408794080759,-10,0
14,1,2,1,14,-13,0,0.312611593846668,-4,0
14,1,10,13,2,11,0,0.630701389436126,8,0
14,1,2,17,7,10,0,0.607559148633754,3,0
14,1,2,2,10,-8,0,0.577675548965544,0,0
14,1,2,19,0,19,0,0.701014814421342,10,0
14,1,10,3,12,-9,1,1.05896407186719,2,0
14,1,10,7,10,-3,0,0.659031885003515,0,0
14,1,10,0,13,-13,0,1.04321089702125,-3,0
14,1,2,14,10,4,1,0.731997720012259,0,0
14,1,10,17,10,7,1,0.624106287010818,0,0
14,1,2,14,8,6,0,0.665518119853004,2,0
14,1,10,2,17,-15,0,0.736753436935032,-7,0
14,1,2,14,7,7,0,0.797603813663954,3,0
14,1,2,6,18,-12,1,1.17571519948979,8,0
14,1,10,15,3,12,0,1.14696866116719,7,0
14,1,2,8,10,-2,0,0.871216256091884,0,0
14,1,10,3,20,-17,0,1.41461941251828,-10,0
14,1,2,0,13,-13,0,0.888117855565724,-3,0
14,1,10,11,3,8,0,1.48661790230153,7,0
14,1,10,11,10,1,1,1.52488210594629,0,0
14,1,10,4,16,-12,0,0.634277157786528,-6,0
14,1,2,20,1,19,0,0.787064552607262,9,0
14,1,10,8,15,-7,1,0.989671142944644,5,0
14,1,2,12,9,3,0,0.40841359415117,1,0
14,1,2,13,4,9,0,0.946566547596831,6,0
14,1,10,0,13,-13,1,1.15852145369399,3,0
14,1,10,3,13,-10,0,1.08264588530028,-3,0
14,1,2,18,5,13,0,0.673339357094846,5,0
14,1,2,13,0,13,0,0.672201562634655,10,0
15,1,10,10,16,-6,1,1.95709366025403,6,0
15,1,10,20,3,17,1,2.48894452373497,-7,0
15,1,10,5,11,-6,0,1.83225315739401,-1,0
15,1,2,11,5,6,0,1.09822019311832,5,0
15,1,10,6,17,-11,0,2.33682464569574,-7,0
15,1,2,10,9,1,1,0.758101686020382,-1,0
15,1,10,11,0,11,0,1.33948216802673,10,0
15,1,2,20,0,20,0,1.21730285306694,10,0
15,1,2,10,20,-10,0,1.00396355713019,-10,0
15,1,2,10,12,-2,1,0.806591022002976,2,0
15,1,2,11,8,3,1,1.12120464572217,-2,0
15,1,10,20,8,12,1,1.43186277651694,-2,0
15,1,10,1,17,-16,0,1.69712969259126,-7,0
15,1,10,0,14,-14,0,1.61578348343028,-4,0
15,1,2,15,0,15,0,1.10567335202359,10,0
15,1,2,16,9,7,1,0.752345675835386,-1,0
15,1,2,10,20,-10,0,0.932935499178711,-10,0
15,1,10,6,20,-14,1,2.6181206368492,10,0
15,1,2,17,3,14,1,1.54018558666576,-7,0
15,1,10,1,20,-19,0,1.59347898996202,-10,0
15,1,10,1,16,-15,0,1.60409771621926,-6,0
15,1,2,5,17,-12,0,1.27067176665878,-7,0
15,1,2,17,6,11,0,1.05538753088331,4,0
15,1,10,0,18,-18,0,1.57596500130603,-8,0
15,1,2,12,8,4,1,0.787947677948978,-2,0
15,1,2,14,6,8,1,0.871842909313273,-4,0
15,1,10,11,5,6,0,1.3998764710268,5,0
15,1,10,8,11,-3,1,2.39437301718863,1,0
15,1,2,15,0,15,0,1.22970230248757,10,0
15,1,10,6,20,-14,1,1.48695083212806,10,0
15,1,10,13,8,5,1,1.70158773212461,-2,0
15,1,10,19,9,10,1,2.0681905571837,-1,0
15,1,2,2,18,-16,0,1.02815470809583,-8,0
15,1,10,20,7,13,1,1.42215750494506,-3,0
15,1,10,6,20,-14,1,1.39208608173067,10,0
15,1,10,15,0,15,0,1.49140154063934,10,0
15,1,2,10,12,-2,1,0.858616145618726,2,0
15,1,2,10,3,7,0,1.16328697022982,7,0
15,1,2,4,14,-10,0,1.37523922277614,-4,0
15,1,2,18,4,14,0,1.69905227253912,6,0
15,1,10,17,6,11,0,1.2330493144691,4,0
15,1,2,7,16,-9,0,1.11461362376576,-6,0
15,1,10,5,11,-6,0,1.47292644530535,-1,0
15,1,2,6,12,-6,1,1.336954772647,2,0
15,1,2,10,16,-6,1,0.862213147920556,6,0
15,1,2,20,7,13,1,1.22213881067,-3,0
15,1,10,14,7,7,1,2.20011033298215,-3,0
15,1,2,14,9,5,1,1.04272196273087,-1,0
15,1,10,18,4,14,0,1.89195577154169,6,0
15,1,10,14,3,11,0,1.42729990230873,7,0
15,1,2,4,20,-16,0,0.860589676711243,-10,0
15,1,2,3,15,-12,0,0.96523630869342,-5,0
15,1,10,10,14,-4,1,0.873873622913379,4,0
15,1,2,6,20,-14,1,1.05775547493249,10,0
15,1,2,7,10,-3,1,0.986439671483822,0,0
15,1,10,18,4,14,0,1.05369661358418,6,0
15,1,10,14,3,11,0,1.11033849505475,7,0
15,1,2,0,15,-15,0,0.940915030776523,-5,0
15,1,10,2,17,-15,0,1.46625258191489,-7,0
15,1,10,6,19,-13,0,1.93017094279639,-9,0
15,1,2,15,0,15,0,1.06275858148001,10,0
15,1,10,11,3,8,0,2.00670465396252,7,0
15,1,2,14,3,11,0,0.889398318598978,7,0
15,1,2,2,19,-17,0,1.20872766996035,-9,0
15,1,2,8,11,-3,1,0.955340795160737,1,0
15,1,10,2,13,-11,0,1.3358111216221,-3,0
15,1,10,13,9,4,1,1.37320887576789,-1,0
15,1,10,6,11,-5,1,1.57715520483907,1,0
15,1,2,17,9,8,1,1.76494673039997,-1,0
15,1,10,4,13,-9,0,2.46499786479399,-3,0
15,1,10,1,19,-18,0,1.99234963464551,-9,0
15,1,10,10,3,7,0,1.57159420184325,7,0
15,1,10,10,5,5,0,0.895523449406028,5,0
15,1,2,7,10,-3,0,0.966190450883005,0,0
15,1,10,6,12,-6,0,1.26616497529903,-2,0
15,1,2,6,11,-5,0,0.79401012789458,-1,0
15,1,2,18,6,12,0,1.0132835796685,4,0
15,1,10,9,15,-6,1,1.10335122735705,5,0
15,1,2,13,6,7,0,1.13395598781062,4,0
15,1,2,5,18,-13,1,1.14726669242373,8,0
15,1,2,2,18,-16,0,0.942408741568215,-8,0
15,1,10,20,10,10,1,1.09167242463445,0,0
15,1,10,5,18,-13,0,1.90715533308685,-8,0
15,1,2,6,12,-6,0,1.07370060903486,-2,0
15,1,2,1,13,-12,0,0.961576258996502,-3,0
15,1,2,16,10,6,1,0.686102624342311,0,0
15,1,2,17,0,17,0,1.21344669652171,10,0
15,1,10,3,19,-16,1,3.03145736694569,9,0
15,1,10,17,6,11,1,1.13670478225686,-4,0
15,1,10,7,12,-5,1,0.949993860209361,2,0
15,1,2,18,4,14,0,1.44992549775634,6,0
15,1,2,10,3,7,0,1.08255254104733,7,0
15,1,2,1,18,-17,0,0.969615905545652,-8,0
15,1,10,20,2,18,0,1.07781921885908,8,0
15,1,10,20,1,19,0,0.949734705965966,9,0
15,1,2,1,15,-14,0,0.938406329660211,-5,0
15,1,2,5,10,-5,0,1.16766693361569,0,0
15,1,10,19,3,16,0,0.987607881659642,7,0
15,1,10,11,0,11,0,1.5349035319523,10,0
15,1,10,9,11,-2,1,1.3962233858183,1,0
15,1,2,0,11,-11,0,0.933490096591413,-1,0
15,1,10,13,1,12,0,1.05072238791035,9,0
15,1,2,13,6,7,0,0.891423900437076,4,0
15,1,10,2,14,-12,0,1.41875257733045,-4,0
15,1,2,10,19,-9,1,0.820521937333979,9,0
15,1,10,19,2,17,0,1.04662393854233,8,0
15,1,2,16,7,9,1,1.26325672946405,-3,0
15,1,10,2,20,-18,0,0.999225836247206,-10,0
15,1,2,7,10,-3,1,1.17780400678748,0,0
15,1,10,1,19,-18,0,0.821777387638576,-9,0
15,1,10,7,10,-3,0,1.51837887469446,0,0
15,1,10,9,15,-6,1,1.13972592697246,5,0
15,1,2,19,2,17,0,0.912304328463506,8,0
15,1,2,1,17,-16,0,0.966307015274651,-7,0
15,1,10,10,19,-9,1,0.809589073702227,9,0
15,1,10,17,0,17,0,1.74018448707648,10,0
15,1,2,1,20,-19,0,1.10540356766433,-10,0
15,1,10,10,7,3,0,2.24739956855774,3,0
15,1,2,1,12,-11,0,0.84807952772826,-2,0
15,1,2,5,14,-9,0,1.40069462137762,-4,0
15,1,10,4,15,-11,0,1.21660933142994,-5,0
15,1,10,12,8,4,1,1.28984441579087,-2,0
15,1,10,8,11,-3,1,1.07318596611731,1,0
15,1,2,10,14,-4,1,0.984489599941298,4,0
15,1,2,18,8,10,1,1.0111091764993,-2,0
15,1,2,7,11,-4,1,0.98901361937169,1,0
15,1,2,13,6,7,0,1.11167642008513,4,0
15,1,10,4,14,-10,0,1.12556628137827,-4,0
15,1,10,1,14,-13,0,0.826886428520083,-4,0
15,1,2,2,20,-18,0,0.828301330038812,-10,0
15,1,10,1,15,-14,0,0.908805196231697,-5,0
15,1,10,8,19,-11,1,2.54673408833332,9,0
15,1,2,8,15,-7,1,1.23055454244604,5,0
15,1,2,10,19,-9,1,0.79205272521358,9,0
15,1,10,8,16,-8,1,1.29131356743164,6,0
15,1,10,19,2,17,0,0.978559842857067,8,0
15,1,2,19,10,9,1,1.02991637052037,0,0
15,1,2,8,12,-4,0,1.31048804940656,-2,0
15,1,2,6,12,-6,0,0.94050448940834,-2,0
15,1,10,14,8,6,1,0.985129604639951,-2,0
15,1,2,2,18,-16,0,0.739011511672288,-8,0
15,1,2,10,7,3,0,1.03169269510545,3,0
15,1,10,17,6,11,0,2.02426776097855,4,0
15,1,2,9,11,-2,1,1.2335382985766,1,0
15,1,10,12,4,8,0,1.07414304069243,6,0
15,1,2,17,1,16,0,0.809468477207702,9,0
15,1,2,18,3,15,0,0.843474866240285,7,0
15,1,10,17,2,15,0,1.29265479149763,8,0
15,1,10,10,19,-9,1,0.915351132047363,9,0
15,1,10,11,7,4,0,1.52060092997272,3,0
15,1,2,5,10,-5,0,0.885940973646939,0,0
15,1,10,15,1,14,0,0.876567434170283,9,0
15,1,10,0,11,-11,0,1.15653319796547,-1,0
15,1,2,5,18,-13,0,0.808532296214253,-8,0
15,1,2,16,1,15,0,0.946419217740186,9,0
15,1,10,6,20,-14,1,1.20640004693996,10,0
15,1,2,11,8,3,1,1.22478423669236,-2,0
15,1,10,8,11,-3,1,0.874309090024326,1,0
15,1,2,1,11,-10,0,0.658270117884967,-1,0
15,1,10,18,6,12,0,1.12284057983197,4,0
15,1,2,17,6,11,0,0.924152479507029,4,0
15,1,10,12,10,2,1,0.929612313280813,0,0
15,1,10,9,17,-8,1,1.15064082946628,7,0
15,1,10,6,16,-10,0,1.42730503407074,-6,0
15,1,2,9,18,-9,1,0.997291893057991,8,0
15,1,10,9,12,-3,1,0.919166967563797,2,0
15,1,10,10,17,-7,1,0.996482540038414,7,0
15,1,2,10,0,10,0,1.03848238976207,10,0
15,1,2,14,9,5,1,0.919077528174967,-1,0
15,1,2,13,2,11,0,0.844326006481424,8,0
15,1,10,9,18,-9,0,0.876294350833632,-8,0
15,1,10,3,17,-14,0,0.747622983704787,-7,0
15,1,2,13,1,12,0,1.07954312610673,9,0
15,1,10,8,13,-5,1,1.3981833543512,3,0
15,1,10,12,4,8,0,0.888079087832011,6,0
15,1,2,17,0,17,0,0.80747075349791,10,0
15,1,2,18,5,13,1,1.47338647156721,-5,0
15,1,2,3,18,-15,0,0.936708081222605,-8,0
15,1,2,7,17,-10,1,1.19729812454898,7,0
15,1,10,11,5,6,0,1.02329345827457,5,0
15,1,2,10,10,0,1,1.64786252728663,0,0
15,1,2,0,16,-16,0,0.863820490776561,-6,0
15,1,10,16,4,12,0,1.24713271664223,6,0
15,1,10,14,5,9,0,1.01515814091545,5,0
15,1,2,19,7,12,1,1.10449194588,-3,0
15,1,10,7,12,-5,0,1.58228587242775,-2,0
15,1,2,6,16,-10,0,0.792894335056189,-6,0
15,1,10,20,3,17,0,1.04361672297819,7,0
15,1,10,10,14,-4,1,1.02018837252399,4,0
15,1,2,13,6,7,0,1.02146508294391,4,0
15,1,2,4,18,-14,0,0.797493131656665,-8,0
15,1,2,10,3,7,0,0.887360640452243,7,0
15,1,10,10,19,-9,1,0.829928833409213,9,0
15,1,2,0,13,-13,0,0.798650711716618,-3,0
15,1,10,9,17,-8,1,1.81661263038404,7,0
15,1,2,2,14,-12,0,0.713895909429993,-4,0
15,1,10,15,3,12,0,1.64720456139185,7,0
15,1,2,1,18,-17,0,0.847028981603216,-8,0
15,1,10,7,17,-10,0,1.94304068211932,-7,0
15,1,10,17,4,13,0,1.23639742605155,6,0
16,1,10,15,0,15,0,2.99773249196005,10,0
16,1,2,10,9,1,0,1.35155208468495,1,0
16,1,2,1,20,-19,0,0.612337501675938,-10,0
16,1,2,10,20,-10,1,0.9509560665756,10,0
16,1,10,11,5,6,0,0.787519541961956,5,0
16,1,10,20,8,12,1,1.06335716550529,-2,0
16,1,2,16,9,7,0,1.11218666436616,1,0
16,1,2,17,3,14,0,0.750301033142023,7,0
16,1,10,6,17,-11,0,0.594760832143947,-7,0
16,1,10,5,11,-6,0,0.518225288251415,-1,0
16,1,2,0,14,-14,0,0.523951607436175,-4,0
16,1,2,1,17,-16,0,0.706606600550003,-7,0
16,1,10,6,20,-14,0,0.585804065456614,-10,0
16,1,2,10,16,-6,1,0.661239944936824,6,0
16,1,10,20,3,17,0,0.701271028796327,7,0
16,1,10,10,12,-2,1,0.915640343751875,2,0
16,1,10,11,0,11,0,0.482432311080629,10,0
16,1,2,11,8,3,0,0.666194666264346,2,0
16,1,10,20,0,20,0,0.658178845755174,10,0
16,1,2,10,20,-10,1,0.970753325105761,10,0
16,1,2,14,6,8,NaN,NaN,0,0
16,1,2,16,0,16,0,0.814773991471156,10,0
16,1,10,20,0,20,0,0.688682070525829,10,0
16,1,10,11,1,10,0,0.856049528883887,9,0
16,1,2,19,10,9,1,0.753286988590844,0,0
16,1,10,10,20,-10,1,0.549878028890816,10,0
16,1,2,20,5,15,0,0.530545928399079,5,0
16,1,10,3,19,-16,0,0.463729585186229,-9,0
16,1,10,20,1,19,0,0.559846853400813,9,0
16,1,2,19,9,10,0,0.7324303866626,1,0
16,1,2,11,0,11,0,0.608333256968763,10,0
16,1,2,1,17,-16,0,0.658949343953282,-7,0
16,1,10,19,5,14,0,0.579627616971266,5,0
16,1,10,2,18,-16,0,1.23103143024491,-8,0
16,1,10,14,0,14,0,0.688044998270925,10,0
16,1,2,6,11,-5,0,0.479512335485197,-1,0
16,1,2,12,1,11,0,0.479027016917826,9,0
16,1,10,13,9,4,0,0.541279752796981,1,0
16,1,2,4,16,-12,0,0.450715789891547,-6,0
16,1,10,9,10,-1,0,0.547347334519145,0,0
16,1,2,12,10,2,1,0.827988658798859,0,0
16,1,10,20,1,19,1,0.733322581058019,-9,0
16,1,10,5,20,-15,0,0.714374629998929,-10,0
16,1,10,8,17,-9,0,0.744528528055525,-7,0
16,1,2,18,10,8,1,0.613075376488268,0,0
16,1,2,16,6,10,0,0.527106178094982,4,0
16,1,2,14,9,5,0,0.493076329541509,1,0
16,1,10,10,16,-6,1,0.67633943707915,6,0
16,1,2,9,14,-5,0,0.420473185600713,-4,0
16,1,10,8,14,-6,0,0.518542358156992,-4,0
16,1,2,19,9,10,0,0.722733912378317,1,0
16,1,10,8,10,-2,0,0.632879966127803,0,0
16,1,2,12,9,3,0,0.562093467800878,1,0
16,1,10,16,0,16,0,0.750067904271418,10,0
16,1,2,8,17,-9,0,1.1305939470767,-7,0
16,1,10,12,1,11,0,0.831859844096471,9,0
16,1,10,3,10,-7,0,0.881276930318563,0,0
16,1,2,9,16,-7,1,1.3924999221199,6,0
16,1,2,19,8,11,1,1.31584341511189,-2,0
16,1,10,0,19,-19,0,0.793878168173251,-9,0
16,1,2,16,6,10,0,0.691115994442953,4,0
16,1,2,16,1,15,0,0.730361917885602,9,0
16,1,10,15,0,15,0,0.615609736429178,10,0
16,1,10,5,17,-12,0,0.737618969942559,-7,0
16,1,2,20,1,19,0,0.878921815688955,9,0
16,1,10,13,4,9,0,0.638222135879914,6,0
16,1,10,0,18,-18,0,0.687435784173431,-8,0
16,1,10,1,16,-15,0,0.598738318352844,-6,0
16,1,2,3,20,-17,0,0.729279848106671,-10,0
16,1,2,4,10,-6,0,0.96661235546344,0,0
16,1,10,7,17,-10,0,0.729821982662543,-7,0
16,1,2,20,5,15,0,0.767216804335476,5,0
16,1,2,19,9,10,1,1.65930673488765,-1,0
16,1,10,17,2,15,0,0.651179481719737,8,0
16,1,2,2,17,-15,0,1.05963076934859,-7,0
16,1,10,10,16,-6,1,0.932463743156404,6,0
16,1,2,11,3,8,0,1.08968936312885,7,0
16,1,10,16,6,10,0,0.784959889744641,4,0
16,1,2,4,20,-16,0,1.10018309412408,-10,0
16,1,10,7,16,-9,0,1.72290582656569,-6,0
16,1,2,9,10,-1,0,0.913598633487709,0,0
16,1,2,10,3,7,0,0.607568257095409,7,0
16,1,10,15,1,14,0,0.482198449113639,9,0
16,1,10,9,16,-7,1,1.04144561884459,6,0
16,1,10,19,6,13,0,0.91451575361134,4,0
16,1,2,9,19,-10,1,0.896730147855124,9,0
16,1,10,5,16,-11,0,0.687460709916195,-6,0
16,1,2,19,2,17,0,0.89446850468812,8,0
16,1,2,10,16,-6,1,0.997242041645222,6,0
16,1,10,8,15,-7,0,1.11982566653751,-5,0
16,1,2,16,9,7,1,1.65978032370913,-1,0
16,1,10,1,19,-18,0,1.22031153492571,-9,0
16,1,2,9,14,-5,0,0.894311985786771,-4,0
16,1,10,9,13,-4,0,1.25360167588224,-3,0
16,1,2,19,3,16,0,0.798251167027047,7,0
16,1,10,10,7,3,0,0.968847973228549,3,0
16,1,10,0,12,-12,0,0.916835678974167,-2,0
16,1,10,15,0,15,0,0.690786828214186,10,0
16,1,2,10,9,1,0,0.690026593540097,1,0
16,1,2,10,10,0,1,1.13730373281578,0,0
16,1,10,1,13,-12,0,1.21397343577701,-3,0
16,1,10,3,16,-13,0,2.05587651500537,-6,0
16,1,2,2,11,-9,0,1.52041142110829,-1,0
16,1,10,17,3,14,0,0.654442919170833,7,0
16,1,2,13,9,4,0,0.599110738039599,1,0
16,1,10,7,10,-3,0,1.27372443510103,0,0
16,1,2,18,4,14,0,1.32959691800352,6,0
16,1,10,0,20,-20,0,1.30219621311699,-10,0
16,1,2,8,13,-5,0,0.684935513854725,-3,0
16,1,2,15,2,13,0,0.724148447363405,8,0
16,1,2,10,16,-6,1,0.816778679698473,6,0
16,1,2,13,4,9,0,1.18602033279603,6,0
16,1,2,6,19,-13,0,0.804740653315093,-9,0
16,1,10,7,17,-10,0,1.53535622713389,-7,0
16,1,10,8,12,-4,0,0.795827140085748,-2,0
16,1,10,3,17,-14,0,0.606494984618621,-7,0
16,1,2,9,20,-11,1,0.776546723820502,10,0
16,1,10,13,8,5,0,1.02038044724031,2,0
16,1,10,15,5,10,0,0.646244920921163,5,0
16,1,2,9,16,-7,0,0.662944424795569,-6,0
16,1,10,10,2,8,0,1.70028096425813,8,0
16,1,2,16,0,16,0,1.45054021014948,10,0
16,1,2,19,5,14,0,0.819016496796394,5,0
16,1,10,6,11,-5,0,0.75616737625387,-1,0
16,1,2,14,0,14,0,0.776856096083065,10,0
16,1,2,1,17,-16,0,1.11667329519696,-7,0
16,1,10,10,3,7,0,0.714127938612364,7,0
16,1,2,9,18,-9,1,1.50404364934366,8,0
16,1,10,16,6,10,0,1.70987883530324,4,0
16,1,10,12,6,6,0,0.667840130787226,4,0
16,1,2,13,1,12,0,0.635226283440716,9,0
16,1,10,3,18,-15,0,0.612507949655992,-8,0
16,1,2,16,9,7,1,1.36643054427986,-1,0
16,1,2,10,12,-2,1,0.905749961966649,2,0
16,1,10,3,12,-9,0,0.784400160540827,-2,0
16,1,2,19,3,16,1,1.20317143217835,-7,0
16,1,10,17,3,14,0,1.13342228396505,7,0
16,1,10,1,11,-10,0,0.810904638943612,-1,0
16,1,10,6,10,-4,0,0.932813436433207,0,0
16,1,2,15,9,6,NaN,NaN,0,0
16,1,10,19,9,10,1,1.45202329089807,-1,0
16,1,2,7,12,-5,0,0.556745799738565,-2,0
16,1,2,18,0,18,0,0.352692803251557,10,0
16,1,2,10,4,6,0,0.43728302247473,6,0
16,1,10,1,13,-12,0,0.910528370426618,-3,0
16,1,10,10,3,7,0,0.516354025952751,7,0
16,1,10,6,15,-9,0,0.45768399676308,-5,0
16,1,2,15,6,9,0,0.449824328621617,4,0
16,1,10,2,20,-18,0,0.530224826390622,-10,0
16,1,2,12,9,3,0,0.567012266765232,1,0
16,1,2,9,17,-8,1,0.762214064336149,7,0
16,1,10,20,2,18,0,0.637536311827716,8,0
16,1,10,6,16,-10,0,1.71010280029441,-6,0
16,1,10,11,1,10,0,1.10009732028993,9,0
16,1,10,10,12,-2,1,1.23475929262349,2,0
16,1,2,18,2,16,0,0.755381482755183,8,0
16,1,2,16,6,10,0,1.20786956514348,4,0
16,1,10,20,3,17,0,0.73058624942496,7,0
16,1,2,1,16,-15,0,0.839310437106178,-6,0
16,1,2,5,12,-7,0,0.871827880531782,-2,0
16,1,10,12,6,6,0,0.693488703705953,4,0
16,1,2,13,8,5,0,0.74877506546909,2,0
16,1,2,15,7,8,0,0.584836727328366,3,0
16,1,10,8,13,-5,0,0.427511404443067,-3,0
16,1,2,2,13,-11,0,0.661414791597053,-3,0
16,1,10,19,2,17,0,0.972677371290047,8,0
16,1,10,9,17,-8,0,0.664164685731521,-7,0
16,1,2,2,14,-12,0,0.599144461084506,-4,0
16,1,10,1,19,-18,0,0.785221976417233,-9,0
16,1,2,9,16,-7,1,1.2758856422297,6,0
16,1,2,11,1,10,0,1.77776038678712,9,0
16,1,2,1,20,-19,0,0.781536267852061,-10,0
16,1,2,2,14,-12,0,0.960386422084412,-4,0
16,1,10,13,6,7,0,0.836317883658921,4,0
16,1,10,15,9,6,0,1.70142241593567,1,0
16,1,2,11,5,6,NaN,NaN,0,0
16,1,10,2,17,-15,0,0.743399539249367,-7,0
16,1,10,17,3,14,0,0.572075854855939,7,0
16,1,2,17,4,13,0,0.567238431074657,6,0
16,1,10,10,1,9,0,0.70665571889549,9,0
16,1,2,10,12,-2,1,0.807912452059099,2,0
16,1,10,9,19,-10,1,1.02583661553217,9,0
16,1,2,1,11,-10,0,1.01977966391132,-1,0
16,1,2,10,1,9,0,0.629102618855541,9,0
16,1,10,11,5,6,0,0.653740966707119,5,0
16,1,2,18,7,11,0,0.501619988965103,3,0
16,1,10,4,20,-16,0,0.779598292574519,-10,0
16,1,2,3,19,-16,0,1.1963293201552,-9,0
16,1,10,8,20,-12,1,0.830264597592759,10,0
16,1,10,11,10,1,1,0.966827523137908,0,0
16,1,10,11,8,3,0,0.938183097794536,2,0
16,1,10,12,0,12,0,0.959434845790383,10,0
16,1,10,10,1,9,0,0.771365471635363,9,0
16,1,2,19,4,15,0,0.766687865747372,6,0
16,1,2,1,14,-13,0,0.642606131354114,-4,0
16,1,10,19,2,17,0,0.64328865641437,8,0
16,1,2,2,18,-16,0,0.524617637507617,-8,0
16,1,2,6,15,-9,0,0.769840603636112,-5,0
16,1,10,0,18,-18,0,0.580433304436156,-8,0
16,1,2,3,16,-13,0,0.81508446339285,-6,0
17,1,2,10,20,-10,NaN,NaN,0,0
17,1,2,11,0,11,0,1.12869210452482,10,0
17,1,10,11,5,6,0,1.15012728709553,5,0
17,1,2,6,20,-14,0,0.618872579114395,-10,0
17,1,10,0,14,-14,0,0.51694247064006,-4,0
17,1,10,17,3,14,0,0.731019744620426,7,0
17,1,10,1,17,-16,0,0.585133894288447,-7,0
17,1,2,16,9,7,0,0.524545606167521,1,0
17,1,10,10,9,1,0,0.914507429202786,1,0
17,1,2,6,17,-11,0,0.432639012346044,-7,0
17,1,2,15,0,15,0,0.490077471928089,10,0
17,1,10,10,16,-6,1,1.00148492440348,6,0
17,1,2,20,8,12,0,0.524190411961172,2,0
17,1,10,5,11,-6,0,0.578285867188242,-1,0
17,1,10,20,3,17,0,0.694405049696798,7,0
17,1,2,10,12,-2,1,0.781796754876268,2,0
17,1,2,1,20,-19,0,0.841176502930466,-10,0
17,1,10,20,0,20,0,0.690501578952535,10,0
17,1,2,11,8,3,0,1.09794782787503,2,0
17,1,10,10,20,-10,1,0.824714772446896,10,0
17,1,10,8,17,-9,0,0.950183736946201,-7,0
17,1,2,19,5,14,0,0.634905070779496,5,0
17,1,10,3,11,-8,0,0.564350817512604,-1,0
17,1,2,15,6,9,0,0.704390808939934,4,0
17,1,2,20,8,12,0,0.743085717636859,2,0
17,1,10,0,12,-12,0,1.46852279161976,-2,0
17,1,10,4,16,-12,0,0.828636204518261,-6,0
17,1,10,8,12,-4,0,0.878883172641508,-2,0
17,1,2,16,7,9,0,0.742138533067191,3,0
17,1,2,20,5,15,0,0.675500580080552,5,0
17,1,2,1,12,-11,0,0.618228904146235,-2,0
17,1,10,11,6,5,0,0.596309132597526,4,0
17,1,2,18,4,14,0,0.751074105093721,6,0
17,1,2,18,8,10,0,0.69179919247108,2,0
17,1,2,11,8,3,0,0.571226336425752,2,0
17,1,10,9,20,-11,0,0.775316018378362,-10,0
17,1,10,16,1,15,0,0.899346977821551,9,0
17,1,10,20,3,17,0,0.618086313304957,7,0
17,1,2,15,7,8,0,0.652157832315424,3,0
17,1,10,11,1,10,0,0.47693052086106,9,0
17,1,10,9,10,-1,0,1.19378465112823,0,0
17,1,2,10,6,4,0,0.565202697136556,4,0
17,1,10,2,16,-14,0,0.673233055422315,-6,0
17,1,2,15,6,9,0,0.737310237775091,4,0
17,1,2,17,3,14,0,0.71053907777241,7,0
17,1,2,11,8,3,0,0.500827136987937,2,0
17,1,10,0,17,-17,0,0.763556487421738,-7,0
17,1,10,2,17,-15,0,1.19166668194521,-7,0
17,1,10,3,12,-9,0,0.690996431570966,-2,0
17,1,2,4,18,-14,0,0.4664374460408,-8,0
17,1,2,16,4,12,0,0.801188012846978,6,0
17,1,10,6,13,-7,0,0.595915816404158,-3,0
17,1,2,16,7,9,0,0.638682445744053,3,0
17,1,10,10,9,1,0,0.736126623611199,1,0
17,1,2,17,10,7,1,1.19745279198105,0,0
17,1,2,10,19,-9,1,0.720216562171117,9,0
17,1,10,15,7,8,0,0.950245318614179,3,0
17,1,10,6,12,-6,0,2.24307233828586,-2,0
17,1,10,4,17,-13,0,0.876496883342043,-7,0
17,1,2,13,8,5,0,0.732579813309712,2,0
17,1,10,16,7,9,0,0.592676181273418,3,0
17,1,10,11,10,1,1,0.828091866642353,0,0
17,1,2,5,18,-13,0,0.605390961049125,-8,0
17,1,2,15,8,7,0,0.456214890669798,2,0
17,1,10,17,3,14,0,0.368932419631165,7,0
17,1,2,11,3,8,0,0.605062158996589,7,0
17,1,10,12,1,11,0,0.527816765228636,9,0
17,1,2,9,18,-9,0,0.477869641152211,-8,0
17,1,2,20,3,17,0,0.805834129074356,7,0
17,1,10,14,6,8,0,1.04066478867026,4,0
17,1,10,1,17,-16,0,1.84935769962613,-7,0
17,1,2,11,7,4,0,0.634142997747404,3,0
17,1,10,17,8,9,0,0.603584565717028,2,0
17,1,2,9,14,-5,0,0.438293528248323,-4,0
17,1,10,16,7,9,0,0.527743087193812,3,0
17,1,10,18,2,16,0,0.573845389706548,8,0
17,1,2,20,6,14,0,0.521800457092468,4,0
17,1,2,2,13,-11,0,0.527882012480404,-3,0
17,1,10,13,8,5,0,0.46190532919718,2,0
17,1,2,9,20,-11,0,0.614117961857119,-10,0
17,1,10,18,7,11,0,0.738972942563123,3,0
17,1,2,13,1,12,0,0.792384034954011,9,0
17,1,2,14,9,5,0,1.33977680312819,1,0
17,1,2,6,17,-11,0,0.721187572969939,-7,0
17,1,10,18,0,18,0,0.583256386802532,10,0
17,1,2,19,6,13,0,0.69068852327473,4,0
17,1,2,11,7,4,0,0.570105770166265,3,0
17,1,10,18,3,15,0,0.518133049365133,7,0
17,1,10,9,17,-8,0,0.780199663859094,-7,0
17,1,10,10,0,10,0,0.991679878017749,10,0
17,1,2,18,10,8,1,1.00970534275984,0,0
17,1,10,0,10,-10,0,0.852492132762563,0,0
17,1,10,3,20,-17,0,0.741234602304758,-10,0
17,1,2,4,19,-15,0,1.08267044465174,-9,0
17,1,2,8,18,-10,0,0.609990524491877,-8,0
17,1,10,12,9,3,0,0.820773179715616,1,0
17,1,2,16,7,9,0,0.958952891873196,3,0
17,1,10,19,3,16,0,0.675594052241649,7,0
17,1,2,3,13,-10,0,0.579693814521306,-3,0
17,1,10,7,19,-12,0,0.463150524999946,-9,0
17,1,10,2,19,-17,0,0.557106908323476,-9,0
17,1,10,13,9,4,0,1.5138457929279,1,0
17,1,2,18,4,14,0,1.03198287442501,6,0
17,1,2,11,6,5,0,0.969389883379336,4,0
17,1,2,14,6,8,0,1.18945524058654,4,0
17,1,2,8,20,-12,0,1.14496505791612,-10,0
17,1,10,17,7,10,0,1.47034751482715,3,0
17,1,10,3,16,-13,0,1.07039553386858,-6,0
17,1,2,12,5,7,0,0.790444579251925,5,0
17,1,10,9,15,-6,0,0.914127675641794,-5,0
17,1,10,8,10,-2,0,1.21460548332834,0,0
17,1,2,6,16,-10,0,0.5687249480834,-6,0
17,1,2,17,6,11,0,0.460829116389505,4,0
17,1,10,13,9,4,0,0.653556249162648,1,0
17,1,2,13,5,8,0,0.549658826625091,5,0
17,1,10,18,9,9,0,0.6583152651001,1,0
17,1,10,3,16,-13,0,0.642442225958803,-6,0
17,1,2,3,11,-8,0,0.531216952556861,-1,0
17,1,2,16,6,10,0,0.735875898288214,4,0
17,1,10,7,13,-6,0,0.988639283605153,-3,0
17,1,2,11,7,4,0,0.783505279337987,3,0
17,1,2,13,8,5,0,0.506283711831202,2,0
17,1,2,9,17,-8,0,1.04831924225437,-7,0
17,1,10,14,9,5,0,0.63247369491728,1,0
17,1,10,3,19,-16,0,0.752955278148875,-9,0
17,1,2,9,12,-3,0,0.869160601680051,-2,0
17,1,10,1,15,-14,0,0.548675719415769,-5,0
17,1,10,17,9,8,0,1.18471528562077,1,0
17,1,10,0,17,-17,0,0.795385407705908,-7,0
17,1,2,18,1,17,0,0.653771784971468,9,0
17,1,2,11,1,10,0,0.476893865110469,9,0
17,1,10,10,16,-6,1,0.964337987999897,6,0
17,1,10,0,20,-20,0,0.888377378258156,-10,0
17,1,2,19,9,10,NaN,NaN,0,0
17,1,2,18,10,8,0,0.659929584304336,0,0
17,1,10,11,9,2,0,0.747966064096545,1,0
17,1,10,13,4,9,0,1.42469937703572,6,0
17,1,2,16,6,10,0,0.962162102718139,4,0
17,1,2,10,9,1,0,0.869433686995762,1,0
17,1,10,3,16,-13,0,0.565064871509094,-6,0
17,1,10,10,9,1,0,0.7910691932193,1,0
17,1,10,4,16,-12,0,0.713856789661804,-6,0
17,1,2,6,14,-8,0,0.527945060355705,-4,0
17,1,2,16,6,10,0,0.4853507130465,4,0
17,1,2,12,0,12,0,1.05202220605861,10,0
17,1,10,20,3,17,0,0.852779880384333,7,0
17,1,10,19,5,14,0,0.476963877590606,5,0
17,1,2,6,19,-13,0,0.516178198260604,-9,0
17,1,10,8,13,-5,0,0.513731426995946,-3,0
17,1,2,0,10,-10,0,0.583188940232503,0,0
17,1,2,7,10,-3,0,0.46441038310877,0,0
17,1,2,3,11,-8,0,0.672858800215181,-1,0
17,1,10,7,13,-6,0,0.583261152045452,-3,0
17,1,10,11,1,10,0,1.05005012673791,9,0
17,1,2,17,7,10,0,0.810105623546406,3,0
17,1,2,10,18,-8,1,1.10022634925554,8,0
17,1,10,6,19,-13,0,1.17897096314118,-9,0
17,1,10,12,1,11,0,0.597751536333817,9,0
17,1,10,14,7,7,0,0.439760491324705,3,0
17,1,2,15,10,5,1,0.672582049315679,0,0
17,1,2,0,11,-11,0,0.759486233015195,-1,0
17,1,10,5,12,-7,0,0.452175427082693,-2,0
17,1,2,4,14,-10,0,0.436247770863702,-4,0
17,1,10,19,5,14,0,0.589630455055158,5,0
17,1,10,20,8,12,0,0.519742603341001,2,0
17,1,2,16,8,8,0,0.541145895374939,2,0
17,1,10,17,9,8,0,0.577920042807818,1,0
17,1,2,5,14,-9,0,0.509301946236519,-4,0
17,1,2,19,4,15,0,0.715318620947073,6,0
17,1,10,5,13,-8,0,0.592775884913863,-3,0
17,1,10,14,9,5,0,0.418223772358033,1,0
17,1,10,1,20,-19,0,0.731607336289017,-10,0
17,1,2,15,1,14,0,1.176266868526,9,0
17,1,2,3,13,-10,0,0.651694503656472,-3,0
17,1,2,14,6,8,0,0.619816831225762,4,0
17,1,2,3,12,-9,0,1.04524895668146,-2,0
17,1,10,5,15,-10,0,1.41464580465981,-5,0
17,1,10,13,2,11,0,0.832066449554986,8,0
17,1,10,10,20,-10,1,1.0807342879707,10,0
17,1,2,2,20,-18,0,0.735528401783085,-10,0
17,1,10,1,10,-9,0,0.755001402081689,0,0
17,1,2,10,5,5,0,0.678980310374754,5,0
17,1,2,10,15,-5,1,1.3577080626128,5,0
17,1,2,1,15,-14,0,1.38589633388619,-5,0
17,1,2,12,7,5,0,0.756640280640568,3,0
17,1,10,10,18,-8,1,0.71268123977643,8,0
17,1,10,16,9,7,0,0.542144397986704,1,0
17,1,10,12,4,8,0,0.578907182149123,6,0
17,1,2,12,9,3,0,0.605611628678162,1,0
17,1,10,16,7,9,0,0.455699877391453,3,0
17,1,2,20,1,19,0,0.830389082460897,9,0
17,1,10,13,5,8,0,0.375162797339726,5,0
17,1,10,6,13,-7,0,0.346595505645382,-3,0
17,1,2,13,2,11,0,0.638711770341615,8,0
17,1,2,4,12,-8,0,0.767175143002532,-2,0
17,1,10,6,10,-4,0,0.546785382408416,0,0
17,1,10,20,4,16,0,0.478901500493521,6,0
17,1,10,2,11,-9,0,0.942259130490129,-1,0
17,1,2,13,8,5,0,0.578347082293476,2,0
17,1,2,11,5,6,0,0.477686362413806,5,0
18,1,10,11,0,11,0,1.84593554865569,10,0
18,1,2,10,16,-6,1,1.19040945998859,6,0
18,1,10,10,9,1,0,1.44986354990397,1,0
18,1,10,10,12,-2,0,1.14639685791917,-2,0
18,1,2,16,9,7,1,1.43088077614084,-1,0
18,1,10,0,14,-14,1,1.20010373496916,4,0
18,1,2,6,17,-11,1,1.77956273674499,7,0
18,1,10,10,20,-10,0,1.55084280110896,-10,0
18,1,2,20,0,20,0,1.58744146581739,10,0
18,1,2,11,5,6,1,1.76740887900814,-5,0
18,1,10,6,20,-14,1,2.15534482721705,10,0
18,1,2,1,17,-16,0,1.58383016788866,-7,0
18,1,10,5,11,-6,0,1.02725884818938,-1,0
18,1,2,1,20,-19,0,1.70177174266428,-10,0
18,1,10,10,20,-10,1,1.70917285070755,10,0
18,1,2,15,0,15,0,1.73246777523309,10,0
18,1,2,11,8,3,1,1.67371087265201,-2,0
18,1,10,17,3,14,0,1.88172889244743,7,0
18,1,10,20,3,17,0,1.8257075882284,7,0
18,1,2,20,8,12,1,1.93156165175606,-2,0
18,1,10,16,2,14,0,1.66472881357186,8,0
18,1,2,5,17,-12,1,1.51349416538142,7,0
18,1,2,15,4,11,0,1.43144417088479,6,0
18,1,2,6,20,-14,NaN,NaN,0,0
18,1,10,18,9,9,0,1.7733917866135,1,0
18,1,10,0,14,-14,1,1.46505028218962,4,0
18,1,2,16,3,13,0,1.22525196068455,7,0
18,1,10,20,3,17,0,1.84360316046514,7,0
18,1,10,18,3,15,0,0.861187161062844,7,0
18,1,2,0,18,-18,0,1.55841142474674,-8,0
18,1,10,9,18,-9,1,1.22733325883746,8,0
18,1,2,10,20,-10,1,1.22886619099882,10,0
18,1,2,5,17,-12,1,1.3429068896221,7,0
18,1,2,6,12,-6,1,1.06093313847668,2,0
18,1,2,13,9,4,0,1.10978096514009,1,0
18,1,2,8,13,-5,1,1.14887806738261,3,0
18,1,10,9,20,-11,1,1.51437536312733,10,0
18,1,10,2,16,-14,1,1.23272601317149,6,0
18,1,10,15,2,13,0,1.17869620129932,8,0
18,1,10,20,1,19,0,1.3906557848677,9,0
18,1,10,20,5,15,0,1.30313019477762,5,0
18,1,10,1,16,-15,1,1.39775925048161,6,0
18,1,10,12,2,10,0,1.17644188913982,8,0
18,1,2,18,9,9,0,0.892312429379672,1,0
18,1,2,4,13,-9,1,1.65951493801549,3,0
18,1,2,13,9,4,0,1.97215906274505,1,0
18,1,2,20,4,16,0,0.952198687475175,6,0
18,1,10,18,8,10,0,1.35697636276018,2,0
18,1,10,6,19,-13,1,1.79346432781313,9,0
18,1,2,13,9,4,1,1.74881758587435,-1,0
18,1,10,11,0,11,0,1.40070671762805,10,0
18,1,10,11,10,1,0,2.77996777975932,0,0
18,1,2,7,15,-8,1,1.73593904927839,5,0
18,1,10,13,9,4,0,1.82917189772706,1,0
18,1,2,17,1,16,0,1.67832433129661,9,0
18,1,2,18,5,13,0,1.90980699053034,5,0
18,1,2,20,0,20,0,1.97892969660461,10,0
18,1,2,10,9,1,NaN,NaN,0,0
18,1,10,5,12,-7,0,1.04289937519934,-2,0
18,1,10,17,3,14,0,1.17212020792067,7,0
18,1,2,11,0,11,0,1.61545175127685,10,0
18,1,10,9,20,-11,1,1.24938409624156,10,0
18,1,10,9,12,-3,1,1.47413460991811,2,0
18,1,10,20,3,17,0,1.5378279061988,7,0
18,1,10,1,11,-10,0,1.5913379433332,-1,0
18,1,2,18,4,14,0,1.57859943073709,6,0
18,1,2,7,16,-9,1,1.44590622419491,6,0
18,1,2,0,14,-14,0,1.80645612976514,-4,0
18,1,10,10,20,-10,0,1.7929962372873,-10,0
18,1,2,2,15,-13,1,1.21230817725882,5,0
18,1,2,1,16,-15,1,1.18237714457791,6,0
18,1,10,6,10,-4,0,1.51358727028128,0,0
18,1,2,2,16,-14,1,1.57560907665174,6,0
18,1,2,10,1,9,0,0.947591459960677,9,0
18,1,10,11,3,8,0,1.33603618631605,7,0
18,1,2,19,4,15,0,1.18941609642934,6,0
18,1,10,19,1,18,0,2.09678733046167,9,0
18,1,10,15,9,6,1,1.17538327886723,-1,0
18,1,2,1,11,-10,0,1.25126305618323,-1,0
18,1,10,12,2,10,0,1.69191435084213,8,0
18,1,2,2,16,-14,1,1.06583984126337,6,0
18,1,2,11,0,11,0,1.65775767422747,10,0
18,1,10,10,10,0,0,2.08212513814215,0,0
18,1,2,11,1,10,0,1.18570546223782,9,0
18,1,10,6,16,-10,1,2.03697145078331,6,0
18,1,2,3,17,-14,1,1.59027236851398,7,0
18,1,10,8,13,-5,1,2.03345729003195,3,0
18,1,2,0,12,-12,0,1.45074987958651,-2,0
18,1,10,6,19,-13,1,1.92343183269259,9,0
18,1,10,10,18,-8,1,1.77737550425809,8,0
18,1,2,2,16,-14,0,1.12465282680932,-6,0
18,1,2,10,10,0,1,1.93865082168486,0,0
18,1,10,19,4,15,0,1.35989267274272,6,0
18,1,10,11,10,1,0,1.89245978440158,0,0
18,1,2,13,9,4,NaN,NaN,0,0
18,1,10,2,11,-9,1,1.20046369184274,1,0
18,1,2,18,8,10,0,1.0350448389072,2,0
18,1,10,9,17,-8,1,1.41234263335355,7,0
18,1,10,10,4,6,0,1.70215076033492,6,0
18,1,2,17,3,14,0,1.52488852152601,7,0
18,1,10,18,7,11,1,1.49818683660123,-3,0
18,1,2,10,15,-5,1,1.54480344417971,5,0
18,1,2,20,0,20,0,1.40609104116447,10,0
18,1,10,20,6,14,0,1.80869064782746,4,0
18,1,10,18,4,14,0,1.58735056023579,6,0
18,1,2,10,20,-10,1,1.69456747442018,10,0
18,1,2,2,11,-9,0,1.35773916321341,-1,0
18,1,10,19,5,14,1,1.96249191288371,-5,0
18,1,10,8,14,-6,1,1.7023340377491,4,0
18,1,2,8,12,-4,1,1.11693721462507,2,0
18,1,10,14,8,6,0,1.33035055466462,2,0
18,1,10,20,1,19,0,1.41565005748998,9,0
18,1,2,3,13,-10,1,1.82487770810258,3,0
18,1,10,10,15,-5,1,1.28218598617241,5,0
18,1,10,18,5,13,0,0.889714655349962,5,0
18,1,2,16,6,10,0,1.84014068369288,4,0
18,1,10,20,3,17,0,1.12072482542135,7,0
18,1,2,5,13,-8,1,1.42052670265548,3,0
18,1,2,2,11,-9,0,1.22989401069935,-1,0
18,1,2,8,14,-6,1,1.58326274098363,4,0
18,1,10,13,8,5,0,1.07780565635767,2,0
18,1,10,8,13,-5,0,0.877120565390214,-3,0
18,1,10,1,14,-13,1,1.11630014237016,4,0
18,1,10,13,9,4,1,1.59359958651476,-1,0
18,1,2,10,9,1,0,0.796148242079653,1,0
18,1,2,2,15,-13,1,1.15088898700196,5,0
18,1,2,11,3,8,0,0.866749630309641,7,0
18,1,2,15,4,11,0,0.658922585542314,6,0
18,1,2,14,7,7,0,1.75484741234686,3,0
18,1,10,0,12,-12,1,2.41539053665474,2,0
18,1,2,5,15,-10,1,1.35996561706997,5,0
18,1,2,7,16,-9,1,0.851961709675379,6,0
18,1,10,1,15,-14,0,1.35588439600542,-5,0
18,1,2,2,11,-9,1,1.75182040280197,1,0
18,1,2,17,5,12,0,1.37184199283365,5,0
18,1,10,14,1,13,0,0.927061458351091,9,0
18,1,10,10,18,-8,1,1.61299839999992,8,0
18,1,2,15,9,6,0,1.15099418838508,1,0
18,1,10,2,17,-15,1,2.00288808532059,7,0
18,1,10,6,11,-5,0,1.80486051668413,-1,0
18,1,10,6,16,-10,1,2.022022979334,6,0
18,1,2,17,1,16,0,1.63212926196866,9,0
18,1,2,2,11,-9,NaN,NaN,0,0
18,1,2,10,17,-7,1,1.18924015027005,7,0
18,1,10,0,20,-20,1,1.07922532304656,10,0
18,1,2,14,1,13,0,1.10993968334515,9,0
18,1,10,20,3,17,0,1.27653664362151,7,0
18,1,2,3,17,-14,1,0.84368563524913,7,0
18,1,10,20,5,15,0,0.900482202880085,5,0
18,1,10,3,20,-17,1,0.922301744227298,10,0
18,1,10,2,11,-9,0,0.951012516045012,-1,0
18,1,10,0,12,-12,0,1.27500920963939,-2,0
18,1,2,16,3,13,1,1.53015481447801,-7,0
18,1,10,0,19,-19,1,1.10289889865089,9,0
18,1,2,4,12,-8,0,1.00501263700426,-2,0
18,1,2,17,5,12,0,1.60684541100636,5,0
18,1,10,0,20,-20,1,1.44070077955257,10,0
18,1,2,0,15,-15,1,1.72189853398595,5,0
18,1,10,6,17,-11,1,1.28718799317721,7,0
18,1,2,19,4,15,0,1.13450691965409,6,0
18,1,10,2,11,-9,0,1.24715544306673,-1,0
18,1,2,11,7,4,0,1.39101464208215,3,0
18,1,10,15,8,7,0,0.505667120567523,2,0
18,1,10,8,18,-10,1,0.871530238073319,8,0
18,1,10,11,1,10,0,0.942793624126352,9,0
18,1,2,6,17,-11,0,0.923133823671378,-7,0
18,1,2,4,13,-9,1,1.32067240809556,3,0
18,1,2,9,15,-6,1,0.510776527924463,5,0
18,1,10,6,13,-7,1,0.740716724540107,3,0
18,1,2,11,9,2,0,0.689266358851455,1,0
18,1,10,6,10,-4,0,1.22331545152701,0,0
18,1,2,2,11,-9,1,0.976517766015604,1,0
18,1,10,11,6,5,0,1.49180365120992,4,0
18,1,2,1,12,-11,1,1.06649817363359,2,0
18,1,2,5,17,-12,1,0.921673835837282,7,0
18,1,10,14,0,14,0,0.887075827340595,10,0
18,1,10,3,14,-11,0,1.50164161564317,-4,0
18,1,2,11,1,10,0,1.32359714887571,9,0
18,1,10,0,12,-12,0,1.56879995460622,-2,0
18,1,2,6,16,-10,1,1.82015391637105,6,0
18,1,10,7,20,-13,1,0.940892304410227,10,0
18,1,2,9,20,-11,1,1.13002981932368,10,0
18,1,10,18,4,14,0,1.04674746759702,6,0
18,1,2,1,10,-9,0,1.23077410878614,0,0
18,1,2,7,18,-11,1,1.09528298943769,8,0
18,1,2,18,10,8,0,1.10993895027786,0,0
18,1,10,8,15,-7,1,1.85985510086175,5,0
18,1,2,18,1,17,0,1.05965092976112,9,0
18,1,10,2,11,-9,0,1.57966647180729,-1,0
18,1,10,13,6,7,0,1.22307279228698,4,0
18,1,10,13,9,4,0,0.679051209590398,1,0
18,1,2,2,11,-9,0,1.09367931226734,-1,0
18,1,10,4,16,-12,1,0.948908491409384,6,0
18,1,2,2,20,-18,1,0.816865186672658,10,0
18,1,2,18,5,13,0,0.906194959534332,5,0
18,1,2,20,5,15,0,1.80810379376635,5,0
18,1,10,10,3,7,0,1.37812107673381,7,0
18,1,10,1,14,-13,1,1.13275955291465,4,0
18,1,10,0,16,-16,0,1.17725637392141,-6,0
18,1,2,9,18,-9,1,1.21262598026078,8,0
19,1,10,10,20,-10,1,1.71200476517765,10,0
19,1,2,20,8,12,1,1.63711780068729,-2,0
19,1,10,15,0,15,0,2.19042932416937,10,0
19,1,10,6,20,-14,0,1.95369603665517,-10,0
19,1,10,10,9,1,0,2.57426217640318,1,0
19,1,2,0,14,-14,NaN,NaN,0,0
19,1,10,16,9,7,1,1.23956563573893,-1,0
19,1,2,11,8,3,1,1.41748013745701,-2,0
19,1,2,1,17,-16,0,1.44327441008022,-7,0
19,1,2,10,16,-6,0,1.70869113402046,-6,0
19,1,10,5,11,-6,0,0.97949580756017,-1,0
19,1,10,11,5,6,0,1.29460087056123,5,0
19,1,10,6,17,-11,0,0.981152989690599,-7,0
19,1,2,11,0,11,NaN,NaN,0,0
19,1,10,10,12,-2,0,0.813795922107829,-2,0
19,1,2,20,0,20,1,0.951911294387173,-10,0
19,1,2,1,20,-19,0,1.42045177548675,-10,0
19,1,2,17,3,14,1,0.998246048110104,-7,0
19,1,2,20,3,17,1,0.977595967926618,-7,0
19,1,10,10,20,-10,0,1.11770208476514,-10,0
19,1,2,9,19,-10,0,1.51927019473078,-9,0
19,1,10,12,2,10,0,1.10159431844227,8,0
19,1,10,17,9,8,1,1.07599358533798,-1,0
19,1,10,11,1,10,0,1.67609402061862,9,0
19,1,2,13,0,13,0,1.60380701030931,10,0
19,1,2,9,16,-7,0,1.6946327605956,-6,0
19,1,10,11,4,7,0,1.43776953035513,6,0
19,1,2,12,8,4,NaN,NaN,0,0
19,1,2,2,16,-14,0,0.963584879725204,-6,0
19,1,10,17,6,11,1,1.15963124856808,-4,0
19,1,2,11,5,6,0,0.831559037800616,5,0
19,1,2,10,8,2,0,1.30488302405502,2,0
19,1,10,18,10,8,1,0.775464833905971,0,0
19,1,10,18,7,11,1,0.699456586483393,-3,0
19,1,10,11,1,10,0,1.03404352806433,9,0
19,1,2,17,6,11,1,0.811308132875183,-4,0
19,1,2,7,19,-12,0,1.12528604810996,-9,0
19,1,10,12,2,10,0,1.25121063001166,8,0
19,1,2,4,12,-8,0,0.939786483390662,-2,0
19,1,10,8,17,-9,0,1.12114914089352,-7,0
19,1,2,15,0,15,NaN,NaN,0,0
19,1,10,17,6,11,1,1.17282749140895,-4,0
19,1,2,10,9,1,0,1.37670268041234,1,0
19,1,10,9,20,-11,1,1.34065887743418,10,0
19,1,2,11,1,10,NaN,NaN,0,0
19,1,10,8,10,-2,1,1.04651839633448,0,0
19,1,10,16,8,8,1,1.64715179839618,-2,0
19,1,2,9,14,-5,0,0.999730584192321,-4,0
19,1,2,1,18,-17,0,1.25035473081334,-8,0
19,1,10,0,17,-17,0,1.03501928980518,-7,0
19,1,10,9,10,-1,0,0.86763729667814,0,0
19,1,2,15,7,8,1,1.0835405269188,-3,0
19,1,2,5,14,-9,0,0.994844810996483,-4,0
19,1,10,8,10,-2,0,1.36546309278356,0,0
19,1,10,17,10,7,1,1.15342258877422,0,0
19,1,2,17,6,11,1,1.08585713631169,-4,0
19,1,2,4,12,-8,0,1.2373054753723,-2,0
19,1,2,4,10,-6,0,0.942649255440983,0,0
19,1,10,12,2,10,0,1.37981397479939,8,0
19,1,10,11,4,7,0,1.03120311569319,6,0
19,1,2,12,7,5,0,1.24714923253146,3,0
19,1,10,19,0,19,1,0.77581855670087,-10,0
19,1,2,6,19,-13,0,1.68370987399771,-9,0
19,1,10,10,8,2,0,1.010944879725,2,0
19,1,2,7,13,-6,0,1.4769125315006,-3,0
19,1,10,11,4,7,0,1.10873512027501,6,0
19,1,2,16,1,15,1,0.811509736540756,-9,0
19,1,10,10,20,-10,0,0.781434135166137,-10,0
19,1,2,20,7,13,1,0.784765360824849,-3,0
19,1,10,12,8,4,0,0.940088888888795,2,0
19,1,10,10,17,-7,0,1.59265759450182,-7,0
19,1,2,19,5,14,1,0.571919541809848,-5,0
19,1,2,11,1,10,0,0.815836151202802,9,0
19,1,2,2,15,-13,1,0.961813333333339,5,0
19,1,10,3,15,-12,0,1.31778712485698,-5,0
19,1,2,15,8,7,1,0.691743963344834,-2,0
19,1,10,15,0,15,1,0.826925452462774,-10,0
19,1,2,10,8,2,0,0.932773974799602,2,0
19,1,10,12,7,5,0,1.0262729896906,3,0
19,1,10,4,20,-16,0,0.948201786941581,-10,0
19,1,10,11,5,6,0,0.974582176403146,5,0
19,1,10,13,6,7,0,1.00256183276065,4,0
19,1,10,11,4,7,0,0.989181947308225,6,0
19,1,2,18,10,8,1,0.832423367697629,0,0
19,1,10,4,15,-11,0,1.16973085910649,-5,0
19,1,2,5,14,-9,0,0.965669461626703,-4,0
19,1,2,10,10,0,0,0.601537319587578,0,0
19,1,2,1,18,-17,0,0.860175761741175,-8,0
19,1,10,9,20,-11,0,0.732897869415865,-10,0
19,1,2,18,1,17,1,1.47418538373404,-9,0
19,1,2,7,11,-4,0,0.969483436426117,-1,0
19,1,2,0,14,-14,0,0.813363024054979,-4,0
19,1,10,10,12,-2,0,1.2153189461626,-2,0
19,1,10,13,0,13,0,1.28924957617414,10,0
19,1,10,15,9,6,1,1.36858868270315,-1,0
19,1,2,16,5,11,1,0.780467537227878,-5,0
19,1,10,11,1,10,0,1.10380719358545,9,0
19,1,2,11,2,9,0,0.878436288659714,8,0
19,1,10,4,19,-15,0,0.837717846506393,-9,0
19,1,2,10,9,1,0,1.5829509278351,1,0
19,1,2,11,8,3,0,1.297627491409,2,0
19,1,10,3,16,-13,0,1.0962774799541,-6,0
19,1,10,8,14,-6,0,1.46291134020612,-4,0
19,1,10,11,1,10,0,1.15071266895757,9,0
19,1,2,2,15,-13,0,0.84342323024066,-5,0
19,1,2,17,1,16,1,1.2766482474226,-9,0
19,1,10,10,5,5,0,0.947949232531528,5,0
19,1,10,8,10,-2,0,1.16053406643755,0,0
19,1,2,12,5,7,0,1.15650675830466,5,0
19,1,2,16,5,11,1,0.681179198167229,-5,0
19,1,10,20,6,14,1,0.855787399771089,-4,0
19,1,10,18,7,11,1,1.07230643757157,-3,0
19,1,2,9,18,-9,1,1.83170492554405,8,0
19,1,2,6,12,-6,0,1.48101388316149,-2,0
19,1,2,13,0,13,1,1.55219134020626,-10,0
19,1,10,12,5,7,0,1.58889273768614,5,0
19,1,10,1,15,-14,0,0.872150286368878,-5,0
19,1,2,9,10,-1,0,1.11144943871705,0,0
19,1,2,19,4,15,1,0.918013654066499,-6,0
19,1,10,10,9,1,0,1.39590854524613,1,0
19,1,10,9,18,-9,0,1.15032045819021,-8,0
19,1,2,11,1,10,0,0.962974570446704,9,0
19,1,2,15,7,8,1,1.04627207331032,-3,0
19,1,2,12,7,5,0,1.6308746849943,3,0
19,1,10,17,8,9,1,0.631484261168453,-2,0
19,1,10,16,0,16,0,1.35999963344807,10,0
19,1,2,13,6,7,1,1.62061452462785,-4,0
19,1,10,2,18,-16,0,0.766794776632423,-8,0
19,1,2,17,2,15,1,1.09793026345938,-8,0
19,1,10,9,11,-2,0,1.48063706758307,-1,0
19,1,10,11,2,9,0,1.21450300114543,8,0
19,1,10,9,20,-11,0,1.10380939289803,-10,0
19,1,2,0,12,-12,0,1.48579665521197,-2,0
19,1,10,5,17,-12,0,1.2049532187857,-7,0
19,1,2,10,8,2,0,1.07092746849958,2,0
19,1,2,3,10,-7,0,0.846927101947358,0,0
19,1,10,1,14,-13,0,0.934887880870519,-4,0
19,1,10,10,20,-10,0,0.915416632302595,-10,0
19,1,2,17,5,12,1,0.944716242840741,-5,0
19,1,2,10,9,1,0,0.748681237113487,1,0
19,1,2,18,7,11,1,0.672712577319771,-3,0
19,1,10,11,8,3,0,0.976000000000113,2,0
19,1,10,19,6,13,1,1.37912558991979,-4,0
19,1,2,18,4,14,1,0.694434089346942,-6,0
19,1,2,9,18,-9,0,0.909293012600074,-8,0
19,1,2,17,6,11,1,0.810311111111105,-4,0
19,1,10,4,13,-9,0,0.660440412371145,-3,0
19,1,10,12,2,10,0,1.10098254295531,8,0
19,1,10,1,19,-18,0,1.81958854524623,-9,0
19,1,2,12,7,5,0,0.612866712485584,3,0
19,1,2,11,8,3,0,1.27748471935843,2,0
19,1,2,1,19,-18,0,0.772240274914111,-9,0
19,1,10,18,6,12,1,0.648337594501754,-4,0
19,1,2,9,20,-11,0,0.768121695303535,-10,0
19,1,2,11,2,9,0,1.27599358533803,8,0
19,1,10,10,8,2,0,1.36397965635729,2,0
19,1,10,18,5,13,1,0.895847880870633,-5,0
19,1,10,1,12,-11,0,0.757902588774186,-2,0
19,1,2,14,3,11,1,1.20989873997701,-7,0
19,1,10,1,18,-17,0,1.09176742268028,-8,0
19,1,10,10,9,1,0,1.62005333333332,1,0
19,1,2,13,7,6,1,0.989387583047119,-3,0
19,1,2,4,19,-15,0,0.904734570446635,-9,0
19,1,10,0,18,-18,0,0.678918671248539,-8,0
19,1,10,11,9,2,0,0.885278717067649,1,0
19,1,10,12,8,4,0,1.33982753722785,2,0
19,1,10,16,0,16,1,0.993201191294474,-10,0
19,1,2,2,18,-16,0,1.20442135166127,-8,0
19,1,2,5,15,-10,0,1.23111514318452,-5,0
19,1,2,9,20,-11,0,1.27974378006911,-10,0
19,1,10,17,8,9,1,0.669646368843132,-2,0
19,1,10,7,15,-8,0,1.33356975945026,-5,0
19,1,10,10,19,-9,0,0.826232302405515,-9,0
19,1,2,11,5,6,0,1.42744485681578,5,0
19,1,2,0,11,-11,0,0.940779106529135,-1,0
19,1,2,16,0,16,1,1.06536980526926,-10,0
19,1,2,18,8,10,1,0.86463963344795,-2,0
19,1,2,1,20,-19,0,0.77655825887723,-10,0
19,1,10,10,14,-4,0,1.81189828178685,-4,0
19,1,10,9,18,-9,0,1.14983697594516,-8,0
19,1,10,0,14,-14,0,0.761109186712474,-4,0
19,1,2,19,4,15,1,0.813031660939487,-6,0
19,1,2,10,9,1,0,0.790450950744344,1,0
19,1,2,13,6,7,0,1.46481557846528,4,0
19,1,10,9,20,-11,0,0.831844104161064,-10,0
19,1,2,5,16,-11,0,0.82492041237083,-6,0
19,1,10,12,10,2,0,1.06684957617426,0,0
19,1,10,5,18,-13,0,1.99412343642643,-8,0
19,1,10,14,7,7,1,0.876654112256347,-3,0
19,1,2,6,13,-7,0,0.740057731958586,-3,0
19,1,10,13,3,10,1,0.704663825887565,-7,0
19,1,10,11,1,10,0,0.742575578464766,9,0
19,1,10,1,17,-16,0,0.747248384880095,-7,0
19,1,2,9,18,-9,0,0.591248934707892,-8,0
19,1,10,1,20,-19,0,0.577820664375849,-10,0
19,1,10,3,14,-11,0,0.557203940435556,-4,0
19,1,2,10,8,2,NaN,NaN,0,0
19,1,2,15,1,14,0,1.10897521191282,9,0
19,1,2,11,10,1,1,0.962937915234761,0,0
19,1,2,6,16,-10,0,0.653581122565811,-6,0
20,1,2,20,8,12,1,1.07777229982003,-2,0
20,1,10,1,17,-16,0,1.19638686927374,-7,0
20,1,2,15,0,15,0,1.84709716084944,10,0
20,1,10,11,0,11,1,2.1681760782667,-10,0
20,1,10,11,8,3,0,0.252127759012183,2,0
20,1,2,20,0,20,0,0.236798070455734,10,0
20,1,10,10,12,-2,1,1.01476079549684,2,0
20,1,10,10,20,-10,1,1.04159700598029,10,0
20,1,2,10,16,-6,1,0.683679697079242,6,0
20,1,2,10,9,1,0,0.35508787235176,1,0
20,1,10,0,14,-14,0,0.951761387484112,-4,0
20,1,2,5,11,-6,1,0.268529620378104,1,0
20,1,2,17,3,14,0,0.276650275557586,7,0
20,1,2,6,20,-14,0,0.645327434243882,-10,0
20,1,2,20,3,17,0,0.214836305786775,7,0
20,1,10,6,17,-11,1,0.192859878926356,7,0
20,1,10,11,5,6,0,0.340854915774798,5,0
20,1,10,10,20,-10,1,0.194390978353113,10,0
20,1,2,1,20,-19,1,0.29365255369612,10,0
20,1,10,16,9,7,0,0.421074335482444,1,0
20,1,2,3,18,-15,1,0.327305217357207,8,0
20,1,2,17,3,14,1,0.39722811255433,-7,0
20,1,2,0,18,-18,0,0.752007712312661,-8,0
20,1,10,10,10,0,1,0.324879357649479,0,0
20,1,10,6,17,-11,1,1.36271147921343,7,0
20,1,10,8,16,-8,0,0.222855058730602,-6,0
20,1,2,9,16,-7,1,0.345105118754873,6,0
20,1,10,17,5,12,0,0.414445191809136,5,0
20,1,2,9,15,-6,1,0.472429030407511,5,0
20,1,10,19,3,16,0,0.776385439709884,7,0
20,1,2,15,0,15,1,0.491942208969704,-10,0
20,1,10,16,1,15,0,0.403053768091922,9,0
20,1,2,1,11,-10,1,0.830255800271516,1,0
20,1,10,12,9,3,1,0.551393366456978,-1,0
20,1,10,3,12,-9,0,0.468296858075519,-2,0
20,1,2,11,1,10,0,1.18836005212415,9,0
20,1,2,20,3,17,0,0.583667050937947,7,0
20,1,10,19,7,12,1,0.402986688562123,-3,0
20,1,10,5,13,-8,1,0.581780759905087,3,0
20,1,2,9,16,-7,0,0.67317900154103,-6,0
20,1,10,16,9,7,1,1.62164139576726,-1,0
20,1,10,0,13,-13,0,0.487250307447539,-3,0
20,1,10,12,6,6,1,0.366600992264466,-4,0
20,1,2,15,1,14,0,0.330728106139759,9,0
20,1,2,19,9,10,0,0.472077504347908,1,0
20,1,2,1,20,-19,1,0.688118675784608,10,0
20,1,2,14,0,14,NaN,NaN,0,0
20,1,10,11,5,6,1,4.34026659531082,-5,0
20,1,10,5,18,-13,1,1.73784806669846,8,0
20,1,2,13,0,13,0,1.43148339231811,10,0
20,1,10,1,11,-10,1,4.26390589805033,1,0
20,1,10,11,4,7,0,1.09615025814674,6,0
20,1,10,16,9,7,0,2.36677730512565,1,0
20,1,10,19,9,10,0,0.95501162895107,1,0
20,1,2,9,15,-6,0,0.239711814610928,-5,0
20,1,2,4,12,-8,0,0.80775849903057,-2,0
20,1,10,10,18,-8,1,0.194566191550621,8,0
20,1,2,18,2,16,1,0.645361890396089,-8,0
20,1,2,10,4,6,1,0.278021923642882,-6,0
20,1,2,0,10,-10,1,0.493227716675392,0,0
20,1,10,13,0,13,1,0.204193020430466,-10,0
20,1,2,12,0,12,NaN,NaN,0,0
20,1,2,20,3,17,1,0.115730149682349,-7,0
20,1,2,8,18,-10,1,0.657673366677955,8,0
20,1,10,17,3,14,1,0.594271114930962,-7,0
20,1,2,13,8,5,0,1.59784722362292,2,0
20,1,10,9,12,-3,0,0.504590182563334,-2,0
20,1,2,14,4,10,1,0.423335978637624,-6,0
20,1,10,0,12,-12,0,0.313491966035144,-2,0
20,1,10,8,14,-6,1,4.63152664578502,4,0
20,1,10,8,17,-9,1,0.760428575879814,7,0
20,1,2,12,2,10,1,0.33217233207688,-8,0
20,1,2,0,12,-12,1,1.41780869871218,2,0
20,1,10,5,11,-6,0,0.627890788661716,-1,0
20,1,2,6,17,-11,1,0.749920182691312,7,0
20,1,2,20,0,20,1,0.546903803189707,-10,0
20,1,10,11,5,6,1,0.327577567578373,-5,0
20,1,10,16,1,15,1,1.45306467309729,-9,0
20,1,2,13,2,11,1,0.380686227253136,-8,0
20,1,10,18,3,15,1,1.70431233401905,-7,0
20,1,2,10,13,-3,1,1.58273380240098,3,0
20,1,2,6,13,-7,NaN,NaN,0,0
20,1,10,16,1,15,1,0.287032940447716,-9,0
20,1,10,11,10,1,0,0.50228565249472,0,0
20,1,2,2,17,-15,0,0.381108498389949,-7,0
20,1,10,8,12,-4,0,1.08875134937989,-2,0
20,1,10,20,3,17,0,0.215780184413234,7,0
20,1,2,1,20,-19,0,0.154191645850005,-10,0
20,1,2,11,5,6,1,0.262586667302457,-5,0
20,1,10,13,0,13,1,0.350860029214346,-10,0
20,1,10,8,10,-2,1,0.651059984860694,0,0
20,1,2,11,5,6,1,0.49162807149969,-5,0
20,1,2,5,18,-13,1,0.115093443984733,8,0
20,1,2,16,3,13,1,0.249181391478487,-7,0
20,1,10,11,4,7,1,0.265956405636643,-6,0
20,1,2,3,10,-7,0,0.185678337160425,0,0
20,1,10,17,3,14,1,0.197340644880569,-7,0
20,1,10,14,5,9,0,0.152196854593058,5,0
20,1,10,11,1,10,0,0.132801340124388,9,0
20,1,2,16,0,16,1,0.274222949629802,-10,0
20,1,2,10,16,-6,1,1.98484332531189,6,0
20,1,10,13,0,13,0,0.300338513363386,10,0
20,1,2,4,14,-10,1,0.187274683342366,4,0
20,1,2,13,3,10,0,0.182498107660649,7,0
20,1,10,6,15,-9,0,0.138064700588075,-5,0
20,1,10,14,10,4,0,0.31927913331765,0,0
20,1,2,20,0,20,1,1.70154741111492,-10,0
20,1,10,5,16,-11,1,1.23587141990538,6,0
20,1,10,11,9,2,1,0.589464115200826,-1,0
20,1,2,11,1,10,0,0.137114223975914,9,0
20,1,10,17,1,16,0,1.86103394114161,9,0
20,1,2,12,0,12,1,0.253183070299201,-10,0
20,1,2,7,10,-3,0,0.397128776201498,0,0
20,1,2,13,8,5,1,0.271859037683498,-2,0
20,1,10,19,3,16,1,0.511256714825322,-7,0
20,1,10,17,5,12,0,0.246105630099009,5,0
20,1,10,0,12,-12,0,0.365972717326258,-2,0
20,1,2,13,7,6,0,0.209686577312823,3,0
20,1,10,5,17,-12,1,0.124371312687799,7,0
20,1,2,10,17,-7,1,0.409566713890854,7,0
20,1,10,18,10,8,1,1.06628887084662,0,0
20,1,2,2,11,-9,1,0.274240910815024,1,0
20,1,10,0,12,-12,0,0.298515269757445,-2,0
20,1,2,8,10,-2,0,0.208616970387993,0,0
20,1,2,6,13,-7,1,0.242618960780419,3,0
20,1,2,10,12,-2,0,0.411403886580047,-2,0
20,1,10,16,9,7,1,4.18871011196461,-1,0
20,1,2,18,6,12,1,0.247579180419962,-4,0
20,1,10,20,4,16,0,0.247673751559887,6,0
20,1,10,12,1,11,1,0.399701990942049,-9,0
20,1,10,0,12,-12,1,0.136948907757869,2,0
20,1,2,11,9,2,0,0.142051717218237,1,0
20,1,10,8,17,-9,0,0.258818850447824,-7,0
20,1,10,1,17,-16,0,0.202708106909085,-7,0
20,1,2,12,8,4,0,0.516707018241505,2,0
20,1,2,17,5,12,1,0.250152761715981,-5,0
20,1,10,10,13,-3,0,0.434348018130549,-3,0
20,1,10,14,0,14,0,0.410682506721059,10,0
20,1,2,7,13,-6,0,0.316867569246824,-3,0
20,1,2,3,19,-16,1,0.427056143366826,9,0
20,1,10,2,11,-9,0,0.203888413386267,-1,0
20,1,10,15,1,14,1,0.486445353093586,-9,0
20,1,2,20,0,20,0,0.381975767061704,10,0
20,1,10,15,9,6,1,0.673140513286853,-1,0
20,1,2,19,9,10,1,0.312956429462247,-1,0
20,1,10,2,16,-14,0,0.198027202031881,-6,0
20,1,10,8,12,-4,1,0.224172823259323,2,0
20,1,2,15,8,7,0,0.105650259062713,2,0
20,1,2,4,14,-10,0,0.567566131068816,-4,0
20,1,2,1,12,-11,1,0.211226840609015,2,0
20,1,2,13,6,7,0,0.747761174881816,4,0
20,1,10,18,2,16,1,0.376011187252516,-8,0
20,1,2,3,10,-7,1,0.363137049344004,0,0
20,1,10,16,7,9,0,0.319295261729167,3,0
20,1,10,0,12,-12,0,0.108786501985378,-2,0
20,1,10,8,17,-9,0,0.226764365740564,-7,0
20,1,2,20,7,13,0,0.15624728520379,3,0
20,1,2,1,12,-11,1,0.192251031393425,2,0
20,1,2,18,9,9,0,0.170986453967089,1,0
20,1,10,13,8,5,0,0.230336808883294,2,0
20,1,10,13,9,4,0,0.265752967719891,1,0
20,1,2,20,6,14,1,0.209184763783014,-4,0
20,1,10,1,13,-12,0,0.331268407924654,-3,0
20,1,2,10,18,-8,0,0.136214698481126,-8,0
20,1,2,10,8,2,1,0.508633282076516,-2,0
20,1,10,13,0,13,0,0.162788455722875,10,0
20,1,2,11,0,11,0,0.217462670974783,10,0
20,1,2,3,18,-15,1,0.423622257941133,8,0
20,1,10,10,5,5,1,0.417237606323397,-5,0
20,1,10,6,18,-12,1,0.202447486441997,8,0
20,1,2,2,11,-9,1,0.283245696188715,1,0
20,1,2,20,4,16,0,0.281923533001645,6,0
20,1,2,10,12,-2,0,0.280576077533624,-2,0
20,1,2,5,16,-11,0,0.191308985541582,-6,0
20,1,2,16,2,14,1,0.153969513637094,-8,0
20,1,10,14,7,7,1,0.198093181898003,-3,0
20,1,10,4,11,-7,0,0.368116329833356,-1,0
20,1,10,13,9,4,0,0.291470819488495,1,0
20,1,10,12,5,7,0,0.154444935220454,5,0
20,1,10,4,14,-10,1,0.230257999600326,4,0
20,1,2,16,1,15,1,0.254445485052202,-9,0
20,1,2,20,0,20,1,0.406380986069053,-10,0
20,1,2,11,5,6,1,0.456555374517848,-5,0
20,1,10,18,2,16,1,0.264861506430861,-8,0
20,1,2,10,6,4,0,0.288024104644137,4,0
20,1,2,5,20,-15,1,0.150936639169231,10,0
20,1,10,15,6,9,0,1.21792489658583,4,0
20,1,10,12,8,4,1,0.419513545116388,-2,0
20,1,10,2,11,-9,1,0.293099789048028,1,0
20,1,10,8,12,-4,0,0.395853165476183,-2,0
20,1,10,18,0,18,0,1.492464183013,10,0
20,1,2,14,5,9,1,0.243478531800974,-5,0
20,1,10,7,18,-11,0,0.203995813944857,-8,0
20,1,10,11,5,6,0,0.349943275644364,5,0
20,1,2,2,17,-15,1,0.242132175998449,7,0
20,1,2,10,15,-5,1,0.146566939322838,5,0
20,1,10,1,11,-10,1,0.214254949863971,1,0
20,1,10,2,11,-9,1,0.3355772596733,1,0
20,1,2,0,10,-10,1,0.316052717911589,0,0
20,1,2,8,20,-12,0,0.401616873250532,-10,0
21,1,2,11,5,6,0,1.32338528025866,5,0
21,1,10,17,3,14,1,1.05694795471584,-7,0
21,1,2,10,20,-10,0,1.51373645809088,-10,0
21,1,2,20,8,12,1,1.31973512749698,-2,0
21,1,10,6,17,-11,1,1.83852051149051,7,0
21,1,2,20,3,17,1,1.25602093761051,-7,0
21,1,10,10,12,-2,1,1.4253809879018,2,0
21,1,10,15,0,15,0,1.92418290351725,10,0
21,1,2,16,9,7,1,0.978322315306741,-1,0
21,1,10,0,14,-14,0,1.2703521308747,-4,0
21,1,10,1,20,-19,1,2.03845196574184,10,0
21,1,10,10,9,1,1,1.23988666125388,-1,0
21,1,2,1,17,-16,NaN,NaN,0,0
21,1,10,5,11,-6,0,1.84683727349204,-1,0
21,1,2,20,0,20,1,1.70353267194628,-10,0
21,1,10,10,16,-6,1,1.33431741080346,6,0
21,1,2,11,8,3,1,1.53166098812176,-2,0
21,1,2,11,0,11,0,1.00180601553097,10,0
21,1,2,10,20,-10,1,0.956548959809083,10,0
21,1,10,6,20,-14,1,1.40131739797414,10,0
21,1,2,12,8,4,1,0.886643292688518,-2,0
21,1,10,16,5,11,1,1.29418992304193,-5,0
21,1,2,11,6,5,0,1.18068952624617,4,0
21,1,10,6,10,-4,0,1.53634225955386,0,0
21,1,2,4,15,-11,0,1.81357352447935,-5,0
21,1,10,15,0,15,1,1.20796120383932,-10,0
21,1,10,6,20,-14,0,1.76273640494048,-10,0
21,1,2,17,9,8,1,1.36668456675977,-1,0
21,1,10,2,17,-15,0,1.62647662021811,-7,0
21,1,2,10,12,-2,1,1.07734599657999,2,0
21,1,10,8,14,-6,0,1.40558409592006,-4,0
21,1,2,10,12,-2,1,1.0250085682186,2,0
21,1,2,12,9,3,1,1.0991446443594,-1,0
21,1,10,11,7,4,1,1.45804028803877,-3,0
21,1,2,11,1,10,0,1.21061762652096,9,0
21,1,10,11,6,5,1,1.21347968644909,-4,0
21,1,2,15,8,7,1,1.19127452938949,-2,0
21,1,2,15,0,15,0,1.05083308743622,10,0
21,1,10,10,14,-4,1,1.2597238742643,4,0
21,1,10,5,18,-13,0,1.73154259091928,-8,0
21,1,2,4,14,-10,0,0.876708191217062,-4,0
21,1,10,10,16,-6,1,1.18068109548562,6,0
21,1,2,18,9,9,1,0.7119286097859,-1,0
21,1,2,11,0,11,0,0.98294053931204,10,0
21,1,10,10,1,9,0,1.43415264441808,9,0
21,1,10,5,13,-8,0,1.14781725776675,-3,0
21,1,10,5,19,-14,0,3.28847093495301,-9,0
21,1,10,11,1,10,0,1.43978219313408,9,0
21,1,2,2,19,-17,0,0.633423200353377,-9,0
21,1,2,14,4,10,0,1.18678459956629,6,0
21,1,10,1,20,-19,0,1.24612212506486,-10,0
21,1,10,0,20,-20,0,1.42282683401106,-10,0
21,1,10,14,6,8,1,1.56884907289123,-4,0
21,1,2,1,10,-9,0,1.17289987005631,0,0
21,1,2,10,1,9,0,0.72929194440826,9,0
21,1,2,6,11,-5,0,1.31850680234083,-1,0
21,1,10,2,17,-15,0,1.284408774589,-7,0
21,1,2,10,14,-4,1,1.79596936334929,4,0
21,1,10,2,13,-11,0,0.870760106374291,-3,0
21,1,2,17,3,14,1,1.85491247587618,-7,0
21,1,10,8,10,-2,1,1.29552381598216,0,0
21,1,2,12,9,3,NaN,NaN,0,0
21,1,2,3,17,-14,0,0.635170933670111,-7,0
21,1,10,9,12,-3,0,2.29251476757679,-2,0
21,1,10,10,1,9,0,1.23590331017317,9,0
21,1,10,15,0,15,1,1.21342140423474,-10,0
21,1,2,11,4,7,0,0.951467410528608,6,0
21,1,2,8,16,-8,0,1.19596569780117,-6,0
21,1,2,3,11,-8,0,1.51898845535629,-1,0
21,1,10,6,20,-14,0,1.41319084126167,-10,0
21,1,2,11,3,8,0,1.06245580723612,7,0
21,1,10,9,16,-7,1,1.32652079007221,6,0
21,1,2,10,14,-4,0,1.41266263578564,-4,0
21,1,10,10,7,3,0,1.58274736492922,3,0
21,1,2,8,10,-2,0,1.04210138539383,0,0
21,1,2,1,20,-19,0,0.963554188713488,-10,0
21,1,2,18,0,18,0,1.21546421417065,10,0
21,1,10,20,8,12,1,1.153802364645,-2,0
21,1,10,11,0,11,0,1.07841083829248,10,0
21,1,10,1,10,-9,0,1.78272060642826,0,0
21,1,10,11,2,9,0,0.997998610757236,8,0
21,1,2,10,14,-4,0,1.46490989166477,-4,0
21,1,2,10,19,-9,1,1.05695381959265,9,0
21,1,2,1,14,-13,0,0.505873857494407,-4,0
21,1,2,5,13,-8,1,1.0324232388416,3,0
21,1,10,11,4,7,0,0.889865309436345,6,0
21,1,2,11,0,11,0,0.825234365979327,10,0
21,1,10,1,12,-11,0,1.16337750929677,-2,0
21,1,10,20,2,18,0,2.86339235476646,8,0
21,1,10,12,8,4,1,1.48755308171792,-2,0
21,1,10,15,0,15,0,1.22945781045826,10,0
21,1,10,8,19,-11,1,1.63924885589086,9,0
21,1,10,6,13,-7,0,1.42454560949807,-3,0
21,1,2,16,3,13,0,1.53062730356794,7,0
21,1,10,10,12,-2,1,1.16816691439658,2,0
21,1,2,11,4,7,0,0.779960815291133,6,0
21,1,2,7,10,-3,0,1.31144842298954,0,0
21,1,2,19,7,12,1,0.845640105494454,-3,0
21,1,2,9,10,-1,1,1.27037119172462,0,0
21,1,10,18,8,10,1,1.19026430434315,-2,0
21,1,10,9,13,-4,0,1.0964702604922,-3,0
21,1,2,8,10,-2,0,0.943397339911598,0,0
21,1,10,12,1,11,0,1.06002921441814,9,0
21,1,2,18,8,10,1,0.932051368990642,-2,0
21,1,10,15,0,15,0,0.793501349838152,10,0
21,1,2,9,10,-1,0,1.2282525782548,0,0
21,1,10,5,11,-6,0,1.22102485058326,-1,0
21,1,2,20,9,11,1,1.35897408640813,-1,0
21,1,10,6,20,-14,0,1.95576416596873,-10,0
21,1,2,17,0,17,0,1.04850509786093,10,0
21,1,2,3,16,-13,0,1.2087819200508,-6,0
21,1,2,15,9,6,1,1.21156187170209,-1,0
21,1,2,11,6,5,0,1.17352081389822,4,0
21,1,10,2,20,-18,0,1.24958753420401,-10,0
21,1,2,0,11,-11,0,1.16227417932964,-1,0
21,1,10,4,11,-7,0,1.34257185848787,-1,0
21,1,10,15,8,7,1,1.61177997181198,-2,0
21,1,2,10,20,-10,0,0.749009293997233,-10,0
21,1,10,9,16,-7,1,0.873820839007294,6,0
21,1,10,20,2,18,1,1.38585391691299,-8,0
21,1,2,2,18,-16,0,0.868370169036552,-8,0
21,1,10,2,20,-18,0,1.05174800823283,-10,0
21,1,10,11,1,10,0,0.947808827006384,9,0
21,1,2,17,0,17,0,1.12047886719915,10,0
21,1,2,20,9,11,1,1.27026855637882,-1,0
21,1,2,0,16,-16,0,1.07732327018198,-6,0
21,1,10,1,16,-15,0,0.964699305928434,-6,0
21,1,2,11,2,9,0,1.5768733241573,8,0
21,1,10,20,8,12,0,1.29292567551465,2,0
21,1,10,10,16,-6,1,1.56431515649138,6,0
21,1,10,5,13,-8,0,1.23112416860795,-3,0
21,1,10,17,6,11,1,1.3598435544086,-4,0
21,1,10,2,18,-16,0,1.53974462126644,-8,0
21,1,2,10,16,-6,1,0.953184353241568,6,0
21,1,2,8,12,-4,1,1.32610475036699,2,0
21,1,2,20,8,12,1,1.15628504034862,-2,0
21,1,2,11,4,7,0,1.16009611067011,6,0
21,1,2,2,15,-13,0,1.19627800249623,-5,0
21,1,10,12,1,11,0,1.25507412654565,9,0
21,1,10,16,2,14,0,1.66424569435549,8,0
21,1,2,11,2,9,0,0.88661910007113,8,0
21,1,10,10,19,-9,1,1.12616816434866,9,0
21,1,2,2,20,-18,0,1.17203700004211,-10,0
21,1,10,13,10,3,1,1.05549346524413,0,0
21,1,10,14,0,14,0,0.896315574363825,10,0
21,1,2,10,15,-5,1,1.17517910784227,5,0
21,1,10,0,13,-13,0,0.882464567896022,-3,0
21,1,10,10,0,10,0,1.23322746008671,10,0
21,1,2,10,20,-10,0,1.22668885545113,-10,0
21,1,2,16,4,12,1,1.83659133354467,-6,0
21,1,10,14,2,12,0,1.46068094886368,8,0
21,1,2,4,10,-6,0,1.11691522137153,0,0
21,1,2,0,20,-20,0,1.10689764506856,-10,0
21,1,10,16,7,9,1,1.27299169203548,-3,0
21,1,2,0,15,-15,0,1.12113463374772,-5,0
21,1,10,11,6,5,0,1.15055688838947,4,0
21,1,10,7,13,-6,0,1.26674633124458,-3,0
21,1,10,11,0,11,0,1.3226833278045,10,0
21,1,2,5,18,-13,0,1.08010175561412,-8,0
21,1,2,14,0,14,0,1.26294515790278,10,0
21,1,2,11,4,7,0,0.768403708801543,6,0
21,1,2,11,1,10,0,0.628325522661271,9,0
21,1,2,17,4,13,1,0.669235971489343,-6,0
21,1,2,6,20,-14,0,0.716443465335942,-10,0
21,1,10,2,20,-18,0,0.841960261793474,-10,0
21,1,10,16,6,10,1,0.75477630076557,-4,0
21,1,10,20,0,20,0,1.07951930002696,10,0
21,1,10,10,0,10,0,1.24691864865895,10,0
21,1,2,18,6,12,1,0.719012281418827,-4,0
21,1,10,12,5,7,0,1.0203375603212,5,0
21,1,2,18,7,11,1,0.997203186827392,-3,0
21,1,10,14,0,14,0,1.58334778170206,10,0
21,1,2,12,2,10,0,1.08261778780502,8,0
21,1,2,9,13,-4,0,0.649292091030247,-3,0
21,1,10,20,8,12,1,0.929509677963324,-2,0
21,1,10,15,1,14,0,1.29429475771644,9,0
21,1,10,20,6,14,1,0.908378526486331,-4,0
21,1,2,2,13,-11,0,0.970414628469143,-3,0
21,1,2,20,7,13,1,0.742505878622524,-3,0
21,1,10,12,1,11,0,0.699102490556697,9,0
21,1,2,20,7,13,1,0.543969898519208,-3,0
21,1,2,8,17,-9,1,0.924692781253043,7,0
21,1,10,16,3,13,0,1.14609811572495,7,0
21,1,10,16,7,9,1,1.15813724178497,-3,0
21,1,10,1,14,-13,0,0.778107880744983,-4,0
21,1,2,14,10,4,1,1.13280720500143,0,0
21,1,10,10,0,10,0,1.08177067964766,10,0
21,1,10,9,11,-2,0,1.23251341132413,-1,0
21,1,2,11,1,10,0,1.58527476031895,9,0
21,1,2,10,13,-3,1,1.20405262993904,3,0
21,1,10,16,8,8,1,1.04544546489251,-2,0
21,1,2,20,3,17,1,0.789528995401497,-7,0
21,1,10,20,8,12,1,0.688249169295204,-2,0
21,1,10,5,20,-15,0,0.830562606644435,-10,0
21,1,2,17,0,17,0,0.775132188827001,10,0
21,1,2,12,7,5,1,0.826523172678435,-3,0
21,1,2,7,16,-9,0,0.747941886401122,-6,0
21,1,10,15,9,6,1,0.7845108601025,-1,0
21,1,2,7,18,-11,0,0.803228981289294,-8,0
21,1,10,11,5,6,0,0.965661145740569,5,0
22,1,2,10,20,-10,0,1.22318991981683,-10,0
22,1,2,6,17,-11,0,1.17709342497164,-7,0
22,1,10,10,12,-2,0,0.436405223367728,-2,0
22,1,10,10,16,-6,0,0.413699885452843,-6,0
22,1,10,11,5,6,1,0.655714455899215,-5,0
22,1,10,11,0,11,1,0.584289942727082,-10,0
22,1,2,6,20,-14,0,0.636216449026506,-10,0
22,1,2,15,0,15,1,0.989497548682266,-10,0
22,1,2,16,9,7,1,0.584593081329331,-1,0
22,1,10,1,20,-19,0,0.684068361970276,-10,0
22,1,10,11,8,3,1,0.915295670102751,-2,0
22,1,10,10,20,-10,0,0.817271935853569,-10,0
22,1,10,20,0,20,1,0.939977090491993,-10,0
22,1,10,10,9,1,0,0.537225383734039,1,0
22,1,2,20,3,17,1,0.862491271477666,-7,0
22,1,2,5,11,-6,0,0.734447651775554,-1,0
22,1,2,17,3,14,1,0.643756792669592,-7,0
22,1,2,0,14,-14,0,0.733019931270974,-4,0
22,1,10,1,17,-16,0,0.530323573883834,-7,0
22,1,2,20,8,12,1,0.671450538373392,-2,0
22,1,2,9,20,-11,0,0.484942955326005,-10,0
22,1,10,10,8,2,0,0.724167697593657,2,0
22,1,2,7,12,-5,0,0.698101809851323,-2,0
22,1,10,11,2,9,1,1.41740206185568,-8,0
22,1,2,2,14,-12,0,0.635357617410591,-4,0
22,1,10,20,2,18,1,0.852644215348846,-8,0
22,1,10,11,4,7,1,0.725224100801825,-6,0
22,1,2,8,17,-9,0,0.939270011454028,-7,0
22,1,10,9,16,-7,0,0.800512806415099,-6,0
22,1,2,20,7,13,1,0.763172508591197,-3,0
22,1,10,11,4,7,1,0.783103046965152,-6,0
22,1,10,17,3,14,1,0.682380389461287,-7,0
22,1,2,14,1,13,1,0.801586437571132,-9,0
22,1,10,11,1,10,1,0.844245773196235,-9,0
22,1,10,9,16,-7,0,0.645590286369043,-6,0
22,1,2,11,3,8,0,0.726236884306672,7,0
22,1,10,10,17,-7,0,0.900122978236141,-7,0
22,1,2,9,18,-9,0,0.674749507445995,-8,0
22,1,2,0,16,-16,0,0.818679129438351,-6,0
22,1,2,12,9,3,1,0.708568705612379,-1,0
22,1,10,9,18,-9,0,0.857134112256972,-8,0
22,1,10,15,2,13,1,0.681684306987336,-8,0
22,1,2,6,14,-8,0,0.697108087056222,-4,0
22,1,10,11,4,7,1,0.647722153494215,-6,0
22,1,10,1,17,-16,0,0.688328430698675,-7,0
22,1,10,16,6,10,1,0.775587628865651,-4,0
22,1,2,12,10,2,1,0.69150570446709,0,0
22,1,2,9,17,-8,0,0.546860939290127,-7,0
22,1,2,9,10,-1,0,0.447384558991871,0,0
22,1,2,11,1,10,1,0.592085406644401,-9,0
22,1,10,2,15,-13,0,0.675242153493855,-5,0
22,1,10,8,20,-12,0,0.475357250858906,-10,0
22,1,2,9,20,-11,0,0.627324627720554,-10,0
22,1,10,11,1,10,0,0.388589232531558,9,0
22,1,2,13,7,6,1,0.727867308132772,-3,0
22,1,2,11,0,11,1,0.645135761740676,-10,0
22,1,10,9,19,-10,0,0.669774295532079,-9,0
22,1,2,6,17,-11,0,0.765710148912149,-7,0
22,1,10,17,8,9,1,0.689669644902096,-2,0
22,1,2,10,11,-1,0,1.50519422680463,-1,0
22,1,2,19,2,17,1,0.83161988545271,-8,0
22,1,10,9,16,-7,0,1.17680971363097,-6,0
22,1,2,9,17,-8,0,0.78879596792649,-7,0
22,1,10,19,3,16,1,0.648130492554628,-7,0
22,1,2,14,2,12,1,0.832616174111536,-8,0
22,1,2,1,16,-15,0,0.666009438717083,-6,0
22,1,10,9,18,-9,0,0.649850355097442,-8,0
22,1,2,11,3,8,1,0.962347399770806,-7,0
22,1,10,17,10,7,1,0.734534891180374,0,0
22,1,10,3,13,-10,0,0.763824604810907,-3,0
22,1,2,16,4,12,1,0.839627949599162,-6,0
22,1,2,15,4,11,1,0.865036975945259,-6,0
22,1,2,1,11,-10,0,0.697030378007184,-1,0
22,1,2,15,6,9,1,0.78370235967941,-4,0
22,1,10,20,8,12,1,0.722782863688735,-2,0
22,1,10,9,17,-8,0,0.5368635967925,-7,0
22,1,10,11,0,11,1,0.806182268041994,-10,0
22,1,2,9,19,-10,0,1.29664403207335,-9,0
22,1,10,11,2,9,1,0.783411317296668,-8,0
22,1,10,13,6,7,1,0.986671065292285,-4,0
22,1,2,9,20,-11,0,0.98372618556732,-10,0
22,1,10,9,17,-8,0,0.62714061855695,-7,0
22,1,10,9,18,-9,0,0.589097273768857,-8,0
22,1,2,13,3,10,1,0.712340893470355,-7,0
22,1,2,9,15,-6,0,0.462335486827214,-5,0
22,1,2,17,6,11,1,0.67825997709042,-4,0
22,1,10,11,0,11,1,0.757534936998127,-10,0
22,1,10,20,5,15,1,0.930150561282971,-5,0
22,1,10,1,11,-10,0,0.935448705612544,-1,0
22,1,2,16,9,7,1,0.708718258877525,-1,0
22,1,10,11,2,9,1,0.746656403207453,-8,0
22,1,10,9,16,-7,0,0.711311248568563,-6,0
22,1,2,9,17,-8,0,0.525967468499402,-7,0
22,1,2,19,4,15,1,0.595952898052929,-6,0
22,1,10,0,18,-18,0,0.646519129439184,-8,0
22,1,2,6,17,-11,0,0.671176357388504,-7,0
22,1,2,11,3,8,1,0.639115143184426,-7,0
22,1,10,14,5,9,1,0.536408705612303,-5,0
22,1,2,1,13,-12,0,0.509674593356067,-3,0
22,1,10,9,12,-3,0,0.564182359678853,-2,0
22,1,2,9,17,-8,0,0.407655074455761,-7,0
22,1,2,9,10,-1,0,0.442261993127431,0,0
22,1,10,17,10,7,1,0.811521832760263,0,0
22,1,10,2,13,-11,0,0.565469324169499,-3,0
22,1,10,18,6,12,1,0.69740352806366,-4,0
22,1,10,9,19,-10,0,0.680136357388619,-9,0
22,1,10,14,0,14,1,0.575279358534317,-10,0
22,1,2,11,3,8,1,1.4991662772054,-7,0
22,1,2,9,20,-11,0,0.593846689576822,-10,0
22,1,2,6,10,-4,0,0.508419885451985,0,0
22,1,2,9,18,-9,0,0.482430973654118,-8,0
22,1,10,20,6,14,1,1.10564691867148,-4,0
22,1,10,9,16,-7,0,0.560322199313305,-6,0
22,1,2,11,4,7,1,0.908989507445767,-6,0
22,1,2,11,6,5,1,1.13882355097394,-4,0
22,1,10,3,20,-17,0,0.463622817869691,-10,0
22,1,10,17,5,12,1,0.919557938144862,-5,0
22,1,2,12,9,3,1,0.885430469644234,-1,0
22,1,10,9,17,-8,0,0.508759312715483,-7,0
22,1,2,14,0,14,1,0.907201466208789,-10,0
22,1,10,11,0,11,1,1.15377227949557,-10,0
22,1,2,5,17,-12,0,0.637797021763618,-7,0
22,1,2,9,20,-11,0,0.478472943871566,-10,0
22,1,10,9,19,-10,0,0.54972481099685,-9,0
22,1,10,17,0,17,1,0.64190790378052,-10,0
22,1,10,6,16,-10,0,0.41016119129381,-6,0
22,1,2,6,11,-5,0,0.452076426116946,-1,0
22,1,10,8,17,-9,0,0.516889072164304,-7,0
22,1,2,11,4,7,1,0.69880925544112,-6,0
22,1,2,19,0,19,1,1.00940646048093,-10,0
22,1,10,11,3,8,1,0.803260481099642,-7,0
22,1,10,15,5,10,1,0.669336632302475,-5,0
22,1,2,18,3,15,1,0.620711660939378,-7,0
22,1,10,4,17,-13,0,0.478647056128466,-7,0
22,1,10,11,0,11,1,0.597937044673017,-10,0
22,1,2,20,10,10,1,0.720520504009073,0,0
22,1,2,11,2,9,1,0.558489438717515,-8,0
22,1,2,13,2,11,1,0.442521512028179,-8,0
22,1,10,11,4,7,1,0.491035418098363,-6,0
22,1,2,15,4,11,1,0.465722428407389,-6,0
22,1,2,3,18,-15,0,0.40888595647175,-8,0
22,1,2,18,5,13,1,0.539631798395931,-5,0
22,1,2,9,20,-11,0,0.568219931272324,-10,0
22,1,10,18,7,11,1,0.572115280640901,-3,0
22,1,10,7,10,-3,0,0.576181809851732,0,0
22,1,2,14,1,13,1,0.57993310423808,-9,0
22,1,10,9,16,-7,0,0.486813837343107,-6,0
22,1,10,9,17,-8,0,0.501340297822935,-7,0
22,1,2,11,0,11,1,0.771227857961094,-10,0
22,1,10,20,7,13,1,0.967066025200438,-3,0
22,1,2,9,16,-7,0,0.721911569301483,-6,0
22,1,2,10,8,2,0,1.06314886598011,2,0
22,1,10,7,10,-3,0,1.10247294387227,0,0
22,1,10,13,3,10,1,1.51705841924377,-7,0
22,1,2,11,1,10,1,0.650359495991324,-9,0
22,1,10,18,0,18,1,0.523007560137557,-10,0
22,1,2,17,9,8,1,0.640301305842513,-1,0
22,1,10,7,17,-10,0,0.472798350516314,-7,0
22,1,2,11,4,7,0,1.31285809851124,6,0
22,1,10,9,20,-11,0,0.702148545246018,-10,0
22,1,2,11,3,8,1,0.67055761741085,-7,0
22,1,10,7,17,-10,0,0.678511798396357,-7,0
22,1,2,10,5,5,0,0.557861901489559,5,0
22,1,2,13,1,12,1,0.849638854524528,-9,0
22,1,10,8,17,-9,0,0.521751386025244,-7,0
22,1,10,9,16,-7,0,0.679025337914936,-6,0
22,1,2,13,9,4,1,0.653589186712452,-1,0
22,1,10,11,1,10,1,0.662192898053036,-9,0
22,1,10,10,10,0,0,1.02156242840738,0,0
22,1,2,9,17,-8,0,0.662706437571615,-7,0
22,1,2,11,4,7,1,0.86187143184361,-6,0
22,1,10,9,19,-10,0,0.541309140893645,-9,0
22,1,10,17,1,16,1,0.546027766323277,-9,0
22,1,2,3,16,-13,0,0.374261443299474,-6,0
22,1,2,14,8,6,1,0.593159770905004,-2,0
22,1,2,3,13,-10,0,0.43608705612769,-3,0
22,1,10,0,13,-13,0,0.501144925544395,-3,0
22,1,2,9,17,-8,0,0.315056678121437,-7,0
22,1,10,11,0,11,0,0.577087193585612,10,0
22,1,10,4,20,-16,0,0.756382130583916,-10,0
22,1,10,9,16,-7,0,0.391737548682613,-6,0
22,1,2,9,19,-10,0,0.30633493699861,-9,0
22,1,10,10,17,-7,0,0.584255120274975,-7,0
22,1,2,9,18,-9,0,0.72288733104233,-8,0
22,1,10,8,19,-11,0,0.464191340206526,-9,0
22,1,2,14,0,14,0,0.39196737686143,10,0
22,1,2,7,16,-9,0,0.491384375715825,-6,0
22,1,10,11,10,1,1,0.609936494844987,0,0
22,1,10,6,14,-8,0,0.620023276059328,-4,0
22,1,2,11,0,11,1,0.573315738832207,-10,0
22,1,2,9,18,-9,0,0.495905063001373,-8,0
22,1,2,12,7,5,1,0.597748636884717,-3,0
22,1,2,17,8,9,1,0.687792164948405,-2,0
22,1,10,11,1,10,0,0.959139702176799,9,0
22,1,10,19,10,9,1,0.794853241695819,0,0
22,1,10,2,15,-13,0,0.789022497137012,-5,0
22,1,10,4,15,-11,0,0.75171885452437,-5,0
22,1,10,11,2,9,1,0.875552989690732,-8,0
22,1,2,11,3,8,1,1.15484664375708,-7,0
22,1,2,11,0,11,1,0.750809072164884,-10,0
23,1,2,10,12,-2,1,1.29206903693193,2,0
23,1,10,11,5,6,1,1.3464621046478,-5,0
23,1,10,10,20,-10,1,0.951355611312465,10,0
23,1,10,10,9,1,0,1.67595382142554,1,0
23,1,2,6,17,-11,0,1.18907446744197,-7,0
23,1,10,1,20,-19,0,0.880559949122471,-10,0
23,1,2,0,14,-14,0,0.767743177039847,-4,0
23,1,2,10,20,-10,1,1.07578777209801,10,0
23,1,10,1,17,-16,0,0.972483830350939,-7,0
23,1,2,15,0,15,1,1.56058362856311,-10,0
23,1,2,20,3,17,1,0.661283931520302,-7,0
23,1,10,6,20,-14,0,0.733171560478695,-10,0
23,1,10,16,9,7,1,0.706830565539349,-1,0
23,1,2,20,8,12,1,0.561530439627859,-2,0
23,1,10,10,16,-6,1,0.982424796699888,6,0
23,1,10,11,0,11,1,0.945790209687402,-10,0
23,1,2,20,0,20,1,0.534557504201075,-10,0
23,1,2,5,11,-6,0,0.979944686880117,-1,0
23,1,2,11,8,3,1,0.695399920457021,-2,0
23,1,10,17,3,14,1,0.75800894760323,-7,0
23,1,10,9,16,-7,0,0.688044265158169,-6,0
23,1,10,16,7,9,1,0.591595997953846,-3,0
23,1,10,5,15,-10,0,0.714949021390566,-5,0
23,1,2,11,3,8,1,1.05716532171573,-7,0
23,1,2,15,1,14,1,1.47368814616766,-9,0
23,1,2,9,20,-11,0,0.706061167000371,-10,0
23,1,2,4,10,-6,0,1.12841551186557,0,0
23,1,10,9,17,-8,0,0.63865100500152,-7,0
23,1,2,10,3,7,0,0.680128147560936,7,0
23,1,10,5,20,-15,0,0.671725611734473,-10,0
23,1,10,8,17,-9,0,0.63945339347265,-7,0
23,1,10,7,10,-3,0,0.552910536801392,0,0
23,1,10,9,16,-7,0,1.42193207372839,-6,0
23,1,2,9,18,-9,0,0.511922744908588,-8,0
23,1,10,11,3,8,1,0.709834115622471,-7,0
23,1,2,1,19,-18,0,0.724679585279773,-9,0
23,1,2,17,10,7,1,0.4906251775501,0,0
23,1,2,15,10,5,1,0.497991096383885,0,0
23,1,2,11,4,7,1,0.896759105679848,-6,0
23,1,10,15,5,10,1,0.607736139188091,-5,0
23,1,10,9,20,-11,0,0.872997190357637,-10,0
23,1,2,11,3,8,1,1.78510907754662,-7,0
23,1,10,11,2,9,1,0.860494739022215,-8,0
23,1,10,8,19,-11,0,0.677253258213568,-9,0
23,1,10,11,1,10,1,0.645277949345655,-9,0
23,1,2,8,18,-10,0,0.998149997892142,-8,0
23,1,2,7,15,-8,0,1.07294147402717,-5,0
23,1,2,13,4,9,1,1.33716774097775,-6,0
23,1,2,15,1,14,1,0.566321677501037,-9,0
23,1,10,18,3,15,1,0.562368383914873,-7,0
23,1,10,11,4,7,1,0.75835424223078,-6,0
23,1,2,9,17,-8,0,0.779305781852599,-7,0
23,1,10,3,11,-8,0,0.830608792550265,-1,0
23,1,10,4,10,-6,0,0.767973740013076,0,0
23,1,2,2,18,-16,0,0.716208137149806,-8,0
23,1,2,13,0,13,1,0.690100271067422,-10,0
23,1,2,10,4,6,0,1.71381929947711,6,0
23,1,2,9,18,-9,0,0.647441355812589,-8,0
23,1,10,9,16,-7,0,0.536380747808835,-6,0
23,1,10,4,19,-15,0,0.765817298088223,-9,0
23,1,2,13,7,6,1,0.873176069102556,-3,0
23,1,10,11,1,10,1,1.82511376944785,-9,0
23,1,10,11,2,9,1,0.963378242406179,-8,0
23,1,2,14,6,8,1,1.33557102824125,-4,0
23,1,2,11,3,8,1,0.81285324428427,-7,0
23,1,10,10,10,0,1,0.98280674680791,0,0
23,1,2,4,17,-13,0,0.826379849749173,-7,0
23,1,10,10,11,-1,1,1.56378438513184,1,0
23,1,2,9,16,-7,0,0.951848627527397,-6,0
23,1,10,12,0,12,1,1.18865879429177,-10,0
23,1,2,10,3,7,1,0.975345890278732,-7,0
23,1,2,9,18,-9,0,0.787631707724358,-8,0
23,1,10,13,1,12,1,0.630622355078231,-9,0
23,1,10,9,16,-7,0,0.60013525872364,-6,0
23,1,2,11,2,9,1,0.667013916252472,-8,0
23,1,10,11,3,8,1,1.18699060336803,-7,0
23,1,10,17,1,16,1,0.654456848251357,-9,0
23,1,10,9,19,-10,0,1.15097842641717,-9,0
23,1,2,12,5,7,1,0.72419060116863,-5,0
23,1,2,1,14,-13,0,0.929911788585741,-4,0
23,1,10,11,1,10,1,0.655014378112355,-9,0
23,1,10,10,9,1,0,0.767757839233127,1,0
23,1,2,9,18,-9,NaN,NaN,0,0
23,1,2,19,7,12,1,0.600399911294517,-3,0
23,1,2,11,2,9,1,0.435263672035944,-8,0
23,1,10,6,20,-14,0,0.444500120047451,-10,0
23,1,2,11,3,8,1,0.645993830882617,-7,0
23,1,2,5,18,-13,0,0.694694302454991,-8,0
23,1,10,6,15,-9,0,0.502047025315733,-5,0
23,1,10,7,18,-11,0,0.500812102173768,-8,0
23,1,10,9,18,-9,0,0.554643241370286,-8,0
23,1,2,9,20,-11,0,0.9355864235431,-10,0
23,1,2,11,1,10,1,0.828922640441306,-9,0
23,1,10,14,2,12,1,0.894349007828168,-8,0
23,1,10,6,16,-10,0,0.613596983987009,-6,0
23,1,2,11,10,1,1,0.647985689700363,0,0
23,1,2,11,3,8,1,0.616634623667778,-7,0
23,1,2,7,20,-13,0,0.578900005682044,-10,0
23,1,10,10,2,8,1,0.742328099540828,-8,0
23,1,10,11,8,3,1,0.651524043246354,-2,0
23,1,2,11,2,9,1,1.04350529030216,-8,0
23,1,10,9,16,-7,0,0.589148878067135,-6,0
23,1,2,8,11,-3,1,0.496484922684431,1,0
23,1,2,10,18,-8,1,1.00732046603844,8,0
23,1,2,9,19,-10,0,0.689841483374039,-9,0
23,1,10,11,4,7,1,0.665088770410875,-6,0
23,1,10,18,2,16,1,1.78537776221947,-8,0
23,1,10,5,11,-6,0,0.812011634449846,-1,0
23,1,2,4,13,-9,0,0.702871407075691,-3,0
23,1,10,18,6,12,1,0.557108322443128,-4,0
23,1,2,14,7,7,1,0.561160219273006,-3,0
23,1,10,11,5,6,1,0.741307244405107,-5,0
23,1,10,9,19,-10,0,2.48980849344116,-9,0
23,1,2,9,16,-7,NaN,NaN,0,0
23,1,10,5,12,-7,0,0.821634797780462,-2,0
23,1,2,9,20,-11,0,0.655323750369462,-10,0
23,1,10,6,17,-11,0,0.504110362321626,-7,0
23,1,10,10,4,6,0,0.918102858944621,6,0
23,1,2,16,8,8,1,0.68366576799599,-2,0
23,1,2,11,3,8,1,0.682548508946638,-7,0
23,1,10,11,3,8,1,0.87742993763095,-7,0
23,1,10,6,19,-13,0,0.557127749848405,-9,0
23,1,10,9,16,-7,0,0.544907912268172,-6,0
23,1,2,9,18,-9,0,0.589027548426202,-8,0
23,1,10,10,3,7,0,0.591886675915703,7,0
23,1,10,11,2,9,1,2.1711396738765,-8,0
23,1,2,15,8,7,1,0.639195705443854,-2,0
23,1,2,3,10,-7,0,0.53614138751982,0,0
23,1,2,6,14,-8,0,0.540887539153118,-4,0
23,1,2,3,16,-13,0,0.865440663023946,-6,0
23,1,2,11,1,10,1,0.825083345398525,-9,0
23,1,10,11,2,9,1,0.666527864579621,-8,0
23,1,10,11,3,8,1,0.617833990993859,-7,0
23,1,10,17,6,11,1,0.611592295751507,-4,0
23,1,2,6,18,-12,0,0.485157646057814,-8,0
23,1,10,11,4,7,1,0.572453039747415,-6,0
23,1,2,0,10,-10,0,0.615929005664839,0,0
23,1,2,5,17,-12,0,0.625138695174428,-7,0
23,1,2,10,15,-5,1,1.05093498967199,5,0
23,1,10,5,20,-15,0,0.634889053024381,-10,0
23,1,2,11,1,10,1,0.635682277625165,-9,0
23,1,10,15,4,11,1,2.02105050942009,-6,0
23,1,2,6,16,-10,0,0.599308311080677,-6,0
23,1,10,12,10,2,1,1.00924084666894,0,0
23,1,2,11,0,11,NaN,NaN,0,0
23,1,2,9,16,-7,0,0.688119042339167,-6,0
23,1,2,1,13,-12,0,0.575492878756449,-3,0
23,1,10,9,17,-8,0,0.603221650192609,-7,0
23,1,10,19,0,19,1,0.716992930991182,-10,0
23,1,10,10,1,9,1,1.19512372141162,-9,0
23,1,10,10,10,0,1,0.925298329792895,0,0
23,1,2,9,20,-11,0,0.802393236330317,-10,0
23,1,10,17,7,10,1,0.788580718117373,-3,0
23,1,2,9,16,-7,0,0.735235630593706,-6,0
23,1,10,4,18,-14,0,0.788261082326244,-8,0
23,1,10,7,20,-13,0,0.630634451385959,-10,0
23,1,10,14,10,4,1,0.608232454395875,0,0
23,1,2,11,2,9,1,0.554333136004971,-8,0
23,1,2,5,18,-13,0,0.622667016114974,-8,0
23,1,2,9,17,-8,0,0.591765712830238,-7,0
23,1,10,3,19,-16,0,0.689007204635345,-9,0
23,1,10,7,11,-4,0,0.57584183893232,-1,0
23,1,2,13,4,9,1,0.490712784148855,-6,0
23,1,10,4,18,-14,0,0.682443674271781,-8,0
23,1,10,14,0,14,1,0.689942652500577,-10,0
23,1,2,9,18,-9,0,0.544293566413216,-8,0
23,1,2,9,19,-10,0,0.75706580208589,-9,0
23,1,10,9,17,-8,0,0.561125030011681,-7,0
23,1,2,17,5,12,1,0.597997511093126,-5,0
23,1,2,9,20,-11,0,0.584176195564396,-10,0
23,1,10,11,4,7,1,0.722176382507314,-6,0
23,1,10,9,19,-10,0,0.511475548045382,-9,0
23,1,2,10,11,-1,1,1.28565652714951,1,0
23,1,10,11,0,11,1,0.908973444937146,-10,0
23,1,2,2,14,-12,0,0.603227881624662,-4,0
23,1,2,1,10,-9,0,0.613256088017806,0,0
23,1,2,18,5,13,1,0.534638512814126,-5,0
23,1,10,8,11,-3,0,0.7715520480333,-1,0
23,1,2,0,11,-11,0,0.542880864189101,-1,0
23,1,10,9,18,-9,0,0.451629977585071,-8,0
23,1,2,14,10,4,1,0.467003286164072,0,0
23,1,10,5,12,-7,0,0.490623711330045,-2,0
23,1,2,0,12,-12,0,0.609109253492534,-2,0
23,1,2,8,13,-5,0,0.555215066868186,-3,0
23,1,10,9,19,-10,0,0.5193564763822,-9,0
23,1,2,11,3,8,1,0.868643252367292,-7,0
23,1,10,11,10,1,1,0.523839808218327,0,0
23,1,10,11,0,11,1,0.481539383565178,-10,0
23,1,10,4,18,-14,0,1.45627202765263,-8,0
23,1,2,9,16,-7,0,0.640365381830634,-6,0
23,1,2,11,0,11,1,0.58517762329484,-10,0
23,1,10,11,3,8,1,0.715888867914146,-7,0
23,1,10,3,12,-9,0,0.697076908696545,-2,0
23,1,2,9,19,-10,0,0.567275819662427,-9,0
23,1,2,12,8,4,1,0.499256077020618,-2,0
23,1,10,5,20,-15,0,0.585289789066337,-10,0
23,1,10,19,3,16,1,0.580151057236435,-7,0
23,1,10,4,13,-9,0,0.751123215564803,-3,0
23,1,2,9,18,-9,0,0.499151975454879,-8,0
23,1,2,12,2,10,1,0.481031705157875,-8,0
24,1,10,10,20,-10,0,2.21157066896558,-10,0
24,1,2,1,20,-19,0,1.1014759328682,-10,0
24,1,10,10,12,-2,1,1.93208912410773,2,0
24,1,10,11,0,11,1,2.00199259200599,-10,0
24,1,10,20,3,17,0,2.82856305025052,7,0
24,1,2,10,20,-10,NaN,NaN,0,0
24,1,2,0,14,-14,0,0.387828181148507,-4,0
24,1,2,5,11,-6,0,0.57582314463798,-1,0
24,1,2,10,16,-6,1,0.756397572578862,6,0
24,1,10,10,9,1,1,1.39311536774039,-1,0
24,1,10,11,8,3,1,1.61232687160373,-2,0
24,1,2,6,20,-14,0,0.558336280984804,-10,0
24,1,2,6,17,-11,0,1.05093718902208,-7,0
24,1,10,1,17,-16,0,1.56353072915226,-7,0
24,1,2,15,0,15,1,1.10346265998669,-10,0
24,1,2,17,3,14,0,1.03813856141642,7,0
24,1,10,16,9,7,1,1.27142870239913,-1,0
24,1,10,11,5,6,0,1.67919966427144,5,0
24,1,2,20,0,20,0,1.01463360106573,10,0
24,1,10,20,8,12,1,1.7372923695948,-2,0
24,1,10,20,3,17,0,2.88861169200391,7,0
24,1,10,11,8,3,0,1.61651439371053,2,0
24,1,10,16,4,12,1,2.34629715501796,-6,0
24,1,2,11,2,9,NaN,NaN,0,0
24,1,2,0,17,-17,0,0.547711323364638,-7,0
24,1,10,7,12,-5,0,0.98433234798722,-2,0
24,1,10,5,19,-14,0,0.739551813458093,-9,0
24,1,2,11,5,6,1,0.560855245683342,-5,0
24,1,2,7,19,-12,0,0.789506635628641,-9,0
24,1,2,17,3,14,1,0.640671821660362,-7,0
24,1,10,17,1,16,1,0.873395635397173,-9,0
24,1,2,17,4,13,0,0.793267487781122,6,0
24,1,2,9,14,-5,0,0.452723777154461,-4,0
24,1,10,16,3,13,1,1.26129786064848,-7,0
24,1,2,1,15,-14,0,1.3418886003783,-5,0
24,1,10,20,7,13,1,0.715202677296475,-3,0
24,1,2,3,14,-11,0,0.433187505579554,-4,0
24,1,10,10,16,-6,1,1.2584720896557,6,0
24,1,10,14,10,4,1,1.08303419407457,0,0
24,1,2,17,3,14,0,0.634358648210764,7,0
24,1,10,10,16,-6,1,1.72414881386794,6,0
24,1,2,6,13,-7,0,0.554230500594713,-3,0
24,1,10,20,0,20,0,1.31938360154163,10,0
24,1,2,20,3,17,1,1.01348078611773,-7,0
24,1,10,8,19,-11,1,1.36734143295325,9,0
24,1,2,5,13,-8,0,0.523392244824208,-3,0
24,1,10,11,8,3,1,0.737324259942397,-2,0
24,1,2,9,19,-10,1,1.10259135917295,9,0
24,1,10,13,4,9,0,1.04526438680477,6,0
24,1,2,6,16,-10,0,0.765869715367444,-6,0
24,1,2,10,7,3,1,1.52121197688393,-3,0
24,1,2,8,16,-8,1,1.79902789671905,6,0
24,1,2,13,4,9,1,0.793842612416483,-6,0
24,1,10,16,5,11,1,1.42900988052133,-5,0
24,1,2,9,19,-10,1,1.46230222075246,9,0
24,1,2,4,11,-7,0,0.630285124760121,-1,0
24,1,10,17,7,10,1,0.879571350873448,-3,0
24,1,10,18,6,12,1,0.878828710876405,-4,0
24,1,10,19,6,13,1,0.862013742094859,-4,0
24,1,10,10,12,-2,1,1.43812976405025,2,0
24,1,10,14,4,10,0,1.270717219566,6,0
24,1,10,17,3,14,0,1.62268424418289,7,0
24,1,2,14,1,13,0,0.888630752917379,9,0
24,1,2,0,18,-18,0,1.16788136819378,-8,0
24,1,10,17,4,13,1,1.69183334219269,-6,0
24,1,2,20,3,17,0,1.32339774316642,7,0
24,1,10,19,6,13,1,0.793138094013557,-4,0
24,1,10,20,0,20,0,2.01240788016003,10,0
24,1,2,10,16,-6,1,0.718371910159476,6,0
24,1,2,4,16,-12,0,1.80425790057052,-6,0
24,1,2,8,19,-11,1,0.950293702073395,9,0
24,1,10,8,16,-8,1,3.53885902487673,6,0
24,1,2,6,15,-9,0,1.01601917820517,-5,0
24,1,2,0,20,-20,0,1.16211032937281,-10,0
24,1,10,1,17,-16,0,0.798103078850545,-7,0
24,1,2,10,6,4,0,1.75269060395658,4,0
24,1,10,0,15,-15,0,1.06127183523495,-5,0
24,1,2,10,9,1,0,1.14192635542713,1,0
24,1,10,11,5,6,0,1.59518640220631,5,0
24,1,10,5,12,-7,0,0.893898878479376,-2,0
24,1,10,8,16,-8,0,1.37103373953141,-6,0
24,1,10,11,8,3,0,1.45507925830316,2,0
24,1,2,2,12,-10,0,0.991672607837245,-2,0
24,1,2,11,5,6,0,1.57100478175562,5,0
24,1,2,10,17,-7,0,0.686895115766674,-7,0
24,1,10,13,2,11,0,1.15820102242287,8,0
24,1,2,14,6,8,0,1.14683342468925,4,0
24,1,10,7,15,-8,0,0.935508347349241,-5,0
24,1,2,20,4,16,1,1.06059187604114,-6,0
24,1,10,10,9,1,0,0.98136032151524,1,0
24,1,2,13,8,5,1,1.40800372418016,-2,0
24,1,2,12,10,2,1,1.21856746717822,0,0
24,1,2,8,16,-8,0,0.72455532324966,-6,0
24,1,10,10,19,-9,1,1.15443247230724,9,0
24,1,10,9,19,-10,0,1.23112453508656,-9,0
24,1,2,1,17,-16,0,0.896496285917237,-7,0
24,1,10,5,13,-8,0,0.991123508778401,-3,0
24,1,2,10,6,4,0,1.69837964442559,4,0
24,1,10,17,1,16,0,1.10497653135099,9,0
24,1,10,5,12,-7,0,0.79946336383,-2,0
24,1,2,6,14,-8,0,0.864854175364599,-4,0
24,1,2,8,16,-8,0,0.848875684780069,-6,0
24,1,10,15,10,5,1,0.985473066451959,0,0
24,1,10,13,1,12,0,1.10879786522128,9,0
24,1,2,15,4,11,1,0.827274976531044,-6,0
24,1,10,12,8,4,1,1.00537296035327,-2,0
24,1,2,14,6,8,1,1.15203667024616,-4,0
24,1,10,5,13,-8,0,0.972478698589839,-3,0
24,1,2,10,9,1,1,1.76039485284127,-1,0
24,1,10,10,20,-10,1,1.26119669142645,10,0
24,1,10,1,19,-18,0,0.748432703199796,-9,0
24,1,2,18,3,15,1,1.15247580280993,-7,0
24,1,10,11,5,6,0,1.46034005295951,5,0
24,1,2,1,18,-17,0,0.860406032763422,-8,0
24,1,10,14,6,8,0,0.964176598703489,4,0
24,1,2,20,9,11,1,0.919566145748831,-1,0
24,1,10,15,3,12,0,1.27670635841787,7,0
24,1,2,11,10,1,1,0.708842218387872,0,0
24,1,10,14,4,10,0,0.9874282698147,6,0
24,1,2,5,14,-9,0,0.662726691225544,-4,0
24,1,2,14,9,5,1,1.36454975162633,-1,0
24,1,10,20,8,12,1,0.991919299238361,-2,0
24,1,2,17,3,14,0,1.9552092020167,7,0
24,1,2,14,6,8,1,1.65577717870474,-4,0
24,1,2,2,14,-12,0,0.799710055114701,-4,0
24,1,10,13,2,11,0,1.52179296617396,8,0
24,1,2,20,1,19,0,1.3036972549744,9,0
24,1,10,6,19,-13,0,1.58172541018575,-9,0
24,1,10,9,18,-9,1,2.64090385090094,8,0
24,1,10,6,20,-14,0,1.96129841043148,-10,0
24,1,2,14,4,10,0,0.89279591513332,6,0
24,1,2,20,1,19,0,1.16409485705663,9,0
24,1,10,18,3,15,0,1.9840292071458,7,0
24,1,10,17,3,14,0,0.978699500206858,7,0
24,1,2,15,4,11,0,1.45325894712005,6,0
24,1,2,12,8,4,1,1.07792112103198,-2,0
24,1,10,9,11,-2,0,0.997844291268848,-1,0
24,1,2,4,20,-16,0,0.711809845990501,-10,0
24,1,10,13,0,13,0,1.1811323245056,10,0
24,1,10,2,11,-9,0,1.63168243155815,-1,0
24,1,10,13,4,9,1,2.31972889602184,-6,0
24,1,2,9,18,-9,0,0.829631923930719,-8,0
24,1,10,18,5,13,1,1.55017567146569,-5,0
24,1,10,20,1,19,0,1.41087641415652,9,0
24,1,2,16,1,15,0,1.39760529738851,9,0
24,1,2,5,14,-9,0,1.69544244080316,-4,0
24,1,2,4,13,-9,0,0.998097580508329,-3,0
24,1,2,3,18,-15,0,0.631835284875706,-8,0
24,1,10,10,4,6,0,2.01661372999661,6,0
24,1,10,4,18,-14,0,1.25845779397059,-8,0
24,1,2,2,19,-17,0,1.17041572812013,-9,0
24,1,10,3,18,-15,0,0.757910710992292,-8,0
24,1,2,14,8,6,1,1.53779821528587,-2,0
24,1,10,12,4,8,0,1.13500396790914,6,0
24,1,2,18,8,10,1,1.14028822211549,-2,0
24,1,2,13,2,11,0,1.00901284953579,8,0
24,1,2,18,3,15,0,1.25897646893281,7,0
24,1,10,0,18,-18,0,1.13085566728842,-8,0
24,1,10,17,1,16,0,1.24753739312291,9,0
24,1,10,10,9,1,0,1.50352130865213,1,0
24,1,2,18,6,12,1,1.2225915058516,-4,0
24,1,10,6,12,-6,0,1.39984971261583,-2,0
24,1,2,11,5,6,0,0.929915454122238,5,0
24,1,10,10,9,1,0,1.21457018703222,1,0
24,1,10,13,6,7,0,2.04787059139926,4,0
24,1,2,8,14,-6,0,0.815816839924082,-4,0
24,1,2,17,3,14,0,0.921085882000625,7,0
24,1,10,10,10,0,1,1.24631713225972,0,0
24,1,10,9,11,-2,0,1.63034157408401,-1,0
24,1,2,20,1,19,0,1.0956440459704,9,0
24,1,2,0,20,-20,NaN,NaN,0,0
24,1,10,2,13,-11,0,1.25688710657414,-3,0
24,1,2,16,1,15,0,0.960694694658741,9,0
24,1,10,8,16,-8,0,1.0286517564673,-6,0
24,1,10,0,12,-12,0,0.973993303021416,-2,0
24,1,2,14,6,8,1,1.13734771928284,-4,0
24,1,2,7,14,-7,0,0.84597477002535,-4,0
24,1,2,3,18,-15,0,1.06190927396528,-8,0
24,1,10,1,17,-16,0,0.678519705077633,-7,0
24,1,10,18,0,18,0,1.34181565581821,10,0
24,1,2,14,9,5,1,1.18578537111171,-1,0
24,1,2,10,19,-9,1,1.46053945866879,9,0
24,1,2,13,1,12,0,1.14031608018558,9,0
24,1,10,15,5,10,1,1.59298853960354,-5,0
24,1,10,13,2,11,0,1.54761601914652,8,0
24,1,2,5,16,-11,0,0.927503523416817,-6,0
24,1,2,3,14,-11,0,0.940772074391134,-4,0
24,1,10,2,20,-18,0,0.849440545774996,-10,0
24,1,10,8,16,-8,0,1.28938695543911,-6,0
24,1,10,6,17,-11,0,0.944003621581942,-7,0
24,1,10,8,20,-12,0,0.667970624286681,-10,0
24,1,2,6,11,-5,0,1.59526557812933,-1,0
24,1,10,16,9,7,1,1.6778555077035,-1,0
24,1,2,16,5,11,0,1.4204823494656,5,0
24,1,2,10,20,-10,1,0.941147059900686,10,0
24,1,2,17,3,14,0,1.00911658455152,7,0
24,1,2,19,0,19,0,1.57105793221854,10,0
24,1,10,16,8,8,1,1.79832447797526,-2,0
24,1,10,4,20,-16,0,0.87224685261026,-10,0
24,1,10,13,2,11,0,1.06361375388224,8,0
25,1,2,6,20,-14,NaN,NaN,0,0
25,1,2,0,14,-14,0,0.525904611442684,-4,0
25,1,2,10,9,1,0,0.516378951689831,1,0
25,1,2,10,20,-10,0,0.731046275711606,-10,0
25,1,10,5,11,-6,0,1.07245468924407,-1,0
25,1,2,15,0,15,0,0.664878001396573,10,0
25,1,10,20,0,20,0,0.801611741483612,10,0
25,1,10,10,12,-2,0,0.541000804587839,-2,0
25,1,10,20,3,17,0,0.786928655605152,7,0
25,1,10,1,17,-16,0,0.510784958790055,-7,0
25,1,10,11,8,3,0,0.406207605645704,2,0
25,1,10,17,3,14,0,0.569470383288035,7,0
25,1,10,10,16,-6,0,0.621907514556824,-6,0
25,1,2,16,9,7,0,0.352646617340497,1,0
25,1,2,10,20,-10,0,0.486120585534536,-10,0
25,1,10,11,5,6,0,0.421954433572182,5,0
25,1,10,6,17,-11,0,0.704501109744797,-7,0
25,1,2,20,8,12,0,0.831880371173384,2,0
25,1,2,11,0,11,0,0.657786265558116,10,0
25,1,2,1,20,-19,0,0.491026921617731,-10,0
25,1,10,1,19,-18,0,0.571532620628659,-9,0
25,1,2,19,1,18,0,0.760151827000755,9,0
25,1,2,20,4,16,0,0.749603112783234,6,0
25,1,10,12,9,3,0,0.506867221019775,1,0
25,1,2,10,16,-6,0,0.64215123684744,-6,0
25,1,10,10,13,-3,0,0.484136790922548,-3,0
25,1,2,0,16,-16,0,0.805295983842143,-6,0
25,1,10,13,2,11,0,0.479338588507289,8,0
25,1,2,17,4,13,0,0.495353367997268,6,0
25,1,10,4,16,-12,0,0.613868234543588,-6,0
25,1,2,13,1,12,0,0.783940134269187,9,0
25,1,2,7,11,-4,0,0.355854338451081,-1,0
25,1,10,18,3,15,0,0.865069343005416,7,0
25,1,2,6,17,-11,0,0.921665405107206,-7,0
25,1,2,16,9,7,0,0.49632363856972,1,0
25,1,10,13,9,4,0,0.399031928756358,1,0
25,1,10,0,20,-20,0,0.690386183816145,-10,0
25,1,2,6,20,-14,0,0.786264824850832,-10,0
25,1,10,19,4,15,0,0.606232164817811,6,0
25,1,10,14,5,9,0,0.649587534204102,5,0
25,1,10,4,15,-11,0,0.691945141407587,-5,0
25,1,2,19,8,11,0,0.636119210954121,2,0
25,1,2,12,2,10,0,0.277944580578833,8,0
25,1,10,9,19,-10,0,0.837859979729501,-9,0
25,1,2,19,4,15,0,0.863834786417556,6,0
25,1,10,5,16,-11,0,0.472396407029692,-6,0
25,1,10,16,6,10,0,0.641011251399959,4,0
25,1,2,0,15,-15,0,0.987283480657879,-5,0
25,1,2,5,13,-8,0,0.430347805528072,-3,0
25,1,10,16,8,8,0,0.431736315134458,2,0
25,1,10,17,4,13,0,0.536267848928219,6,0
25,1,2,4,18,-14,0,0.445506312990119,-8,0
25,1,2,15,7,8,0,0.830957752725908,3,0
25,1,10,15,9,6,0,0.496747742480693,1,0
25,1,2,11,3,8,0,0.776026949109337,7,0
25,1,10,19,1,18,0,0.460039477952705,9,0
25,1,2,5,15,-10,0,0.30800793957701,-5,0
25,1,10,20,0,20,0,0.658583155706992,10,0
25,1,2,20,10,10,0,0.275746351405132,0,0
25,1,10,10,10,0,0,0.595809912008463,0,0
25,1,2,20,7,13,0,0.837782636665452,3,0
25,1,2,19,3,16,0,0.3597772079886,7,0
25,1,10,6,19,-13,0,0.315692027982777,-9,0
25,1,2,12,0,12,0,0.370218521647757,10,0
25,1,10,15,9,6,0,0.398324111425381,1,0
25,1,10,7,18,-11,0,0.312868089754602,-8,0
25,1,2,3,15,-12,0,0.295779304682128,-5,0
25,1,2,0,10,-10,0,0.430121274657722,0,0
25,1,10,11,3,8,0,0.424327509388377,7,0
25,1,10,18,9,9,0,0.370053938539968,1,0
25,1,10,1,16,-15,0,0.237341671233253,-6,0
25,1,10,7,16,-9,0,0.422603968688918,-6,0
25,1,10,10,20,-10,0,0.290331200595347,-10,0
25,1,2,14,3,11,0,0.160764340082096,7,0
25,1,2,16,8,8,0,0.293167235132159,2,0
25,1,2,18,8,10,0,0.468428084696143,2,0
25,1,2,4,16,-12,0,0.412368658830928,-6,0
25,1,10,14,8,6,0,0.382361749272832,2,0
25,1,2,20,5,15,0,0.241492171305708,5,0
25,1,10,9,14,-5,0,0.690995764459103,-4,0
25,1,2,0,14,-14,0,0.682124405035665,-4,0
25,1,2,6,18,-12,0,0.514174124529745,-8,0
25,1,10,12,4,8,0,0.312788547361606,6,0
25,1,10,19,1,18,0,0.590707102549231,9,0
25,1,10,7,20,-13,0,0.402705174470839,-10,0
25,1,2,4,20,-16,0,0.685271278048276,-10,0
25,1,10,9,17,-8,0,0.932554648739824,-7,0
25,1,2,6,16,-10,0,0.921907331279499,-6,0
25,1,2,12,0,12,0,0.479827572619115,10,0
25,1,10,18,5,13,0,0.759740552507992,5,0
25,1,10,10,11,-1,0,0.723731307995649,-1,0
25,1,2,17,4,13,0,0.569632400512319,6,0
25,1,10,8,11,-3,0,0.669822092624827,-1,0
25,1,10,2,10,-8,0,0.734347468297756,0,0
25,1,2,7,20,-13,0,0.708275891140602,-10,0
25,1,2,1,16,-15,0,0.642817266930706,-6,0
25,1,10,20,9,11,0,0.388136453692368,1,0
25,1,2,11,0,11,0,0.399423409289511,10,0
25,1,2,5,19,-14,0,0.434115622382706,-9,0
25,1,10,20,2,18,0,0.571251473091934,8,0
25,1,2,8,12,-4,0,0.429326217282778,-2,0
25,1,2,19,6,13,0,0.398572269029273,4,0
25,1,10,10,15,-5,0,0.449201185438142,-5,0
25,1,10,0,10,-10,0,0.753830222810393,0,0
25,1,2,12,7,5,0,0.654485806081539,3,0
25,1,2,14,9,5,0,0.503017662443426,1,0
25,1,10,8,14,-6,0,0.605653741333072,-4,0
25,1,10,4,16,-12,0,0.85625113402898,-6,0
25,1,10,6,10,-4,0,1.2649333511722,0,0
25,1,2,16,9,7,0,0.568917618639944,1,0
25,1,10,10,13,-3,0,0.483521711957565,-3,0
25,1,2,8,20,-12,0,0.762778925298107,-10,0
25,1,2,18,9,9,0,0.454729198472933,1,0
25,1,2,12,2,10,0,0.607422734828788,8,0
25,1,10,19,4,15,0,1.05785920996436,6,0
25,1,2,18,4,14,0,0.450664838779858,6,0
25,1,2,0,17,-17,0,0.923143354086505,-7,0
25,1,10,12,5,7,0,0.505198663541023,5,0
25,1,10,7,11,-4,0,0.871688956253593,-1,0
25,1,10,19,6,13,0,0.671789392270512,4,0
25,1,2,18,1,17,0,1.64498910415841,9,0
25,1,10,6,11,-5,0,0.453593978237677,-1,0
25,1,2,18,6,12,0,0.686180333968196,4,0
25,1,2,17,7,10,0,0.445542601916031,3,0
25,1,10,15,1,14,0,0.950153678102652,9,0
25,1,10,5,15,-10,0,0.538694441746202,-5,0
25,1,2,19,7,12,0,0.392341203875958,3,0
25,1,10,12,9,3,0,1.03462879911149,1,0
25,1,2,0,13,-13,0,0.708146863848924,-3,0
25,1,10,19,2,17,0,0.546566206212674,8,0
25,1,10,6,11,-5,0,0.61377183062973,-1,0
25,1,2,17,6,11,0,0.615838100073233,4,0
25,1,2,16,7,9,0,0.385678703715485,3,0
25,1,10,18,5,13,0,0.692899283568522,5,0
25,1,10,13,3,10,0,0.412382221358712,7,0
25,1,10,2,14,-12,0,0.614322762503662,-4,0
25,1,2,17,2,15,0,0.727474199123435,8,0
25,1,10,7,16,-9,0,0.621419263554799,-6,0
25,1,2,19,7,12,0,0.895516851440789,3,0
25,1,2,7,17,-10,0,0.838177782746698,-7,0
25,1,10,14,2,12,0,0.485510638337018,8,0
25,1,2,1,19,-18,0,0.636764713968205,-9,0
25,1,10,17,5,12,0,0.797146737387493,5,0
25,1,10,11,8,3,0,0.583227185170699,2,0
25,1,10,20,0,20,0,1.05060142479851,10,0
25,1,2,17,2,15,0,0.666606307308484,8,0
25,1,2,8,14,-6,0,0.474526090454674,-4,0
25,1,2,20,10,10,0,1.29847164973489,0,0
25,1,10,4,16,-12,0,1.6003247675585,-6,0
25,1,2,2,17,-15,0,0.419012831250939,-7,0
25,1,10,18,8,10,0,0.395676852613633,2,0
25,1,2,13,7,6,0,0.477480888748914,3,0
25,1,10,6,16,-10,0,0.685598978045164,-6,0
25,1,2,4,15,-11,0,0.844879137716362,-5,0
25,1,2,13,6,7,0,0.701540813128531,4,0
25,1,2,18,6,12,0,0.812057087245648,4,0
25,1,10,10,9,1,0,0.878136288742553,1,0
25,1,2,3,14,-11,0,0.42930239122029,-4,0
25,1,10,2,14,-12,0,0.622023345875505,-4,0
25,1,10,14,2,12,0,0.559456472533157,8,0
25,1,10,18,9,9,0,0.518291268114808,1,0
25,1,2,19,3,16,0,0.724265011793932,7,0
25,1,2,3,13,-10,0,0.401760929289821,-3,0
25,1,2,1,19,-18,0,0.515674799906947,-9,0
25,1,10,8,20,-12,0,1.62563317760873,-10,0
25,1,2,2,15,-13,0,0.731631297182503,-5,0
25,1,10,14,9,5,0,0.688232307774115,1,0
25,1,10,19,4,15,0,0.591425916524486,6,0
25,1,2,16,9,7,0,1.36282401153926,1,0
25,1,10,1,14,-13,0,0.830063725552918,-4,0
25,1,10,10,2,8,0,1.53391823261927,8,0
25,1,2,14,5,9,0,0.987299975624182,5,0
25,1,10,11,0,11,0,0.854581476885869,10,0
25,1,2,20,3,17,0,1.10253417665376,7,0
25,1,10,0,19,-19,0,0.716751371373221,-9,0
25,1,10,5,14,-9,0,0.777762219562646,-4,0
25,1,2,18,8,10,0,0.701061725996624,2,0
25,1,10,15,8,7,0,0.83572699731144,2,0
25,1,2,8,11,-3,0,0.484377617430255,-1,0
25,1,2,17,2,15,0,1.98700233312138,8,0
25,1,10,6,15,-9,0,0.412252827512248,-5,0
25,1,2,3,10,-7,0,0.534129001633119,0,0
25,1,2,15,8,7,0,0.650781403208384,2,0
25,1,2,7,11,-4,0,0.434712373607226,-1,0
25,1,10,11,8,3,0,0.372026736507678,2,0
25,1,10,0,12,-12,0,0.663933023105756,-2,0
25,1,10,19,3,16,0,0.703890795992265,7,0
25,1,2,10,9,1,0,0.606581124993227,1,0
25,1,10,13,8,5,0,0.57653242818742,2,0
25,1,2,8,20,-12,0,1.14850858013165,-10,0
25,1,10,5,20,-15,0,0.583724600042842,-10,0
25,1,2,14,7,7,0,0.963004356503916,3,0
25,1,2,11,1,10,0,0.798370663885862,9,0
25,1,2,12,2,10,0,0.720869248067629,8,0
25,1,10,19,4,15,0,0.534256196150636,6,0
25,1,10,3,18,-15,0,0.515552004046867,-8,0
25,1,2,0,20,-20,0,0.464896329136764,-10,0
25,1,10,14,4,10,0,0.416146372665253,6,0
25,1,10,20,7,13,0,0.409415693311075,3,0
25,1,2,2,12,-10,0,0.523137122654816,-2,0
26,1,10,10,20,-10,0,6.66056350676809,-10,0
26,1,10,10,9,1,1,2.67682320447057,-1,0
26,1,10,6,20,-14,1,2.70885837919195,10,0
26,1,2,17,3,14,NaN,NaN,0,0
26,1,2,11,0,11,1,1.04106528550619,-10,0
26,1,2,16,9,7,0,1.65053453051951,1,0
26,1,10,5,11,-6,1,1.84329138099565,1,0
26,1,10,20,8,12,1,3.6526968452381,-2,0
26,1,2,1,20,-19,NaN,NaN,0,0
26,1,2,10,12,-2,0,1.08230651789927,-2,0
26,1,2,11,8,3,NaN,NaN,0,0
26,1,2,11,5,6,1,1.01518568815663,-5,0
26,1,10,10,20,-10,0,2.74507449337398,-10,0
26,1,10,0,14,-14,1,4.43791766781942,4,0
26,1,10,15,0,15,1,1.22420333602349,-10,0
26,1,10,20,3,17,1,2.85829709010432,-7,0
26,1,2,1,17,-16,1,0.891023589734687,7,0
26,1,2,6,17,-11,1,1.25838359736372,7,0
26,1,2,10,16,-6,0,1.51522619265597,-6,0
26,1,10,20,0,20,0,5.59326856286498,10,0
26,1,2,5,16,-11,1,0.902038968604757,6,0
26,1,10,2,11,-9,0,1.46088277717354,-1,0
26,1,2,11,7,4,1,1.41367730961065,-3,0
26,1,10,20,2,18,0,2.03966797344037,8,0
26,1,10,7,20,-13,1,3.97709903799114,10,0
26,1,2,14,8,6,1,0.861243101884611,-2,0
26,1,2,13,7,6,NaN,NaN,0,0
26,1,2,5,19,-14,1,1.49078752755304,9,0
26,1,10,9,18,-9,1,2.02610759521485,8,0
26,1,10,14,3,11,1,2.48434823568095,-7,0
26,1,10,5,20,-15,0,1.2671160644968,-10,0
26,1,10,14,1,13,0,2.00303765080753,9,0
26,1,2,12,4,8,NaN,NaN,0,0
26,1,2,16,0,16,1,1.20278839263483,-10,0
26,1,10,20,6,14,1,6.1894626103458,-4,0
26,1,10,15,1,14,0,3.55290853141923,9,0
26,1,2,10,18,-8,NaN,NaN,0,0
26,1,2,14,7,7,1,0.930672135698842,-3,0
26,1,10,7,20,-13,1,1.45603140653111,10,0
26,1,2,5,16,-11,0,1.26478183496511,-6,0
26,1,2,10,12,-2,1,0.854448250524001,2,0
26,1,10,15,1,14,0,1.01553868173505,9,0
26,1,10,17,0,17,0,1.86539398372406,10,0
26,1,2,6,20,-14,0,1.86550101809553,-10,0
26,1,10,2,19,-17,0,1.68148140000994,-9,0
26,1,2,18,0,18,NaN,NaN,0,0
26,1,2,2,15,-13,0,1.08592955893255,-5,0
26,1,2,12,8,4,1,1.38931195577607,-2,0
26,1,10,10,16,-6,0,1.32090451396652,-6,0
26,1,10,2,16,-14,0,1.43886081679375,-6,0
26,1,2,2,19,-17,0,1.53554000135045,-9,0
26,1,2,1,17,-16,0,1.8448096565553,-7,0
26,1,2,3,20,-17,NaN,NaN,0,0
26,1,10,20,0,20,0,2.22652326989919,10,0
26,1,10,5,11,-6,1,1.49245462493855,1,0
26,1,2,14,9,5,1,1.8921082293673,-1,0
26,1,10,14,7,7,1,1.98751619720133,-3,0
26,1,2,16,0,16,0,1.15098851028597,10,0
26,1,10,3,17,-14,0,1.81171586766141,-7,0
26,1,10,0,10,-10,0,2.09365949497442,0,0
26,1,10,2,17,-15,0,1.70055001750006,-7,0
26,1,10,10,4,6,0,1.98728563339682,6,0
26,1,10,13,8,5,1,1.14252179634059,-2,0
26,1,2,16,0,16,0,0.70816998675582,10,0
26,1,10,14,9,5,1,0.770940161542967,-1,0
26,1,2,20,0,20,0,0.838944758172147,10,0
26,1,2,5,19,-14,0,0.784364547405858,-9,0
26,1,2,0,14,-14,0,1.77181256515905,-4,0
26,1,2,13,10,3,1,1.03986554720905,0,0
26,1,10,17,9,8,1,1.27328447139007,-1,0
26,1,10,11,5,6,0,1.22534589155111,5,0
26,1,2,16,9,7,0,0.811501065763878,1,0
26,1,10,13,1,12,0,1.42214988847263,9,0
26,1,10,13,8,5,1,1.12827412533807,-2,0
26,1,10,5,19,-14,0,2.70155987970065,-9,0
26,1,2,20,8,12,1,1.50053425558144,-2,0
26,1,10,10,0,10,0,1.65919991789269,10,0
26,1,2,1,17,-16,0,1.03604419933981,-7,0
26,1,2,6,13,-7,1,1.26945176030858,3,0
26,1,2,15,2,13,0,0.981530701828888,8,0
26,1,10,0,15,-15,0,1.45517879692488,-5,0
26,1,10,1,17,-16,0,1.50391207050416,-7,0
26,1,2,9,18,-9,NaN,NaN,0,0
26,1,10,16,10,6,1,1.6352887271205,0,0
26,1,10,2,12,-10,0,1.18091305470443,-2,0
26,1,2,2,14,-12,1,1.5602645802137,4,0
26,1,2,6,17,-11,1,1.95707700794446,7,0
26,1,10,13,8,5,1,1.29784373342409,-2,0
26,1,2,13,9,4,1,0.728433577285614,-1,0
26,1,2,9,13,-4,1,1.1345997848548,3,0
26,1,2,5,11,-6,1,0.427354252693476,1,0
26,1,2,10,8,2,1,0.653527461487101,-2,0
26,1,10,12,3,9,0,1.55817191116512,7,0
26,1,2,13,5,8,1,1.33094741936657,-5,0
26,1,10,14,9,5,1,1.52837089617969,-1,0
26,1,10,6,20,-14,1,2.72630571882473,10,0
26,1,2,3,18,-15,NaN,NaN,0,0
26,1,2,8,16,-8,1,1.52121975226328,6,0
26,1,10,13,8,5,1,1.14351406384958,-2,0
26,1,10,0,14,-14,0,0.780885196465533,-4,0
26,1,2,10,1,9,0,0.967601201555226,9,0
26,1,10,19,9,10,1,2.13171132237767,-1,0
26,1,10,15,5,10,0,2.53712205772172,5,0
26,1,2,7,20,-13,1,1.67053749962361,10,0
26,1,10,19,7,12,1,1.62999382353155,-3,0
26,1,10,14,1,13,0,3.95073961868184,9,0
26,1,2,2,14,-12,0,1.67472467050538,-4,0
26,1,2,11,3,8,0,1.80300429419731,7,0
26,1,10,6,20,-14,1,2.35780168944621,10,0
26,1,2,5,11,-6,0,0.721825302985962,-1,0
26,1,2,20,2,18,0,0.543260040431051,8,0
26,1,2,20,9,11,1,1.10794125573011,-1,0
26,1,10,5,16,-11,0,1.57071289670421,-6,0
26,1,2,10,11,-1,1,1.11881954257842,1,0
26,1,10,0,17,-17,0,0.740231553529156,-7,0
26,1,10,6,13,-7,0,3.26479869653122,-3,0
26,1,10,11,6,5,0,1.51243413443444,4,0
26,1,2,11,1,10,0,0.862332506745588,9,0
26,1,10,12,1,11,0,1.05397319374606,9,0
26,1,2,4,19,-15,0,0.838573070243001,-9,0
26,1,10,3,10,-7,NaN,NaN,0,0
26,1,10,10,1,9,0,1.51614478236297,9,0
26,1,2,15,5,10,0,0.889558464783477,5,0
26,1,2,17,0,17,0,1.60893297338043,10,0
26,1,10,20,2,18,0,1.45106347103138,8,0
26,1,10,16,3,13,0,2.37911106468528,7,0
26,1,2,2,13,-11,NaN,NaN,0,0
26,1,2,16,9,7,1,1.27475252875593,-1,0
26,1,10,13,9,4,1,1.31413202252588,-1,0
26,1,2,10,10,0,1,1.24030284871696,0,0
26,1,10,3,17,-14,0,1.89685843052575,-7,0
26,1,2,10,4,6,0,1.4550783605373,6,0
26,1,10,2,14,-12,0,1.47917869428056,-4,0
26,1,10,8,19,-11,1,1.54985365245375,9,0
26,1,10,15,2,13,1,2.18604154180503,-8,0
26,1,10,20,2,18,0,1.66137102997163,8,0
26,1,2,7,18,-11,1,1.07751452937373,8,0
26,1,2,12,9,3,1,0.853031144448323,-1,0
26,1,2,0,20,-20,0,1.17300680512562,-10,0
26,1,2,18,4,14,0,1.44033620532718,6,0
26,1,2,17,10,7,0,0.961209928558674,0,0
26,1,10,20,0,20,0,0.749248101696139,10,0
26,1,10,1,19,-18,0,2.84934175680974,-9,0
26,1,10,12,0,12,0,1.81013271166012,10,0
26,1,2,20,6,14,NaN,NaN,0,0
26,1,2,10,15,-5,1,0.953008234704612,5,0
26,1,10,18,3,15,1,0.877108385175234,-7,0
26,1,2,17,0,17,1,1.02848104629084,-10,0
26,1,10,8,16,-8,1,1.59724349775934,6,0
26,1,2,19,9,10,1,0.935508844064316,-1,0
26,1,2,2,12,-10,0,1.55545243111555,-2,0
26,1,2,9,18,-9,1,1.04017052191193,8,0
26,1,2,9,20,-11,1,1.18486159754684,10,0
26,1,10,8,12,-4,1,2.09167166100815,2,0
26,1,2,3,17,-14,1,0.586432657233672,7,0
26,1,10,10,0,10,0,1.47728249931242,10,0
26,1,2,15,10,5,1,0.980627507495228,0,0
26,1,10,14,1,13,0,2.50398721452802,9,0
26,1,10,18,9,9,1,1.30284465901786,-1,0
26,1,10,7,17,-10,1,1.55687320273137,7,0
26,1,2,16,1,15,0,1.53672874296899,9,0
26,1,2,7,18,-11,1,1.38954251958057,8,0
26,1,10,5,10,-5,0,1.35220474359812,0,0
26,1,10,13,1,12,0,1.67620299148257,9,0
26,1,10,15,5,10,1,3.48352128497208,-5,0
26,1,2,0,14,-14,0,0.634610231674742,-4,0
26,1,10,12,1,11,0,1.57935812353389,9,0
26,1,10,18,9,9,1,1.50193926531938,-1,0
26,1,2,4,16,-12,1,1.60397236901917,6,0
26,1,2,3,14,-11,0,0.622218801028794,-4,0
26,1,10,12,5,7,1,1.85432508765371,-5,0
26,1,10,0,17,-17,0,1.83837293056422,-7,0
26,1,2,15,6,9,1,1.22315535199596,-4,0
26,1,2,16,9,7,1,1.49661063856911,-1,0
26,1,2,3,17,-14,0,0.894699048250914,-7,0
26,1,10,12,10,2,1,0.885394386947155,0,0
26,1,10,7,11,-4,1,1.34818802130758,1,0
26,1,2,20,9,11,NaN,NaN,0,0
26,1,2,9,18,-9,1,1.0203775895061,8,0
26,1,10,15,2,13,0,1.58197313509299,8,0
26,1,2,15,9,6,1,1.015937128308,-1,0
26,1,10,2,14,-12,0,1.64857418823522,-4,0
26,1,2,2,18,-16,1,1.71270648567588,8,0
26,1,10,9,12,-3,1,1.26211807140498,2,0
26,1,10,7,18,-11,1,1.88559672591509,8,0
26,1,2,10,1,9,0,1.02823728646035,9,0
26,1,2,4,14,-10,0,1.96557341294829,-4,0
26,1,10,10,15,-5,0,1.20851913146907,-5,0
26,1,10,15,3,12,1,2.16252439888194,-7,0
26,1,2,10,9,1,0,1.12604839642881,1,0
26,1,2,13,7,6,1,0.930092976952437,-3,0
26,1,2,18,0,18,0,1.71085794299142,10,0
26,1,10,18,7,11,1,1.46091100201011,-3,0
26,1,10,16,4,12,1,2.18837357201846,-6,0
26,1,10,9,12,-3,1,0.911119664087892,2,0
26,1,2,17,6,11,NaN,NaN,0,0
26,1,10,8,16,-8,1,1.00132436736021,6,0
26,1,2,18,9,9,1,1.01944030541927,-1,0
26,1,10,5,19,-14,1,1.10899070597952,9,0
26,1,2,0,16,-16,0,1.20277666283073,-6,0
27,1,10,20,3,17,1,0.90485043649096,-7,0
27,1,2,17,3,14,1,0.862865982053336,-7,0
27,1,10,20,8,12,1,1.23099184231251,-2,0
27,1,2,10,9,1,1,1.05614373346907,-1,0
27,1,2,11,5,6,0,1.26551690642373,5,0
27,1,2,10,16,-6,NaN,NaN,0,0
27,1,10,10,12,-2,0,0.950625434139511,-2,0
27,1,2,15,0,15,1,1.16320632820134,-10,0
27,1,10,5,11,-6,0,0.735864272108302,-1,0
27,1,10,1,17,-16,0,1.12575469052535,-7,0
27,1,10,6,20,-14,1,0.995771790330764,10,0
27,1,10,10,20,-10,1,0.695045828528237,10,0
27,1,10,11,8,3,0,0.621696745540248,2,0
27,1,10,6,17,-11,0,0.775631069904193,-7,0
27,1,10,1,20,-19,0,0.58755106566241,-10,0
27,1,2,10,20,-10,0,0.943014290125575,-10,0
27,1,2,0,14,-14,0,0.620563724631211,-4,0
27,1,2,20,0,20,1,0.614153780741617,-10,0
27,1,2,16,9,7,1,0.672851301555056,-1,0
27,1,2,11,0,11,0,1.21671306638746,10,0
27,1,10,13,0,13,0,1.02679588945466,10,0
27,1,10,11,10,1,1,0.932935865741456,0,0
27,1,2,10,10,0,1,0.866638930689078,0,0
27,1,2,9,15,-6,0,1.03454045939725,-5,0
27,1,10,11,5,6,1,1.13982856232906,-5,0
27,1,10,0,12,-12,0,0.866052809549728,-2,0
27,1,2,11,0,11,0,1.13793420707225,10,0
27,1,2,11,8,3,1,0.783197494252818,-2,0
27,1,10,12,5,7,1,0.994452193030156,-5,0
27,1,2,9,20,-11,0,1.0376385806303,-10,0
27,1,2,2,12,-10,0,0.774314771610079,-2,0
27,1,10,16,9,7,1,0.682521750451997,-1,0
27,1,10,11,0,11,0,0.977607533452101,10,0
27,1,2,15,10,5,1,0.821586412552278,0,0
27,1,2,9,16,-7,0,0.967453965306049,-6,0
27,1,2,11,3,8,0,0.819681060645962,7,0
27,1,10,1,19,-18,0,0.765324648411479,-9,0
27,1,10,11,1,10,0,0.82536705880193,9,0
27,1,2,17,8,9,0,0.87534094179864,2,0
27,1,10,11,8,3,1,0.691457623528549,-2,0
27,1,2,11,8,3,1,1.10704390043975,-2,0
27,1,10,5,11,-6,0,0.825946581957396,-1,0
27,1,10,3,12,-9,0,1.0039855504001,-2,0
27,1,2,6,15,-9,0,0.974292411759961,-5,0
27,1,2,11,5,6,1,1.17846343893325,-5,0
27,1,10,11,1,10,0,0.741767637227895,9,0
27,1,2,10,15,-5,1,0.706909008265939,5,0
27,1,10,11,3,8,0,0.873500470101135,7,0
27,1,10,12,5,7,0,0.985555907856906,5,0
27,1,2,9,12,-3,0,1.01272641634569,-2,0
27,1,2,11,0,11,0,0.78239327299525,10,0
27,1,10,13,0,13,0,0.794010494457325,10,0
27,1,2,11,5,6,1,1.34984467239701,-5,0
27,1,10,1,11,-10,0,0.706860623031389,-1,0
27,1,10,3,15,-12,0,0.809174500260269,-5,0
27,1,2,20,2,18,0,0.691978864459088,8,0
27,1,2,20,8,12,1,0.579126536555123,-2,0
27,1,2,8,14,-6,0,0.84646192137734,-4,0
27,1,10,6,14,-8,0,0.655321917613037,-4,0
27,1,10,11,3,8,0,0.967679029941792,7,0
27,1,10,10,0,10,0,0.722979137528455,10,0
27,1,2,8,18,-10,0,0.721088447840884,-8,0
27,1,10,9,11,-2,0,0.799150325969094,-1,0
27,1,2,11,8,3,1,0.665473286411725,-2,0
27,1,10,11,3,8,0,0.737500939285383,7,0
27,1,2,6,20,-14,0,0.686861392809078,-10,0
27,1,10,5,12,-7,0,0.646327395748813,-2,0
27,1,10,2,18,-16,0,0.726668511662865,-8,0
27,1,2,10,12,-2,1,0.708729319449048,2,0
27,1,2,19,3,16,1,0.955222764518112,-7,0
27,1,10,8,18,-10,0,0.703192509099608,-8,0
27,1,2,10,20,-10,1,0.925790979439626,10,0
27,1,10,15,9,6,1,0.827962633426068,-1,0
27,1,2,13,8,5,1,0.630016073439037,-2,0
27,1,10,12,5,7,1,0.687266802415252,-5,0
27,1,2,15,8,7,1,0.718525863194373,-2,0
27,1,2,3,13,-10,0,0.636481367109809,-3,0
27,1,10,19,8,11,1,0.653762593457941,-2,0
27,1,2,11,1,10,0,0.750179336930159,9,0
27,1,10,1,15,-14,0,0.754873437806964,-5,0
27,1,10,12,4,8,0,0.788230291713262,6,0
27,1,2,11,3,8,0,0.719665115553653,7,0
27,1,10,15,0,15,0,0.701461637276225,10,0
27,1,2,6,12,-6,0,0.620169678208185,-2,0
27,1,10,10,20,-10,0,1.07785844019963,-10,0
27,1,10,16,1,15,1,0.694351573707536,-9,0
27,1,2,14,1,13,0,0.861541986087104,9,0
27,1,2,14,6,8,1,1.20530844668974,-4,0
27,1,2,10,10,0,1,0.831803028122522,0,0
27,1,10,17,8,9,1,0.809168268810026,-2,0
27,1,10,19,6,13,1,1.03505033714464,-4,0
27,1,10,14,1,13,0,0.972321080014808,9,0
27,1,2,6,12,-6,0,0.824388724053279,-2,0
27,1,10,17,8,9,1,0.682264428964118,-2,0
27,1,10,13,0,13,1,0.761782995861722,-10,0
27,1,2,3,18,-15,0,0.478161581035238,-8,0
27,1,2,6,17,-11,0,0.710272148629883,-7,0
27,1,2,11,3,8,0,0.684771663858555,7,0
27,1,10,13,8,5,1,1.03612580892514,-2,0
27,1,2,7,16,-9,0,1.41325058968505,-6,0
27,1,10,16,1,15,1,0.918735532555729,-9,0
27,1,2,2,18,-16,0,0.772557874413906,-8,0
27,1,2,6,20,-14,0,1.69651058153249,-10,0
27,1,10,11,3,8,0,0.751251143199624,7,0
27,1,10,5,11,-6,0,0.651918822783045,-1,0
27,1,2,15,4,11,1,0.971757318737218,-6,0
27,1,2,9,13,-4,0,0.831178785272641,-3,0
27,1,10,14,2,12,0,1.00826617743587,8,0
27,1,10,10,4,6,0,1.47490327537525,6,0
27,1,2,10,15,-5,1,1.30689178017201,5,0
27,1,2,12,4,8,0,0.816321952414,6,0
27,1,2,12,0,12,0,0.842248007335002,10,0
27,1,10,9,16,-7,0,0.73143519036239,-6,0
27,1,2,3,14,-11,0,0.792058956663823,-4,0
27,1,2,17,8,9,1,0.786854978097836,-2,0
27,1,10,9,10,-1,0,0.781986030604457,0,0
27,1,10,16,7,9,1,0.713374668499455,-3,0
27,1,10,11,1,10,0,0.935238929581828,9,0
27,1,10,17,9,8,1,0.771870217606192,-1,0
27,1,2,11,0,11,0,0.631175119720865,10,0
27,1,10,16,1,15,1,0.878001396573381,-9,0
27,1,2,17,5,12,1,0.733197219320573,-5,0
27,1,10,9,10,-1,0,0.506343414192088,0,0
27,1,2,10,19,-9,0,1.06420720610186,-9,0
27,1,2,1,19,-18,0,0.688188687752699,-9,0
27,1,10,20,2,18,1,0.703797691094223,-8,0
27,1,10,8,13,-5,0,0.854248645104235,-3,0
27,1,2,7,10,-3,0,0.686764622339979,0,0
27,1,10,14,1,13,0,1.14940700595616,9,0
27,1,2,11,1,10,0,0.689378158102045,9,0
27,1,10,12,0,12,0,0.623994677618612,10,0
27,1,2,10,4,6,0,1.07386079349089,6,0
27,1,10,20,7,13,1,0.754147659259615,-3,0
27,1,2,14,1,13,0,0.894509925390594,9,0
27,1,10,7,19,-12,0,0.765931296627969,-9,0
27,1,2,17,8,9,1,0.681912169820862,-2,0
27,1,10,2,11,-9,0,0.584456243435852,-1,0
27,1,10,18,7,11,1,0.651729680481367,-3,0
27,1,2,5,19,-14,0,0.628294732072391,-9,0
27,1,2,2,14,-12,0,0.621787651121849,-4,0
27,1,2,6,14,-8,0,0.686859193461714,-4,0
27,1,10,0,13,-13,0,0.69367711286759,-3,0
27,1,2,14,0,14,0,0.932443582627457,10,0
27,1,2,8,20,-12,0,1.19295701594092,-10,0
27,1,10,11,8,3,1,0.995401936495909,-2,0
27,1,10,6,19,-13,0,0.813305572926765,-9,0
27,1,10,17,8,9,1,0.751056869165041,-2,0
27,1,2,1,14,-13,0,0.546811797918053,-4,0
27,1,2,11,0,11,0,0.543446824798593,10,0
27,1,10,18,10,8,1,0.604034668765962,0,0
27,1,2,10,3,7,0,0.653864129126305,7,0
27,1,10,16,7,9,1,0.837767974473536,-3,0
27,1,10,0,19,-19,0,0.878367218276253,-9,0
27,1,10,10,7,3,0,0.77319091456593,3,0
27,1,2,14,1,13,0,0.976996486569988,9,0
27,1,10,14,2,12,0,1.10775721608661,8,0
27,1,10,5,15,-10,0,0.874233213166008,-5,0
27,1,2,11,6,5,0,0.826328532071784,4,0
27,1,2,11,8,3,0,0.843474499677541,2,0
27,1,2,15,8,7,1,0.708110941486666,-2,0
27,1,2,3,18,-15,0,1.26867734198458,-8,0
27,1,10,20,8,12,1,0.684526805212954,-2,0
27,1,10,10,16,-6,0,0.843148999032564,-6,0
27,1,2,11,1,10,0,0.987740574521013,9,0
27,1,2,12,0,12,0,0.926525555289118,10,0
27,1,10,10,3,7,0,0.691585551132448,7,0
27,1,2,16,2,14,1,0.770473643788137,-8,0
27,1,2,17,2,15,0,1.26175642068847,8,0
27,1,10,17,3,14,1,0.781521605676971,-7,0
27,1,10,19,8,11,1,0.704137487366097,-2,0
27,1,10,15,2,13,0,1.19678678057971,8,0
27,1,2,11,5,6,0,0.814716442371719,5,0
27,1,10,15,1,14,0,0.736211399460444,9,0
27,1,10,20,2,18,1,0.812612784327939,-8,0
27,1,10,12,2,10,0,0.765883644518908,8,0
27,1,2,13,5,8,0,0.7933320015145,5,0
27,1,2,19,9,10,1,1.04462951389723,-1,0
27,1,10,20,5,15,1,1.01311643063673,-5,0
27,1,2,18,8,10,1,0.734592326916754,-2,0
27,1,2,10,7,3,0,1.05122530108201,3,0
27,1,2,5,19,-14,0,0.721850881818682,-9,0
27,1,10,15,5,10,1,0.886978690337855,-5,0
27,1,2,10,0,10,0,0.797530153708067,10,0
27,1,2,14,9,5,1,1.10356822775793,-1,0
27,1,2,20,6,14,1,1.38151354144793,-4,0
27,1,2,10,15,-5,0,1.08836426748894,-5,0
27,1,10,12,0,12,0,0.822742526419461,10,0
27,1,10,10,12,-2,1,1.23214502373594,2,0
27,1,10,7,16,-9,0,0.624871110165259,-6,0
27,1,10,7,14,-7,0,1.00197609694442,-4,0
27,1,2,10,13,-3,1,1.04321717823041,3,0
27,1,10,10,7,3,0,0.795912547357148,3,0
27,1,2,15,4,11,0,1.57383531791857,6,0
27,1,2,14,2,12,0,0.785112743091304,8,0
27,1,2,5,13,-8,0,0.651851743255975,-3,0
27,1,10,15,1,14,0,0.883882035326678,9,0
27,1,10,3,11,-8,0,0.706350745313102,-1,0
27,1,2,0,13,-13,0,0.824294885998825,-3,0
27,1,10,12,4,8,1,1.09770591673441,-6,0
27,1,10,15,2,13,0,1.26365847355919,8,0
28,1,10,20,0,20,0,1.14128745044582,10,0
28,1,10,10,12,-2,1,1.34592913395863,2,0
28,1,2,0,14,-14,0,1.05455398527556,-4,0
28,1,2,1,20,-19,0,0.663170222554982,-10,0
28,1,2,1,17,-16,0,0.719111984326446,-7,0
28,1,2,11,5,6,0,1.26897755035134,5,0
28,1,10,17,3,14,0,0.764995848765466,7,0
28,1,10,10,9,1,0,0.912942500381178,1,0
28,1,2,6,17,-11,0,1.17536238524553,-7,0
28,1,10,10,16,-6,1,0.811468766780308,6,0
28,1,2,6,20,-14,0,1.48546665176036,-10,0
28,1,10,15,0,15,0,2.14072662159197,10,0
28,1,2,16,9,7,1,0.690068014244389,-1,0
28,1,2,10,20,-10,1,0.689366794900707,10,0
28,1,10,20,3,17,1,1.07257015400864,-7,0
28,1,2,5,11,-6,1,0.800513909838628,1,0
28,1,10,20,8,12,1,1.34720987645233,-2,0
28,1,10,11,8,3,0,0.775782457054447,2,0
28,1,2,10,20,-10,1,0.795752362902931,10,0
28,1,10,11,0,11,0,0.982308598826421,10,0
28,1,10,6,15,-9,0,0.763890319471102,-5,0
28,1,10,9,19,-10,1,1.62364095223529,9,0
28,1,2,5,11,-6,0,0.625530908817382,-1,0
28,1,2,13,0,13,0,0.667506932468314,10,0
28,1,10,1,15,-14,0,1.10730305468496,-5,0
28,1,2,8,20,-12,1,0.88199391152375,10,0
28,1,10,7,12,-5,0,0.713375401606754,-2,0
28,1,2,8,15,-7,1,1.24730133187586,5,0
28,1,2,2,11,-9,0,0.775902320476234,-1,0
28,1,10,20,1,19,0,0.755791291025162,9,0
28,1,2,1,10,-9,0,0.896008034880651,0,0
28,1,2,3,20,-17,0,0.470454399664959,-10,0
28,1,10,15,6,9,0,0.726378566807398,4,0
28,1,10,11,5,6,0,1.1563851098108,5,0
28,1,2,5,11,-6,0,0.561027892987113,-1,0
28,1,10,18,4,14,0,0.508964281067165,6,0
28,1,2,18,6,12,0,0.499581577689241,4,0
28,1,2,13,1,12,0,0.770171236077658,9,0
28,1,10,10,2,8,0,0.638329902991245,8,0
28,1,10,9,15,-6,0,1.3594033220852,-5,0
28,1,2,15,9,6,1,1.22124515002179,-1,0
28,1,10,20,8,12,1,1.01528863441854,-2,0
28,1,2,3,14,-11,0,1.13714244869698,-4,0
28,1,10,15,2,13,0,0.422520760748739,8,0
28,1,10,13,1,12,0,0.584329782028362,9,0
28,1,2,6,16,-10,0,1.32391238607124,-6,0
28,1,2,5,14,-9,0,0.617854151507345,-4,0
28,1,2,7,10,-3,0,0.691654830001426,0,0
28,1,10,16,8,8,1,0.962983829434961,-2,0
28,1,10,14,9,5,1,0.998906933567923,-1,0
28,1,10,1,12,-11,0,1.00877532206505,-2,0
28,1,2,3,13,-10,0,0.467536256852327,-3,0
28,1,2,20,0,20,0,0.915521213442844,10,0
28,1,10,13,7,6,0,0.769361516511708,3,0
28,1,10,19,3,16,0,0.597567542305114,7,0
28,1,2,8,14,-6,0,0.903986466795686,-4,0
28,1,2,14,5,9,0,0.702548838846269,5,0
28,1,10,10,16,-6,1,0.71706807472583,6,0
28,1,10,17,3,14,0,0.371212251728139,7,0
28,1,2,1,16,-15,0,0.559202450052908,-6,0
28,1,2,15,9,6,1,0.979682233637504,-1,0
28,1,10,16,9,7,1,0.782991856984154,-1,0
28,1,10,15,4,11,0,0.754498452221014,6,0
28,1,10,5,11,-6,0,0.918805544508359,-1,0
28,1,2,11,5,6,0,0.773167088509581,5,0
28,1,2,12,5,7,0,1.01687435051099,5,0
28,1,2,19,6,13,1,1.63463722987217,-4,0
28,1,2,10,2,8,0,1.07593109502886,8,0
28,1,10,1,15,-14,1,1.5237826256689,5,0
28,1,10,15,8,7,1,1.7619593087511,-2,0
28,1,2,1,11,-10,0,0.90959952054618,-1,0
28,1,10,6,14,-8,0,0.675189554653116,-4,0
28,1,2,5,11,-6,0,0.803096288449524,-1,0
28,1,2,16,5,11,0,0.701655178227156,5,0
28,1,10,16,1,15,0,0.876373160124785,9,0
28,1,10,4,14,-10,0,0.756318030282273,-4,0
28,1,10,17,4,13,0,0.664948746474693,6,0
28,1,2,18,7,11,1,1.26488276660893,-3,0
28,1,10,20,5,15,1,1.73697016793631,-5,0
28,1,2,10,1,9,0,0.926139206518201,9,0
28,1,10,10,2,8,0,0.847363646193116,8,0
28,1,2,10,18,-8,1,0.751935134459927,8,0
28,1,10,4,13,-9,0,1.0927445974412,-3,0
28,1,2,6,10,-4,0,0.707939393827473,0,0
28,1,10,10,20,-10,1,0.770446518738026,10,0
28,1,2,18,2,16,0,0.6783668517146,8,0
28,1,10,20,7,13,1,1.26178134639304,-3,0
28,1,10,9,10,-1,0,0.797677142192697,0,0
28,1,2,12,7,5,0,0.816150404767541,3,0
28,1,2,5,11,-6,0,0.666436958987106,-1,0
28,1,2,10,9,1,0,0.5616602000282,1,0
28,1,10,10,16,-6,1,0.91745698937666,6,0
28,1,10,19,9,10,1,1.09152690237352,-1,0
28,1,10,2,19,-17,0,0.706799041827253,-9,0
28,1,2,10,1,9,0,0.601619072580434,9,0
28,1,2,12,1,11,0,0.956101762943945,9,0
28,1,2,16,7,9,1,1.36852687121609,-3,0
28,1,2,13,5,8,0,0.956535763836655,5,0
28,1,10,16,9,7,1,1.06520753416771,-1,0
28,1,10,14,2,12,0,0.777016280531825,8,0
28,1,10,8,12,-4,0,0.683894498195514,-2,0
28,1,2,2,17,-15,0,0.691324197565336,-7,0
28,1,2,11,5,6,0,1.09835728463622,5,0
28,1,10,16,1,15,0,1.27306756887992,9,0
28,1,10,9,11,-2,0,0.632801523401213,-1,0
28,1,2,12,5,7,0,0.94622934234576,5,0
28,1,2,16,3,13,0,0.614820910484923,7,0
28,1,10,18,3,15,0,0.544844498286693,7,0
28,1,10,7,14,-7,0,0.573507984481694,-4,0
28,1,2,15,10,5,1,0.537694846789236,0,0
28,1,2,2,15,-13,0,0.541308710624435,-5,0
28,1,2,13,2,11,0,0.617979879807535,8,0
28,1,10,15,7,8,0,0.915819222500431,3,0
28,1,10,3,16,-13,0,0.521277956677295,-6,0
28,1,10,16,3,13,0,0.60650378192986,7,0
28,1,2,16,5,11,0,0.809097890292833,5,0
28,1,2,19,3,16,0,0.707629288463067,7,0
28,1,2,15,5,10,0,0.474281598399102,5,0
28,1,10,3,18,-15,0,0.578304720676897,-8,0
28,1,10,17,2,15,0,0.413099202560261,8,0
28,1,2,9,11,-2,0,0.586860476410948,-1,0
28,1,2,7,11,-4,0,0.582005458001731,-1,0
28,1,10,10,16,-6,1,0.633500176862071,6,0
28,1,10,2,13,-11,0,0.618498921412538,-3,0
28,1,2,9,19,-10,0,0.604687502864181,-9,0
28,1,10,2,16,-14,0,0.75925670016295,-6,0
28,1,2,10,19,-9,1,0.61189177102824,9,0
28,1,10,18,2,16,0,0.597775378879305,8,0
28,1,2,13,1,12,0,0.792638846378395,9,0
28,1,10,18,0,18,0,0.635961592386593,10,0
28,1,10,18,6,12,1,0.915708889504458,-4,0
28,1,2,2,12,-10,0,0.97790847493161,-2,0
28,1,2,17,4,13,0,0.532349378047002,6,0
28,1,10,14,4,10,0,0.544942734975848,6,0
28,1,10,7,10,-3,0,0.773077649137122,0,0
28,1,10,13,0,13,0,0.584139906637574,10,0
28,1,2,1,14,-13,0,0.859628203459579,-4,0
28,1,2,19,4,15,0,0.531602339353412,6,0
28,1,2,0,10,-10,0,0.832083442535804,0,0
28,1,10,15,5,10,0,0.880676513550497,5,0
28,1,2,6,19,-13,1,1.78347570932965,9,0
28,1,2,15,5,10,0,0.570572613591139,5,0
28,1,2,17,2,15,0,0.669822825735537,8,0
28,1,10,15,10,5,1,0.781402475344294,0,0
28,1,2,13,7,6,0,0.856461903043964,3,0
28,1,10,17,3,14,0,0.793120865950186,7,0
28,1,10,11,5,6,0,1.0915789531573,5,0
28,1,10,11,6,5,0,0.802231585661502,4,0
28,1,10,2,20,-18,0,0.980147391686842,-10,0
28,1,2,16,6,10,0,0.998966682000173,4,0
28,1,10,1,14,-13,0,0.592214009357122,-4,0
28,1,10,1,17,-16,0,0.610146237038862,-7,0
28,1,2,17,1,16,0,0.507831260159946,9,0
28,1,10,6,20,-14,1,1.20204244338129,10,0
28,1,2,10,13,-3,1,0.643787537503158,3,0
28,1,2,16,5,11,0,0.644332604499141,5,0
28,1,10,10,12,-2,1,0.572608458985997,2,0
28,1,10,11,0,11,0,0.815858993697475,10,0
28,1,2,14,5,9,0,0.68891996459206,5,0
28,1,2,0,17,-17,0,0.71244508550808,-7,0
28,1,10,5,11,-6,0,1.01890726346755,-1,0
28,1,2,20,1,19,0,0.604263398952753,9,0
28,1,2,8,14,-6,1,1.04634645660917,4,0
28,1,10,8,15,-7,1,1.24609866555693,5,0
28,1,2,14,2,12,0,1.33404066192452,8,0
28,1,10,9,20,-11,1,0.84276448304081,10,0
28,1,10,10,15,-5,1,0.731390470675251,5,0
28,1,10,1,19,-18,0,0.68867840497478,-9,0
28,1,2,10,17,-7,1,0.559247169738228,7,0
28,1,2,3,13,-10,0,1.08316542068496,-3,0
28,1,10,18,6,12,1,0.953248866888316,-4,0
28,1,10,10,4,6,0,1.11703691756702,6,0
28,1,2,6,20,-14,1,1.06635045205257,10,0
28,1,2,12,2,10,0,0.92970761756078,8,0
28,1,10,17,7,10,1,0.966451804455573,-3,0
28,1,10,20,0,20,0,0.793862406320841,10,0
28,1,2,0,12,-12,0,0.723758799606003,-2,0
28,1,2,14,1,13,0,1.11311038248095,9,0
28,1,2,8,14,-6,1,1.15875965184387,4,0
28,1,10,14,5,9,0,1.79499212823794,5,0
28,1,10,12,2,10,0,0.612755007598025,8,0
28,1,10,12,10,2,1,0.725821036947309,0,0
28,1,2,11,4,7,0,0.763309330104676,6,0
28,1,2,17,2,15,0,0.582698246587825,8,0
28,1,2,18,2,16,0,0.513220715478383,8,0
28,1,10,0,18,-18,0,1.06271386182198,-8,0
28,1,2,1,14,-13,0,1.28576246148805,-4,0
28,1,2,10,4,6,0,0.95636641551755,6,0
28,1,10,17,8,9,1,0.848475773473183,-2,0
28,1,10,13,10,3,1,0.96020681022128,0,0
28,1,2,10,15,-5,1,0.7307596298524,5,0
28,1,2,15,0,15,0,1.58356075004485,10,0
28,1,10,5,13,-8,0,1.08194625939723,-3,0
28,1,10,8,12,-4,0,0.648742991932522,-2,0
28,1,10,3,19,-16,0,0.744644725917169,-9,0
28,1,2,3,20,-17,0,0.541313475834613,-10,0
28,1,10,4,20,-16,0,1.3299565082707,-10,0
28,1,10,1,14,-13,0,0.526495497790165,-4,0
28,1,2,2,10,-8,0,0.699925772652932,0,0
28,1,2,14,1,13,0,0.978011476829124,9,0
29,1,2,20,8,12,0,0.667317670389821,2,0
29,1,2,10,20,-10,0,0.85916216260739,-10,0
29,1,2,15,0,15,0,0.363999420840628,10,0
29,1,10,10,20,-10,0,0.880187823371671,-10,0
29,1,10,1,20,-19,0,0.496268275115654,-10,0
29,1,2,11,8,3,0,0.511934884963921,2,0
29,1,2,11,0,11,0,0.526421550568557,10,0
29,1,10,6,17,-11,0,0.388269836643303,-7,0
29,1,10,0,14,-14,0,0.327886308945381,-4,0
29,1,10,6,20,-14,0,0.269959807119449,-10,0
29,1,2,1,17,-16,0,0.2858749420393,-7,0
29,1,10,20,0,20,0,0.285959983064458,10,0
29,1,2,10,16,-6,0,0.269994263395347,-6,0
29,1,10,10,9,1,0,0.462194315081433,1,0
29,1,10,20,3,17,0,0.534222231995955,7,0
29,1,2,16,9,7,0,0.307474996288875,1,0
29,1,2,11,5,6,0,0.242422276349316,5,0
29,1,2,17,3,14,0,0.243858809901212,7,0
29,1,10,10,12,-2,0,0.301791909740132,-2,0
29,1,10,5,11,-6,0,0.276581277410514,-1,0
29,1,10,2,17,-15,0,0.365357877934002,-7,0
29,1,2,13,4,9,0,0.321476708106275,6,0
29,1,10,0,10,-10,0,0.351467599184616,0,0
29,1,2,10,4,6,0,0.404277710269525,6,0
29,1,10,5,16,-11,0,0.43092707548567,-6,0
29,1,10,18,8,10,0,0.336355955345425,2,0
29,1,10,10,19,-9,0,0.621828418732548,-9,0
29,1,2,18,5,13,0,0.439866280315982,5,0
29,1,2,16,7,9,0,0.553396417646582,3,0
29,1,2,14,1,13,0,1.43796715290227,9,0
29,1,10,20,3,17,0,1.02207731035742,7,0
29,1,2,0,16,-16,0,0.712068677959905,-6,0
29,1,2,3,15,-12,0,0.686251395203726,-5,0
29,1,2,13,8,5,0,0.701589204187258,2,0
29,1,2,2,11,-9,0,1.64425102498353,-1,0
29,1,10,10,7,3,0,1.11782470918479,3,0
29,1,10,10,15,-5,0,0.819841684398853,-5,0
29,1,2,8,10,-2,0,0.942739897254796,0,0
29,1,10,17,5,12,0,0.436655248442548,5,0
29,1,10,17,9,8,0,0.33404151981631,1,0
29,1,2,7,13,-6,0,0.414222378618433,-3,0
29,1,2,15,0,15,0,0.296317027081386,10,0
29,1,10,12,0,12,0,0.35099327552598,10,0
29,1,2,19,6,13,0,0.235792375266101,4,0
29,1,10,12,10,2,0,0.253178500015565,0,0
29,1,2,6,15,-9,0,0.429880924233657,-5,0
29,1,10,20,10,10,0,0.199305009538875,0,0
29,1,2,16,7,9,0,0.418169455242605,3,0
29,1,10,18,0,18,0,0.516137817779963,10,0
29,1,10,4,14,-10,0,0.418255962495095,-4,0
29,1,10,16,3,13,0,0.53958531502758,7,0
29,1,2,13,5,8,0,0.56899704739044,5,0
29,1,2,5,11,-6,0,0.533011130477462,-1,0
29,1,10,19,7,12,0,0.88249272844223,3,0
29,1,10,18,0,18,0,0.673819643376191,10,0
29,1,10,18,8,10,0,0.977957145922119,2,0
29,1,2,20,7,13,0,1.15800366189433,3,0
29,1,10,18,9,9,0,1.85875491872503,1,0
29,1,2,4,14,-10,0,0.851492708281512,-4,0
29,1,2,8,17,-9,0,1.54827269578163,-7,0
29,1,2,16,4,12,0,1.9436515223988,6,0
29,1,10,8,18,-10,0,0.437177957512176,-8,0
29,1,10,17,2,15,0,0.358523071960008,8,0
29,1,2,19,6,13,0,0.339284372428665,4,0
29,1,10,18,9,9,0,0.360664126434131,1,0
29,1,2,14,8,6,0,0.405377012162717,2,0
29,1,2,18,2,16,0,0.400137825112324,8,0
29,1,10,10,12,-2,0,0.402781428065282,-2,0
29,1,10,16,7,9,0,0.413592635153691,3,0
29,1,2,2,14,-12,0,0.71166803208871,-4,0
29,1,10,7,14,-7,0,0.308426942610822,-4,0
29,1,2,19,8,11,0,0.219190680676547,2,0
29,1,2,1,16,-15,0,0.277147606662766,-6,0
29,1,2,18,8,10,0,0.261283789604931,2,0
29,1,10,13,1,12,0,0.2620264323632,9,0
29,1,2,7,20,-13,0,0.198099772918795,-10,0
29,1,10,18,9,9,0,0.512710151222564,1,0
29,1,2,15,5,10,0,0.470842840883051,5,0
29,1,10,14,8,6,0,0.342951400152742,2,0
29,1,10,10,6,4,0,0.356301375135445,4,0
29,1,2,12,9,3,0,0.251512868870122,1,0
29,1,10,3,15,-12,0,0.396493890424608,-5,0
29,1,10,17,7,10,0,0.327218077083671,3,0
29,1,2,20,5,15,0,0.221230565652149,5,0
29,1,2,4,14,-10,0,0.495422996633351,-4,0
29,1,2,4,10,-6,0,0.566088790896174,0,0
29,1,10,16,5,11,0,1.01019575931059,5,0
29,1,2,3,16,-13,0,0.708960281808686,-6,0
29,1,10,3,18,-15,0,1.21164292299181,-8,0
29,1,10,7,17,-10,0,0.510421741177197,-7,0
29,1,10,8,14,-6,0,1.67644051984826,-4,0
29,1,2,7,20,-13,NaN,NaN,0,0
29,1,2,19,2,17,0,0.201480153733428,8,0
29,1,2,4,17,-13,0,0.444098171068617,-7,0
29,1,10,1,15,-14,0,2.5015125939517,-5,0
29,1,10,4,20,-16,0,0.58027964568646,-10,0
29,1,2,10,15,-5,0,0.543668750538927,-5,0
29,1,2,12,0,12,0,0.853023446763473,10,0
29,1,10,17,5,12,0,0.677793478598687,5,0
29,1,10,6,18,-12,0,0.662509553369091,-8,0
29,1,2,13,9,4,0,0.957353757843521,1,0
29,1,2,0,13,-13,0,1.98608406232233,-3,0
29,1,2,6,10,-4,0,1.68558756201674,0,0
29,1,10,20,3,17,0,0.876916309731314,7,0
29,1,2,10,7,3,0,0.30098255376106,3,0
29,1,2,18,3,15,0,0.699664051287982,7,0
29,1,10,10,9,1,0,0.786441821122935,1,0
29,1,10,9,12,-3,0,1.63786708307452,-2,0
29,1,10,3,11,-8,0,3.18265602920656,-1,0
29,1,10,17,2,15,0,1.5540675819575,8,0
29,1,10,19,4,15,0,0.309474560086528,6,0
29,1,2,9,10,-1,0,0.932144225182128,0,0
29,1,10,15,1,14,0,2.17770422217654,9,0
29,1,10,3,17,-14,0,0.757919353982288,-7,0
29,1,2,11,0,11,0,0.898455149106667,10,0
29,1,10,13,5,8,0,0.673262111473377,5,0
29,1,2,19,0,19,0,0.281231042174113,10,0
29,1,10,16,8,8,0,1.11270391976905,2,0
29,1,2,20,10,10,0,1.72685115437707,0,0
29,1,2,2,20,-18,0,0.70883895172301,-10,0
29,1,10,20,9,11,0,0.406398237597386,1,0
29,1,10,11,4,7,0,0.232450482844797,6,0
29,1,2,17,1,16,0,0.353218637914324,9,0
29,1,10,16,2,14,0,0.645965041539966,8,0
29,1,10,16,3,13,0,0.854638493161474,7,0
29,1,2,9,13,-4,0,1.0146864387043,-3,0
29,1,2,17,3,14,0,0.784777289645717,7,0
29,1,2,10,4,6,NaN,NaN,0,0
29,1,10,19,1,18,0,0.208377274253507,9,0
29,1,2,16,8,8,0,0.771018238001488,2,0
29,1,10,0,11,-11,0,0.878502398194541,-1,0
29,1,10,19,7,12,0,0.365088825719795,3,0
29,1,2,16,8,8,0,0.58456981886593,2,0
29,1,2,20,9,11,0,1.11536145185528,1,0
29,1,10,6,13,-7,0,1.21672925612802,-3,0
29,1,2,8,11,-3,NaN,NaN,0,0
29,1,2,18,0,18,0,0.222379719180026,10,0
29,1,10,11,8,3,0,1.09556265452557,2,0
29,1,2,4,14,-10,0,0.717802349259728,-4,0
29,1,10,13,1,12,0,0.723839529049656,9,0
29,1,2,5,14,-9,0,0.247934547733166,-4,0
29,1,2,13,2,11,0,0.615991378599574,8,0
29,1,2,20,1,19,0,1.72947093118091,9,0
29,1,10,2,18,-16,0,1.39882592065078,-8,0
29,1,10,9,11,-2,0,1.33686400217084,-1,0
29,1,10,6,19,-13,0,1.51036749086779,-9,0
29,1,2,11,8,3,0,0.556448730707416,2,0
29,1,10,17,9,8,0,1.35319151275871,1,0
29,1,10,1,12,-11,0,0.661815662577283,-2,0
29,1,2,20,0,20,0,0.597356397045587,10,0
29,1,2,4,19,-15,0,0.438137601513517,-9,0
29,1,10,2,15,-13,0,1.83884615455099,-5,0
29,1,10,13,8,5,0,1.7441804629234,2,0
29,1,2,18,10,8,0,1.27757574424686,0,0
29,1,2,15,4,11,0,0.365732498317811,6,0
29,1,10,15,7,8,0,1.35316915283329,3,0
29,1,10,3,20,-17,0,0.773261561638719,-10,0
29,1,2,6,17,-11,0,1.46484158359635,-7,0
29,1,2,18,9,9,0,0.392800104100388,1,0
29,1,10,19,9,10,0,0.524024273348914,1,0
29,1,2,8,19,-11,0,0.988928171489533,-9,0
29,1,2,10,0,10,0,0.415712429370615,10,0
29,1,2,5,20,-15,0,0.761144681544465,-10,0
29,1,10,18,2,16,0,1.35712575991602,8,0
29,1,10,8,16,-8,0,1.26528841554318,-6,0
29,1,10,20,6,14,0,1.48867469791185,4,0
29,1,10,16,8,8,0,1.2314450193262,2,0
29,1,2,7,15,-8,0,0.912191107714534,-5,0
29,1,2,12,8,4,0,0.853626065074423,2,0
29,1,10,10,9,1,0,2.47762229687578,1,0
29,1,10,6,20,-14,0,0.299770719127991,-10,0
29,1,2,14,2,12,0,0.354576728448592,8,0
29,1,10,1,11,-10,0,0.655344113749379,-1,0
29,1,2,15,1,14,0,1.39932663635227,9,0
29,1,2,20,2,18,0,0.5534052149942,8,0
29,1,2,16,7,9,0,0.461499324619581,3,0
29,1,10,16,3,13,0,0.36562289802896,7,0
29,1,10,19,1,18,0,0.400957444664527,9,0
29,1,10,17,5,12,0,0.619089144622194,5,0
29,1,2,13,9,4,0,0.540407133916233,1,0
29,1,10,15,4,11,0,0.479918404600539,6,0
29,1,10,18,7,11,0,0.390613963223586,3,0
29,1,2,5,13,-8,0,1.75318088263157,-3,0
29,1,10,10,4,6,0,3.33340187933391,6,0
29,1,2,6,18,-12,0,0.298248044880893,-8,0
29,1,2,16,2,14,NaN,NaN,0,0
29,1,2,15,0,15,0,0.332388351578629,10,0
29,1,2,14,9,5,0,0.329152393886034,1,0
29,1,10,3,17,-14,0,0.71784853533245,-7,0
29,1,10,10,9,1,0,0.579295075867776,1,0
29,1,2,10,4,6,0,0.837412920003771,6,0
29,1,2,7,18,-11,0,1.86205319096189,-8,0
29,1,10,19,6,13,0,0.214219812725787,4,0
29,1,10,6,14,-8,0,0.943532391649569,-4,0
29,1,10,3,18,-15,0,1.07634374902773,-8,0
29,1,2,15,0,15,NaN,NaN,0,0
29,1,2,1,18,-17,0,0.223924020241611,-8,0
29,1,2,3,12,-9,0,1.00132913259949,-2,0
29,1,10,20,4,16,0,0.451360014954844,6,0
29,1,10,1,20,-19,0,0.0669503811259347,-10,0
30,1,2,6,17,-11,0,0.904725074738963,-7,0
30,1,10,20,0,20,0,1.26273145645973,10,0
30,1,10,17,3,14,0,2.39073276138515,7,0
30,1,2,16,9,7,1,1.26604877747013,-1,0
30,1,2,11,8,3,1,1.29778985778103,-2,0
30,1,2,1,17,-16,0,1.1372428847244,-7,0
30,1,2,10,16,-6,0,0.967233665869571,-6,0
30,1,10,6,20,-14,0,0.827192135184305,-10,0
30,1,10,11,5,6,1,1.92579317875789,-5,0
30,1,10,10,20,-10,0,1.45972607360454,-10,0
30,1,2,15,0,15,0,1.21223303355509,10,0
30,1,2,0,14,-14,0,0.894249671458965,-4,0
30,1,2,20,8,12,0,0.989611470227828,2,0
30,1,10,20,3,17,0,1.15274155503721,7,0
30,1,10,11,0,11,0,1.30952730926219,10,0
30,1,10,5,11,-6,0,1.09196163638262,-1,0
30,1,10,10,12,-2,1,1.05195694448776,2,0
30,1,10,1,20,-19,0,0.796896013896912,-10,0
30,1,2,10,20,-10,0,1.02337336723576,-10,0
30,1,2,10,9,1,0,1.29715938353911,1,0
30,1,10,16,1,15,0,1.18527476032614,9,0
30,1,10,4,18,-14,0,0.748533139296342,-8,0
30,1,2,1,11,-10,0,0.73720916165621,-1,0
30,1,2,11,9,2,1,1.75052059945301,-1,0
30,1,10,17,3,14,0,1.01112860391731,7,0
30,1,10,18,9,9,0,3.08569978064043,1,0
30,1,2,19,3,16,0,1.45296680295723,7,0
30,1,2,7,19,-12,0,1.08560520948959,-9,0
30,1,2,2,11,-9,0,1.54890665863059,-1,0
30,1,10,19,2,17,0,0.889616418717196,8,0
30,1,10,15,0,15,0,1.9361113300256,10,0
30,1,10,18,0,18,0,0.997353840852156,10,0
30,1,2,6,15,-9,NaN,NaN,0,0
30,1,10,6,11,-5,0,0.756722340243869,-1,0
30,1,10,20,3,17,0,1.137208428554,7,0
30,1,10,2,16,-14,0,0.69459130053292,-6,0
30,1,2,0,16,-16,0,0.534414181252941,-6,0
30,1,2,7,20,-13,0,0.795902650395874,-10,0
30,1,2,6,14,-8,0,1.33443507488118,-4,0
30,1,2,20,0,20,0,1.01170886016916,10,0
30,1,10,1,20,-19,0,1.61906158304191,-10,0
30,1,10,9,12,-3,0,1.18118474181392,-2,0
30,1,2,10,10,0,1,1.32831067719962,0,0
30,1,10,3,19,-16,0,0.533663477021037,-9,0
30,1,2,18,2,16,0,0.827053944056388,8,0
30,1,2,12,0,12,0,1.22821518965065,10,0
30,1,2,19,4,15,0,1.00546056692838,6,0
30,1,2,19,7,12,0,1.02415816107532,3,0
30,1,10,20,8,12,0,1.49005921694334,2,0
30,1,10,17,5,12,0,0.73741589859128,5,0
30,1,2,19,3,16,0,0.74994547496317,7,0
30,1,2,18,6,12,0,1.37860932774493,4,0
30,1,10,2,11,-9,0,1.77390899541206,-1,0
30,1,2,0,12,-12,0,0.713892976986244,-2,0
30,1,10,14,6,8,0,0.759817895595916,4,0
30,1,2,10,4,6,0,1.33980620247894,6,0
30,1,10,15,0,15,0,1.1530864831002,10,0
30,1,10,0,15,-15,0,1.57372205250431,-5,0
30,1,10,10,9,1,0,1.26567745744251,1,0
30,1,2,6,11,-5,0,0.441665551741607,-1,0
30,1,2,14,2,12,0,0.946227876149351,8,0
30,1,2,13,8,5,0,1.35866544724558,2,0
30,1,10,20,8,12,0,0.819411642878549,2,0
30,1,10,8,11,-3,0,2.02942225465085,-1,0
30,1,2,20,4,16,0,0.534699727460975,6,0
30,1,10,17,5,12,0,1.61196838098112,5,0
30,1,2,18,4,14,0,0.637958949548192,6,0
30,1,10,15,0,15,0,1.07126961756148,10,0
30,1,10,6,20,-14,0,0.687214385077823,-10,0
30,1,2,9,19,-10,1,1.23849448608235,9,0
30,1,2,18,5,13,0,0.967137628496857,5,0
30,1,10,14,0,14,0,1.81906744791195,10,0
30,1,2,8,17,-9,0,1.39702504119487,-7,0
30,1,10,16,5,11,1,2.03165457342402,-5,0
30,1,10,12,2,10,0,2.04089725285303,8,0
30,1,2,14,2,12,0,0.666247083601775,8,0
30,1,2,17,5,12,0,1.12218298047082,5,0
30,1,10,5,10,-5,0,1.05613200369407,0,0
30,1,10,3,18,-15,0,1.5927524783765,-8,0
30,1,2,0,16,-16,0,0.580122099403525,-6,0
30,1,2,1,18,-17,0,1.24604148301296,-8,0
30,1,10,6,16,-10,0,0.47072418400785,-6,0
30,1,10,4,12,-8,0,0.694707498449134,-2,0
30,1,2,17,3,14,0,0.613940079289023,7,0
30,1,10,0,11,-11,0,0.79199994134251,-1,0
30,1,2,6,13,-7,0,0.603151271672687,-3,0
30,1,2,19,5,14,0,1.45387695854879,5,0
30,1,10,20,1,19,0,1.83043614521739,9,0
30,1,2,2,10,-8,0,0.63946842221776,0,0
30,1,10,7,12,-5,0,0.673036778287496,-2,0
30,1,10,13,2,11,0,0.896331702766474,8,0
30,1,10,9,15,-6,0,1.29499194497475,-5,0
30,1,10,9,10,-1,0,1.0782612839248,0,0
30,1,2,2,17,-15,0,0.422241812542779,-7,0
30,1,2,20,6,14,1,1.36016868852312,-4,0
30,1,2,13,10,3,1,1.56470370458555,0,0
30,1,10,14,1,13,0,1.16007448392338,9,0
30,1,10,19,4,15,0,0.932207887875848,6,0
30,1,2,17,3,14,0,0.881349508155836,7,0
30,1,2,19,6,13,0,0.879981525649782,4,0
30,1,2,17,5,12,0,1.20585571302217,5,0
30,1,2,15,0,15,0,1.26442457310623,10,0
30,1,2,7,15,-8,0,0.727804465015652,-5,0
30,1,2,4,10,-6,0,0.725769352720818,0,0
30,1,2,12,8,4,1,1.10775428367197,-2,0
30,1,10,18,2,16,0,0.76234565753839,8,0
30,1,10,10,10,0,1,1.15762113261735,0,0
30,1,10,2,13,-11,0,1.34560839849291,-3,0
30,1,10,2,15,-13,0,1.27818833952188,-5,0
30,1,10,9,18,-9,0,1.4775091134652,-8,0
30,1,2,11,10,1,1,1.39678604746587,0,0
30,1,10,12,0,12,0,1.4947412214824,10,0
30,1,2,18,1,17,0,1.05336451492622,9,0
30,1,10,6,14,-8,0,0.950005223392509,-4,0
30,1,10,3,16,-13,0,1.79462667310145,-6,0
30,1,2,8,15,-7,0,0.725253610115033,-5,0
30,1,10,17,4,13,0,1.42711332591716,6,0
30,1,2,0,14,-14,0,0.500495765387313,-4,0
30,1,2,15,0,15,0,1.9064438502246,10,0
30,1,10,13,3,10,0,1.73632943013217,7,0
30,1,2,9,19,-10,0,1.05249028172693,-9,0
30,1,10,11,0,11,0,1.0370015083754,10,0
30,1,2,14,0,14,0,0.933652480365708,10,0
30,1,10,10,14,-4,1,1.2428667518252,4,0
30,1,10,16,1,15,0,0.899559217854403,9,0
30,1,2,18,8,10,1,1.11427016189555,-2,0
30,1,2,6,11,-5,0,0.68753365430166,-1,0
30,1,2,5,20,-15,0,0.846793286909815,-10,0
30,1,10,8,19,-11,0,1.151427822595,-9,0
30,1,10,20,7,13,0,1.95601525600068,3,0
30,1,2,12,3,9,0,0.855566776212072,7,0
30,1,10,18,4,14,0,1.27189862559317,6,0
30,1,2,3,17,-14,0,1.40722736110911,-7,0
30,1,2,9,18,-9,1,1.769864063157,8,0
30,1,10,1,16,-15,0,1.04579919029493,-6,0
30,1,2,10,9,1,0,1.22236130939564,1,0
30,1,2,17,4,13,0,1.19238482389483,6,0
30,1,10,20,0,20,0,1.3630036234099,10,0
30,1,10,2,16,-14,0,1.51824214978842,-6,0
30,1,10,2,20,-18,0,1.3162469919771,-10,0
30,1,2,2,11,-9,0,0.936915551283164,-1,0
30,1,10,17,9,8,1,1.44607960470603,-1,0
30,1,10,16,10,6,1,1.24676286286558,0,0
30,1,2,20,1,19,0,1.07073224821943,9,0
30,1,10,6,14,-8,0,1.36668896541232,-4,0
30,1,2,10,4,6,0,1.45058199740015,6,0
30,1,2,18,5,13,0,1.5952384530683,5,0
30,1,2,6,19,-13,0,1.05321496058605,-9,0
30,1,10,3,13,-10,0,1.06895042528049,-3,0
30,1,10,20,2,18,0,1.83709094775259,8,0
30,1,2,8,11,-3,0,0.933039967290824,-1,0
30,1,2,0,17,-17,0,1.00959750448237,-7,0
30,1,10,11,6,5,0,1.1563297600369,4,0
30,1,2,20,6,14,0,0.776995020336471,4,0
30,1,2,3,16,-13,0,1.33222841497627,-6,0
30,1,2,12,0,12,0,0.720775043504545,10,0
30,1,10,14,6,8,0,1.94212649439578,4,0
30,1,10,19,9,10,1,1.27475225477247,-1,0
30,1,10,4,10,-6,0,1.20975329028443,0,0
30,1,10,18,9,9,1,1.89261886914028,-1,0
30,1,2,17,3,14,0,1.28269879642176,7,0
30,1,2,16,1,15,0,0.953328042727662,9,0
30,1,10,20,3,17,0,1.34123686590465,7,0
30,1,10,13,0,13,0,1.01786038294085,10,0
30,1,2,18,5,13,NaN,NaN,0,0
30,1,10,19,8,11,0,0.703073745331494,2,0
30,1,2,4,13,-9,0,0.789768355694832,-3,0
30,1,2,14,0,14,0,0.752325881883735,10,0
30,1,10,1,14,-13,0,0.676915294665378,-4,0
30,1,10,9,17,-8,0,1.25217797703226,-7,0
30,1,10,20,1,19,0,1.16419785894686,9,0
30,1,10,16,9,7,0,1.39948975571315,1,0
30,1,2,17,4,13,0,1.0094648116501,6,0
30,1,10,20,9,11,1,1.29144479410024,-1,0
30,1,10,15,9,6,1,0.986109772173222,-1,0
30,1,2,11,0,11,0,0.980476191354683,10,0
30,1,2,20,4,16,0,1.13593611682882,6,0
30,1,2,3,15,-12,0,1.30118818741175,-5,0
30,1,10,6,12,-6,0,0.803442682721652,-2,0
30,1,2,14,7,7,0,0.797146737371804,3,0
30,1,2,9,17,-8,0,0.695136734109838,-7,0
30,1,2,14,7,7,0,0.82975801883731,3,0
30,1,10,2,17,-15,0,0.782334624207579,-7,0
30,1,10,10,17,-7,1,1.52086008418701,7,0
30,1,10,1,11,-10,0,1.16626486150199,-1,0
30,1,2,19,3,16,0,1.21758619995671,7,0
30,1,10,7,17,-10,0,1.2508099944971,-7,0
30,1,10,13,4,9,0,0.970833600615151,6,0
30,1,2,14,8,6,0,1.30216762184864,2,0
30,1,2,20,8,12,1,1.56405930125038,-2,0
30,1,2,12,3,9,0,0.910732541466132,7,0
30,1,10,10,9,1,0,1.02064839878585,1,0
30,1,10,13,0,13,0,0.973930255597224,10,0
30,1,2,8,15,-7,0,0.873225187446224,-5,0
30,1,2,13,10,3,1,1.18451635842212,0,0
30,1,2,11,8,3,0,0.659137386566726,2,0
30,1,10,9,19,-10,0,0.923071875906317,-9,0
30,1,10,10,2,8,0,0.960419778566575,8,0
30,1,2,13,1,12,0,0.724370579584502,9,0
30,1,10,9,11,-2,0,0.777458345633931,-1,0
31,1,10,15,0,15,0,5.89399235000383,10,0
31,1,2,6,20,-14,NaN,NaN,0,0
31,1,2,20,3,17,0,1.70445822283,7,0
31,1,2,11,0,11,0,1.03930493877851,10,0
31,1,2,10,12,-2,0,1.45711070505058,-2,0
31,1,10,0,14,-14,0,1.21853814277711,-4,0
31,1,10,10,20,-10,0,1.44500376635187,-10,0
31,1,10,20,0,20,0,1.13425472992822,10,0
31,1,10,10,9,1,0,1.10845770232481,1,0
31,1,2,10,16,-6,0,0.978349806915503,-6,0
31,1,2,20,8,12,0,1.53342558295844,2,0
31,1,10,1,20,-19,0,0.850721654776862,-10,0
31,1,2,10,20,-10,0,1.05156509738299,-10,0
31,1,10,6,17,-11,0,1.46800141490166,-7,0
31,1,10,1,17,-16,0,0.859962501443079,-7,0
31,1,2,11,8,3,NaN,NaN,0,0
31,1,10,17,3,14,1,1.47308846250235,-7,0
31,1,10,5,11,-6,0,0.825076014301885,-1,0
31,1,2,16,9,7,1,1.8428601538435,-1,0
31,1,2,11,5,6,0,1.81178473702312,5,0
31,1,10,20,0,20,0,1.02012239264877,10,0
31,1,2,14,10,4,NaN,NaN,0,0
31,1,2,20,8,12,1,1.2907611693845,-2,0
31,1,2,4,10,-6,0,1.2500490267048,0,0
31,1,10,20,3,17,0,0.826655865515932,7,0
31,1,2,10,4,6,0,1.93254438520671,6,0
31,1,10,0,17,-17,0,1.00209852626358,-7,0
31,1,2,2,14,-12,0,0.756734069986123,-4,0
31,1,10,6,11,-5,0,0.537193033258518,-1,0
31,1,10,8,10,-2,0,0.646429664549942,0,0
31,1,10,10,9,1,0,1.26217465969967,1,0
31,1,10,8,17,-9,0,0.750565319147427,-7,0
31,1,2,15,0,15,0,0.906911940706777,10,0
31,1,2,3,19,-16,0,0.833562124626042,-9,0
31,1,10,13,4,9,0,0.866797648915963,6,0
31,1,2,0,17,-17,0,0.874976219758537,-7,0
31,1,2,14,6,8,0,1.09073551054826,4,0
31,1,10,4,19,-15,0,0.762014658525004,-9,0
31,1,10,17,4,13,0,0.9179767640926,6,0
31,1,2,20,8,12,1,1.41171325883624,-2,0
31,1,2,10,2,8,0,1.6677884465571,8,0
31,1,10,20,3,17,0,1.14776080832598,7,0
31,1,2,3,17,-14,0,1.32835686309772,-7,0
31,1,10,18,8,10,0,1.197576706174,2,0
31,1,2,10,4,6,0,0.936191972083179,6,0
31,1,10,9,13,-4,0,0.89332375403319,-3,0
31,1,2,4,18,-14,0,0.716907523721602,-8,0
31,1,10,2,17,-15,0,0.650776637994568,-7,0
31,1,10,13,4,9,0,0.931504469219362,6,0
31,1,2,4,11,-7,0,1.50467888882486,-1,0
31,1,10,5,20,-15,0,0.646651063649188,-10,0
31,1,2,11,3,8,0,0.855244574529934,7,0
31,1,10,10,4,6,0,0.943799083979684,6,0
31,1,2,10,9,1,0,0.725120550712745,1,0
31,1,2,19,1,18,0,0.891115261325467,9,0
31,1,10,4,11,-7,0,0.970430023768131,-1,0
31,1,10,11,4,7,0,0.806367790093645,6,0
31,1,2,20,3,17,0,1.14495079918197,7,0
31,1,10,3,13,-10,0,0.805741714484611,-3,0
31,1,2,11,5,6,0,0.928053355717566,5,0
31,1,10,11,5,6,0,1.05213582321812,5,0
31,1,10,11,3,8,0,1.09277502148689,7,0
31,1,2,18,8,10,0,1.1162334294313,2,0
31,1,10,20,3,17,0,0.834122220367135,7,0
31,1,10,10,7,3,0,2.13927873010834,3,0
31,1,2,8,14,-6,0,1.03256252966821,-4,0
31,1,2,4,15,-11,0,0.794035786744644,-5,0
31,1,2,4,17,-13,0,0.948492451720085,-7,0
31,1,10,2,16,-14,0,1.32088720925458,-6,0
31,1,2,17,10,7,1,1.13508680934319,0,0
31,1,2,13,4,9,1,1.21892779053815,-6,0
31,1,2,1,15,-14,NaN,NaN,0,0
31,1,2,11,4,7,0,1.28951818203495,6,0
31,1,10,19,2,17,1,1.27292131351351,-8,0
31,1,2,1,16,-15,0,0.744755425472249,-6,0
31,1,10,5,12,-7,0,0.717417401454441,-2,0
31,1,10,14,3,11,0,1.08316762001414,7,0
31,1,2,7,10,-3,0,1.24241075765167,0,0
31,1,10,14,4,10,0,0.891867065234692,6,0
31,1,10,10,4,6,0,0.699174701854645,6,0
31,1,10,17,6,11,1,1.76166349902269,-4,0
31,1,2,20,3,17,1,1.29366171756556,-7,0
31,1,10,20,0,20,0,1.26077881899982,10,0
31,1,2,10,3,7,0,0.828790680709062,7,0
31,1,10,17,4,13,0,3.15020866132545,6,0
31,1,10,13,7,6,0,1.92252827512129,3,0
31,1,2,11,0,11,0,1.46467089793077,10,0
31,1,2,1,14,-13,0,1.23279969062787,-4,0
31,1,10,5,17,-12,0,0.873866658355837,-7,0
31,1,2,18,4,14,0,1.13764096323575,6,0
31,1,2,17,0,17,0,1.1105774887692,10,0
31,1,10,4,11,-7,0,1.09262876612047,-1,0
31,1,2,15,0,15,0,1.51498164477016,10,0
31,1,2,4,15,-11,0,1.13688476066818,-5,0
31,1,2,5,16,-11,0,0.710307337874838,-6,0
31,1,2,12,5,7,0,1.00416186327129,5,0
31,1,10,16,10,6,1,1.49500477437687,0,0
31,1,10,6,20,-14,0,0.90136669959611,-10,0
31,1,10,20,3,17,0,1.87601540263495,7,0
31,1,10,10,9,1,0,1.32389992320532,1,0
31,1,2,6,19,-13,0,0.84040277042368,-9,0
31,1,10,13,10,3,1,0.93001259115772,0,0
31,1,2,3,15,-12,0,0.70312762888716,-5,0
31,1,10,1,18,-17,0,0.997578172391513,-8,0
31,1,10,10,0,10,0,1.40037498556921,10,0
31,1,2,0,11,-11,0,1.11499337452187,-1,0
31,1,10,20,0,20,0,1.07293121049224,10,0
31,1,2,14,2,12,0,1.32821134083861,8,0
31,1,2,10,4,6,0,1.49286556052539,6,0
31,1,10,10,2,8,0,0.972331710105209,8,0
31,1,10,3,20,-17,0,0.950743464785774,-10,0
31,1,10,10,0,10,0,0.851236297723517,10,0
31,1,2,1,12,-11,0,0.964071030990453,-2,0
31,1,10,6,14,-8,0,0.839217698732682,-4,0
31,1,10,2,20,-18,0,0.775860533227387,-10,0
31,1,2,12,6,6,0,1.36322135694718,4,0
31,1,2,1,10,-9,0,1.34246739036826,0,0
31,1,10,14,6,8,0,2.70781806418745,4,0
31,1,2,10,2,8,0,0.793559998608544,8,0
31,1,2,3,14,-11,0,1.2123455658766,-4,0
31,1,2,5,15,-10,0,1.11161117332449,-5,0
31,1,10,10,2,8,0,1.06144008386764,8,0
31,1,10,7,14,-7,0,1.38073974425424,-4,0
31,1,2,8,11,-3,0,1.01615443687115,-1,0
31,1,2,6,18,-12,0,0.91348426838158,-8,0
31,1,10,20,7,13,1,1.46260499504206,-3,0
31,1,2,14,2,12,0,1.27772428113894,8,0
31,1,10,12,5,7,0,0.973094510660303,5,0
31,1,10,8,15,-7,0,1.24908755344586,-5,0
31,1,2,10,15,-5,1,1.54574988866079,5,0
31,1,2,14,6,8,NaN,NaN,0,0
31,1,10,18,8,10,1,1.44891197369361,-2,0
31,1,2,13,7,6,0,1.4334701193693,3,0
31,1,10,10,13,-3,1,1.28208481711772,3,0
31,1,10,0,15,-15,0,1.56047659455726,-5,0
31,1,10,5,20,-15,0,1.09278565157729,-10,0
31,1,2,11,1,10,0,1.02725078396907,9,0
31,1,2,1,17,-16,0,0.621243317247718,-7,0
31,1,10,10,7,3,0,1.40653347286934,3,0
31,1,2,10,17,-7,NaN,NaN,0,0
31,1,10,16,5,11,0,1.34041065134807,5,0
31,1,10,11,0,11,0,0.840822475674941,10,0
31,1,2,13,7,6,0,0.80142333231197,3,0
31,1,10,1,10,-9,0,1.41169016588174,0,0
31,1,2,9,11,-2,0,1.07709087443436,-1,0
31,1,10,20,3,17,0,0.876095311581594,7,0
31,1,10,7,17,-10,0,1.00345367938644,-7,0
31,1,2,2,12,-10,0,1.02999041459043,-2,0
31,1,2,14,9,5,1,1.46350781952788,-1,0
31,1,2,14,6,8,0,0.94259788387717,4,0
31,1,2,2,17,-15,0,0.92265253719961,-7,0
31,1,2,14,4,10,0,0.99965873747351,6,0
31,1,10,0,19,-19,0,1.17046411336923,-9,0
31,1,2,11,8,3,0,1.01371171564097,2,0
31,1,10,3,15,-12,0,1.07970184431906,-5,0
31,1,10,14,2,12,0,0.838973939786229,8,0
31,1,10,10,10,0,0,1.14432289079923,0,0
31,1,2,15,3,12,0,0.917525168570137,7,0
31,1,2,17,6,11,0,0.867024912895431,4,0
31,1,10,10,0,10,0,0.769921245700971,10,0
31,1,10,20,5,15,1,1.21401558957587,-5,0
31,1,2,9,12,-3,0,0.791271230395068,-2,0
31,1,10,10,1,9,0,1.20197463074146,9,0
31,1,2,2,12,-10,0,1.48457555702407,-2,0
31,1,2,18,8,10,NaN,NaN,0,0
31,1,10,12,1,11,0,0.903195808077726,9,0
31,1,2,13,7,6,0,0.813366054459038,3,0
31,1,10,19,1,18,0,0.59880613099449,9,0
31,1,2,12,6,6,0,0.656948687825206,4,0
31,1,10,16,10,6,1,0.816832196709584,0,0
31,1,10,3,20,-17,0,0.792851814720052,-10,0
31,1,10,2,19,-17,0,0.668152068923519,-9,0
31,1,2,1,11,-10,0,0.619454896346724,-1,0
31,1,2,6,16,-10,0,0.524671154518728,-6,0
31,1,10,16,5,11,0,0.841988853066141,5,0
31,1,2,19,9,10,1,0.978713429285563,-1,0
31,1,2,13,4,9,0,0.733424116737297,6,0
31,1,10,14,0,14,0,1.53780481322974,10,0
31,1,10,11,5,6,0,1.07851274052882,5,0
31,1,2,15,7,8,0,1.03705649159383,3,0
31,1,10,12,7,5,0,1.06828366210539,3,0
31,1,2,6,10,-4,0,1.26755934980247,0,0
31,1,2,7,17,-10,0,0.866951601936307,-7,0
31,1,10,14,3,11,0,0.666678885161673,7,0
31,1,2,18,7,11,1,0.922161720314762,-3,0
31,1,10,1,13,-12,0,0.64745931699872,-3,0
31,1,10,14,6,8,0,0.816261104318983,4,0
31,1,2,17,1,16,0,0.64938702872314,9,0
31,1,10,10,1,9,0,0.745463975908933,9,0
31,1,2,13,4,9,0,0.806148223768105,6,0
31,1,2,10,7,3,0,0.582569952402991,3,0
31,1,2,9,11,-2,0,0.809039974632469,-1,0
31,1,10,7,17,-10,0,0.683116302341659,-7,0
31,1,2,8,17,-9,0,0.553615788245224,-7,0
31,1,2,4,18,-14,0,0.565517456256202,-8,0
31,1,10,11,0,11,0,0.856937324624596,10,0
31,1,10,19,2,17,0,1.02517754998553,8,0
31,1,2,5,11,-6,0,0.75427338757072,-1,0
31,1,10,17,0,17,0,1.08590211886985,10,0
31,1,10,7,18,-11,0,0.949052180909348,-8,0
32,1,10,10,20,-10,0,1.15153614518204,-10,0
32,1,10,20,3,17,0,1.8036230409889,7,0
32,1,2,17,3,14,0,1.47031500002777,7,0
32,1,2,11,5,6,0,1.22243323637667,5,0
32,1,10,10,16,-6,0,1.48915012123689,-6,0
32,1,10,1,20,-19,0,1.08856289828691,-10,0
32,1,2,0,14,-14,0,0.928689433469117,-4,0
32,1,2,20,8,12,0,1.006786420563,2,0
32,1,2,11,0,11,0,1.73014796039206,10,0
32,1,10,11,8,3,0,0.904226575687062,2,0
32,1,10,6,17,-11,0,0.775682298452011,-7,0
32,1,2,10,9,1,0,1.17240638614021,1,0
32,1,2,10,20,-10,0,1.3364486940518,-10,0
32,1,2,15,0,15,0,1.09450294069393,10,0
32,1,10,16,9,7,1,1.13482631653096,-1,0
32,1,10,20,0,20,0,0.89276876355143,10,0
32,1,2,5,11,-6,0,1.03679637256209,-1,0
32,1,10,1,17,-16,0,1.04618460867277,-7,0
32,1,2,6,20,-14,0,0.742960564057285,-10,0
32,1,10,10,12,-2,0,1.10040229537481,-2,0
32,1,10,15,8,7,0,1.46470705749016,2,0
32,1,2,20,7,13,1,1.40128404619099,-3,0
32,1,10,11,8,3,1,1.41995018501984,-2,0
32,1,2,13,2,11,0,0.94224431334078,8,0
32,1,10,11,4,7,0,1.29141763758162,6,0
32,1,2,10,7,3,0,0.835046066946234,3,0
32,1,2,18,4,14,0,1.18041417179484,6,0
32,1,10,0,19,-19,0,1.08772495092853,-9,0
32,1,10,8,13,-5,0,1.06402672927652,-3,0
32,1,2,9,20,-11,0,1.16800331366903,-10,0
32,1,2,1,16,-15,0,0.914772396121407,-6,0
32,1,10,16,5,11,0,1.33669905190254,5,0
32,1,10,10,1,9,0,1.75836471970251,9,0
32,1,2,11,3,8,0,0.851047342559468,7,0
32,1,10,18,4,14,0,1.20358638537073,6,0
32,1,2,12,6,6,0,1.22271181905307,4,0
32,1,2,12,0,12,0,0.953080079689244,10,0
32,1,2,4,17,-13,0,1.82997952783626,-7,0
32,1,10,2,18,-16,0,1.10327609558954,-8,0
32,1,10,10,9,1,1,1.4380217697726,-1,0
32,1,2,19,2,17,0,1.11924108214589,8,0
32,1,10,18,6,12,0,0.90923593203479,4,0
32,1,10,19,7,12,1,1.23596025798179,-3,0
32,1,2,4,13,-9,0,1.58936290708516,-3,0
32,1,2,13,2,11,0,0.744773184218502,8,0
32,1,2,17,4,13,0,1.16618042993287,6,0
32,1,10,11,5,6,0,1.08229552123157,5,0
32,1,2,7,16,-9,0,0.985714573722362,-6,0
32,1,10,7,14,-7,0,1.22905983845703,-4,0
32,1,10,6,17,-11,0,0.886541707674041,-7,0
32,1,10,9,13,-4,0,1.45325437713836,-3,0
32,1,10,3,20,-17,0,0.798138627869776,-10,0
32,1,10,17,3,14,0,0.944938501041179,7,0
32,1,10,19,2,17,0,1.01420001869337,8,0
32,1,10,10,1,9,0,1.0082618090637,9,0
32,1,2,9,17,-8,0,1.7637164394946,-7,0
32,1,2,1,11,-10,0,0.919874857729155,-1,0
32,1,2,11,0,11,0,0.861905468835175,10,0
32,1,2,15,0,15,0,0.982662993774284,10,0
32,1,2,16,8,8,0,1.24233943466243,2,0
32,1,10,6,20,-14,0,0.778980570692511,-10,0
32,1,2,3,16,-13,0,1.43828935575948,-6,0
32,1,2,11,1,10,0,1.18362007188261,9,0
32,1,10,3,15,-12,0,0.859090684156399,-5,0
32,1,2,11,8,3,1,1.35585637596887,-2,0
32,1,10,0,12,-12,0,0.824718347419548,-2,0
32,1,10,7,16,-9,0,0.914656564378674,-6,0
32,1,2,11,4,7,0,0.840652543258329,6,0
32,1,2,17,8,9,0,1.34600701221643,2,0
32,1,10,12,6,6,0,1.55101270300656,4,0
32,1,10,1,14,-13,0,1.46760505041311,-4,0
32,1,2,8,13,-5,0,1.83569597099995,-3,0
32,1,2,19,5,14,0,0.645259054395865,5,0
32,1,10,10,19,-9,0,1.02252890753516,-9,0
32,1,10,18,3,15,0,1.06475800879343,7,0
32,1,10,0,17,-17,0,0.800678495434113,-7,0
32,1,2,20,0,20,0,1.53957761734637,10,0
32,1,2,10,1,9,0,0.696979027488851,9,0
32,1,10,5,17,-12,0,1.13582188303553,-7,0
32,1,2,9,17,-8,1,1.18900588139513,7,0
32,1,10,11,5,6,0,1.03985601674503,5,0
32,1,10,5,12,-7,0,1.06527961819666,-2,0
32,1,2,16,5,11,1,1.53729287286478,-5,0
32,1,2,9,14,-5,0,1.08707101475738,-4,0
32,1,2,10,9,1,1,1.19816392024222,-1,0
32,1,2,20,2,18,0,1.02496357347991,8,0
32,1,10,0,17,-17,0,0.81909574263409,-7,0
32,1,10,18,10,8,0,1.06108548272823,0,0
32,1,10,8,14,-6,0,1.22195707993887,-4,0
32,1,2,3,18,-15,0,1.22393501692568,-8,0
32,1,2,19,2,17,0,0.889611615431932,8,0
32,1,10,6,20,-14,0,0.880731792698498,-10,0
32,1,2,6,12,-6,0,1.2561446723812,-2,0
32,1,2,4,11,-7,0,1.35292026120806,-1,0
32,1,10,4,20,-16,0,1.67762083065463,-10,0
32,1,10,10,14,-4,0,0.933265520445275,-4,0
32,1,2,11,3,8,0,0.874514267281484,7,0
32,1,10,10,20,-10,0,0.882595364164445,-10,0
32,1,10,14,5,9,0,0.98596859713507,5,0
32,1,2,20,4,16,0,1.70937192436395,6,0
32,1,10,19,4,15,0,0.859758916019928,6,0
32,1,10,9,15,-6,0,0.868225996531692,-5,0
32,1,2,7,11,-4,0,1.06061115906778,-1,0
32,1,10,18,4,14,0,1.18857481136001,6,0
32,1,10,0,15,-15,0,1.01584109057876,-5,0
32,1,2,18,0,18,0,1.45007523565073,10,0
32,1,2,6,11,-5,0,0.938903887144988,-1,0
32,1,2,15,8,7,0,1.01620251494023,2,0
32,1,10,19,5,14,0,0.738166376169829,5,0
32,1,2,19,10,9,1,1.16754145291634,0,0
32,1,2,2,20,-18,0,0.787081461607158,-10,0
32,1,10,2,13,-11,0,0.966357476550911,-3,0
32,1,2,12,3,9,0,0.898419593158906,7,0
32,1,2,9,10,-1,0,1.3133398946884,0,0
32,1,10,20,4,16,0,0.839316079538548,6,0
32,1,2,20,1,19,0,0.688702922732773,9,0
32,1,2,20,3,17,0,1.06344793711469,7,0
32,1,10,17,10,7,1,1.27084210777321,0,0
32,1,10,19,7,12,0,0.69490028756627,3,0
32,1,10,15,8,7,0,1.07707612821469,2,0
32,1,10,17,5,12,0,1.87994149763836,5,0
32,1,2,19,2,17,0,0.702864086477348,8,0
32,1,10,19,0,19,0,0.676652755861141,10,0
32,1,2,9,14,-5,1,1.54804029918159,4,0
32,1,2,2,10,-8,0,1.24076910811345,0,0
32,1,10,15,10,5,1,1.1222153187482,0,0
32,1,2,18,4,14,0,0.951743615965825,6,0
32,1,10,18,1,17,0,1.01174959083437,9,0
32,1,2,20,1,19,0,0.982631103386666,9,0
32,1,10,8,12,-4,0,1.11385417296697,-2,0
32,1,2,10,19,-9,0,1.16726726892011,-9,0
32,1,2,3,20,-17,0,0.827401904993167,-10,0
32,1,2,0,14,-14,0,0.916776358593779,-4,0
32,1,10,20,0,20,0,1.03502040801322,10,0
32,1,10,20,1,19,0,0.987567515061528,9,0
32,1,2,11,8,3,0,1.01458783509952,2,0
32,1,10,5,14,-9,0,0.967772016738309,-4,0
32,1,10,3,11,-8,0,1.29133736178846,-1,0
32,1,2,10,9,1,1,1.65786565350572,-1,0
32,1,10,18,0,18,0,1.58612438349883,10,0
32,1,10,11,9,2,0,1.59604889125694,1,0
32,1,10,2,14,-12,0,1.25420559034683,-4,0
32,1,2,4,12,-8,0,1.11842586126659,-2,0
32,1,10,5,14,-9,0,1.06772967950383,-4,0
32,1,2,16,3,13,0,0.963302597603615,7,0
32,1,2,7,19,-12,0,0.72727049461173,-9,0
32,1,2,17,5,12,0,1.10856256838451,5,0
32,1,10,20,3,17,0,1.42763906682012,7,0
32,1,2,11,6,5,0,1.04475247379742,4,0
32,1,10,16,8,8,0,1.34967330683139,2,0
32,1,10,9,12,-3,0,1.44180866135503,-2,0
32,1,2,20,1,19,0,0.938382277745404,9,0
32,1,2,5,13,-8,0,1.41577364424302,-3,0
32,1,2,18,10,8,1,1.2332415110177,0,0
32,1,10,4,16,-12,0,0.961949272292259,-6,0
32,1,10,20,5,15,0,1.15821113267521,5,0
32,1,2,11,0,11,0,1.14622804557439,10,0
32,1,10,1,14,-13,0,1.1270325996702,-4,0
32,1,2,6,20,-14,0,1.36441216306412,-10,0
32,1,10,10,10,0,1,1.53638308049995,0,0
32,1,2,10,4,6,0,1.48883341672263,6,0
32,1,10,6,18,-12,0,0.92776937752933,-8,0
32,1,10,3,14,-11,0,0.605741002422292,-4,0
32,1,10,0,10,-10,0,1.16799195042768,0,0
32,1,2,15,0,15,0,0.883379427767068,10,0
32,1,2,20,6,14,0,0.849899655255285,4,0
32,1,10,12,5,7,0,0.84230351215956,5,0
32,1,10,12,3,9,0,0.88275078397055,7,0
32,1,2,15,6,9,0,0.857515225827228,4,0
32,1,2,9,15,-6,0,1.34570350372451,-5,0
32,1,10,20,7,13,0,1.07633495167829,3,0
32,1,2,4,17,-13,0,0.843081710863771,-7,0
32,1,10,4,20,-16,0,0.651824075041077,-10,0
32,1,2,2,17,-15,0,0.73984703611859,-7,0
32,1,10,16,4,12,0,1.39266044621036,6,0
32,1,2,19,2,17,0,1.09947197586735,8,0
32,1,2,15,5,10,0,0.865491854208813,5,0
32,1,10,10,1,9,0,0.984853899884911,9,0
32,1,10,12,3,9,0,1.03604346622524,7,0
32,1,2,20,0,20,0,0.980503244940337,10,0
32,1,2,16,5,11,0,0.998439937025978,5,0
32,1,2,1,13,-12,0,1.03262752946466,-3,0
32,1,10,18,10,8,1,1.16130193413119,0,0
32,1,10,15,4,11,0,0.645380017922434,6,0
32,1,2,11,8,3,0,0.749633352210367,2,0
32,1,10,14,8,6,0,0.721706172254926,2,0
32,1,2,9,14,-5,0,0.887244762372575,-4,0
32,1,10,10,19,-9,0,0.933676063330495,-9,0
32,1,10,6,12,-6,0,0.754598721818184,-2,0
32,1,2,7,19,-12,0,0.654683213011594,-9,0
32,1,2,13,2,11,0,0.622036622622545,8,0
32,1,10,18,6,12,0,0.623460693266679,4,0
32,1,10,0,11,-11,0,0.736943178297224,-1,0
32,1,2,19,5,14,0,0.765430822604685,5,0
32,1,2,11,1,10,0,0.833109550803783,9,0
32,1,10,12,0,12,0,0.905761712841922,10,0
32,1,2,10,15,-5,0,0.951920662588236,-5,0
32,1,10,11,4,7,0,0.787131679797312,6,0
32,1,2,2,11,-9,0,0.766060932630353,-1,0
32,1,10,18,9,9,0,0.697401300174533,1,0
33,1,10,11,8,3,0,4.47737312162644,2,0
33,1,2,15,0,15,NaN,NaN,0,0
33,1,2,1,20,-19,NaN,NaN,0,0
33,1,10,11,5,6,1,0.828680347709451,-5,0
33,1,2,17,3,14,1,0.51878538398887,-7,0
33,1,10,5,11,-6,0,2.54048762787716,-1,0
33,1,2,10,9,1,0,0.354229034419404,1,0
33,1,2,1,17,-16,1,0.406501949153608,7,0
33,1,10,20,0,20,0,1.88921467465116,10,0
33,1,10,20,3,17,1,1.48830965082743,-7,0
33,1,2,10,20,-10,0,0.239736007235479,-10,0
33,1,10,6,20,-14,1,0.465009594568983,10,0
33,1,10,16,9,7,1,1.7287633723754,-1,0
33,1,2,20,8,12,0,0.438265022792621,2,0
33,1,2,11,0,11,0,0.383436121424893,10,0
33,1,2,10,12,-2,1,0.554717652004911,2,0
33,1,10,0,14,-14,1,0.215391269768588,4,0
33,1,2,10,20,-10,0,0.609473242424428,-10,0
33,1,10,6,17,-11,0,0.91607031255262,-7,0
33,1,10,10,16,-6,0,0.657913093513343,-6,0
33,1,2,20,8,12,0,0.51380903593963,2,0
33,1,2,14,4,10,0,0.935819185862783,6,0
33,1,2,15,2,13,0,0.84526878548786,8,0
33,1,2,10,14,-4,1,0.573843748687068,4,0
33,1,10,20,0,20,1,0.345942329935497,-10,0
33,1,10,0,14,-14,1,0.50240661558928,4,0
33,1,10,1,12,-11,0,0.628986054420238,-2,0
33,1,2,12,8,4,0,0.766385824594181,2,0
33,1,10,2,13,-11,0,1.28233150849701,-3,0
33,1,10,9,18,-9,0,0.817905102623627,-8,0
33,1,2,18,1,17,0,1.450906398386,9,0
33,1,2,11,0,11,0,0.507520055107307,10,0
33,1,10,3,12,-9,0,0.226255954214139,-2,0
33,1,10,20,8,12,1,1.18001543194987,-2,0
33,1,2,0,14,-14,0,1.03998306515859,-4,0
33,1,10,18,5,13,0,0.217414285725681,5,0
33,1,10,9,15,-6,0,1.11524996289518,-5,0
33,1,10,1,17,-16,0,0.505237518373178,-7,0
33,1,2,9,18,-9,0,0.415965661144583,-8,0
33,1,2,1,16,-15,0,1.0736386612698,-6,0
33,1,2,6,11,-5,1,0.861693373240996,1,0
33,1,10,15,7,8,1,1.11057162389625,-3,0
33,1,2,4,10,-6,0,0.781062312482391,0,0
33,1,10,0,14,-14,0,5.01624570903368,-4,0
33,1,10,2,11,-9,1,4.46618513582507,1,0
33,1,10,6,20,-14,0,2.91415029848577,-10,0
33,1,2,19,10,9,0,0.272139085573144,0,0
33,1,10,20,8,12,1,1.45611074354383,-2,0
33,1,2,8,20,-12,0,0.392729018873069,-10,0
33,1,2,19,4,15,0,0.508018569642445,6,0
33,1,10,7,20,-13,0,0.258671128860442,-10,0
33,1,2,20,7,13,1,1.89123512475635,-3,0
33,1,10,1,11,-10,0,1.30641415927676,-1,0
33,1,10,12,8,4,0,0.273143079160945,2,0
33,1,2,15,2,13,1,0.297021925478475,-8,0
33,1,2,0,14,-14,0,0.263566834852099,-4,0
33,1,10,11,8,3,0,0.623730391613208,2,0
33,1,2,8,17,-9,1,0.345707734872121,7,0
33,1,10,6,10,-4,0,0.21435282001039,0,0
33,1,2,1,13,-12,1,0.408306865021586,3,0
33,1,10,2,11,-9,0,0.250444539356977,-1,0
33,1,10,0,20,-20,0,5.61880132911028,-10,0
33,1,10,1,13,-12,0,0.844846147781936,-3,0
33,1,2,1,14,-13,1,0.518088196753524,4,0
33,1,10,1,10,-9,1,0.748108668864006,0,0
33,1,2,20,0,20,0,0.256701629899908,10,0
33,1,2,5,19,-14,1,0.425321606016951,9,0
33,1,10,8,19,-11,1,0.235260739602381,9,0
33,1,2,7,20,-13,0,1.09250377092394,-10,0
33,1,2,20,3,17,0,0.283755573938834,7,0
33,1,2,10,17,-7,NaN,NaN,0,0
33,1,10,2,20,-18,1,1.17503321904223,10,0
33,1,10,5,11,-6,NaN,NaN,0,0
33,1,10,3,13,-10,1,1.87947238102788,3,0
33,1,2,9,16,-7,0,0.534872741351137,-6,0
33,1,10,12,8,4,0,0.260162273800233,2,0
33,1,2,7,16,-9,0,0.364778848335845,-6,0
33,1,10,11,0,11,1,0.560718154185452,-10,0
33,1,2,5,18,-13,1,0.237384191597812,8,0
33,1,2,20,0,20,1,0.382672954321606,-10,0
33,1,10,9,18,-9,1,0.529252356500365,8,0
33,1,10,14,4,10,1,0.319065431860508,-6,0
33,1,10,5,18,-13,1,0.293163569585886,8,0
33,1,10,18,2,16,1,0.260480443394044,-8,0
33,1,2,17,2,15,1,0.725070699263597,-8,0
33,1,2,8,19,-11,0,0.403009781526634,-9,0
33,1,2,17,6,11,1,0.309691525792005,-4,0
33,1,2,9,20,-11,1,0.28428781151888,10,0
33,1,2,1,17,-16,NaN,NaN,0,0
33,1,10,14,2,12,1,0.392213276267285,-8,0
33,1,2,5,13,-8,0,0.474825199169572,-3,0
33,1,2,18,7,11,0,0.354833116754889,3,0
33,1,10,0,13,-13,1,0.11152246707934,3,0
33,1,10,9,16,-7,1,0.397303256293526,6,0
33,1,10,20,8,12,0,0.34410259136348,2,0
33,1,10,13,6,7,0,0.197521356400102,4,0
33,1,2,11,8,3,1,0.383811840089038,-2,0
33,1,10,19,4,15,1,0.259273011848563,-6,0
33,1,2,20,3,17,0,0.643928294535726,7,0
33,1,2,9,11,-2,1,0.269211045757402,1,0
33,1,2,10,15,-5,1,0.620460356178228,5,0
33,1,2,8,20,-12,0,0.686320724460529,-10,0
33,1,2,6,20,-14,0,0.31775096632191,-10,0
33,1,10,0,13,-13,0,0.451702555437805,-3,0
33,1,10,13,0,13,1,0.436197287141113,-10,0
33,1,2,6,17,-11,0,0.429638521978632,-7,0
33,1,10,6,14,-8,0,0.366939688887214,-4,0
33,1,10,13,6,7,1,0.330823410389712,-4,0
33,1,2,9,11,-2,0,0.824216076725861,-1,0
33,1,10,0,14,-14,1,0.298156046046643,4,0
33,1,2,10,17,-7,0,0.319489535788307,-7,0
33,1,2,1,17,-16,1,0.517207732103998,7,0
33,1,10,11,0,11,1,0.363428093871335,-10,0
33,1,10,3,14,-11,1,0.303343529667472,4,0
33,1,10,12,0,12,0,0.477253258228302,10,0
33,1,2,13,6,7,0,0.205137998738792,4,0
33,1,2,7,20,-13,NaN,NaN,0,0
33,1,2,2,17,-15,1,0.395176871854346,7,0
33,1,10,7,12,-5,0,0.741665001900401,-2,0
33,1,10,4,16,-12,0,0.234488408634206,-6,0
33,1,10,0,14,-14,1,0.37887068130658,4,0
33,1,10,4,20,-16,1,0.197706833132543,10,0
33,1,2,7,19,-12,0,0.280313257739181,-9,0
33,1,10,13,6,7,1,0.326917402358958,-4,0
33,1,10,3,13,-10,1,0.116913022036897,3,0
33,1,2,11,5,6,1,0.658686157607008,-5,0
33,1,10,16,8,8,0,0.371438782603946,2,0
33,1,2,19,1,18,0,0.647456384554971,9,0
33,1,2,9,18,-9,1,0.359420183609473,8,0
33,1,2,2,10,-8,0,0.40389867691556,0,0
33,1,10,10,15,-5,1,0.357352447928861,5,0
33,1,10,20,6,14,0,0.377172799431719,4,0
33,1,2,5,12,-7,1,0.276589794026222,2,0
33,1,10,12,0,12,1,0.244467496668221,-10,0
33,1,2,10,2,8,1,0.605182718427386,-8,0
33,1,10,18,5,13,1,0.655795872939052,-5,0
33,1,2,19,10,9,1,0.160483192565152,0,0
33,1,2,14,7,7,0,0.276434374769451,3,0
33,1,2,9,13,-4,1,0.235492402222008,3,0
33,1,10,6,18,-12,0,0.628359245718457,-8,0
33,1,2,10,15,-5,1,1.0372034800821,5,0
33,1,10,16,8,8,0,0.302229203050956,2,0
33,1,10,7,19,-12,0,0.164320288255112,-9,0
33,1,10,17,1,16,0,0.375508274039021,9,0
33,1,2,19,2,17,0,0.650737416610355,8,0
33,1,2,19,5,14,1,0.298758662160253,-5,0
33,1,10,8,17,-9,1,0.272742068220396,7,0
33,1,2,13,0,13,1,0.26405545239686,-10,0
33,1,2,17,7,10,1,0.591316316626035,-3,0
33,1,10,9,13,-4,1,0.32197697670199,3,0
33,1,2,7,13,-6,1,1.00708367163315,3,0
33,1,2,3,11,-8,1,0.289285419741645,1,0
33,1,2,11,0,11,0,0.631777002708986,10,0
33,1,10,19,7,12,0,0.50796505267499,3,0
33,1,2,13,0,13,1,0.487107717606705,-10,0
33,1,10,20,1,19,0,0.262351705663605,9,0
33,1,10,9,17,-8,0,0.477700088522397,-7,0
33,1,2,2,19,-17,1,0.413023692264687,9,0
33,1,10,3,14,-11,1,0.190333583188476,4,0
33,1,10,18,1,17,1,0.256955652381293,-9,0
33,1,10,10,9,1,1,0.484734641795512,-1,0
33,1,10,8,20,-12,1,0.155511976277921,10,0
33,1,2,9,18,-9,0,0.391358103894163,-8,0
33,1,2,16,1,15,0,0.329992430633865,9,0
33,1,10,20,8,12,0,0.446740503015462,2,0
33,1,2,7,15,-8,0,0.454665784491226,-5,0
33,1,2,13,0,13,1,0.214620404993184,-10,0
33,1,10,2,20,-18,1,0.287966922100168,10,0
33,1,2,2,18,-16,1,0.462607927474892,8,0
33,1,10,0,16,-16,0,0.365888409723993,-6,0
33,1,2,3,11,-8,0,0.288347772526322,-1,0
33,1,2,15,2,13,1,0.343119124823716,-8,0
33,1,2,10,16,-6,0,0.283718551887432,-6,0
33,1,10,20,8,12,1,0.434397136472398,-2,0
33,1,10,12,2,10,0,0.443172825092915,8,0
33,1,2,6,11,-5,1,0.147210609575268,1,0
33,1,10,11,1,10,0,0.398295520164538,9,0
33,1,10,18,0,18,0,0.264220768644009,10,0
33,1,2,5,17,-12,0,0.407420168950921,-7,0
33,1,10,10,11,-1,0,1.02547775837593,-1,0
33,1,2,13,2,11,1,0.154371624259511,-8,0
33,1,2,16,3,13,0,0.294062728527933,7,0
33,1,2,10,14,-4,0,0.348017763230018,-4,0
33,1,10,20,8,12,1,0.304026421275921,-2,0
33,1,2,19,1,18,1,0.565988845744869,-9,0
33,1,10,3,11,-8,0,1.72124313397217,-1,0
33,1,10,9,18,-9,1,0.469783604377881,8,0
33,1,10,19,2,17,0,0.557208391895983,8,0
33,1,10,4,20,-16,1,0.225569030502811,10,0
33,1,2,19,3,16,1,0.265689920284785,-7,0
33,1,10,17,1,16,0,0.111909548955737,9,0
33,1,10,3,11,-8,1,0.220891058066627,1,0
33,1,2,2,13,-11,0,0.326280696666799,-3,0
33,1,10,12,0,12,0,1.99560720718,10,0
33,1,2,8,14,-6,1,0.245593186467886,4,0
33,1,2,16,5,11,1,0.229391830594977,-5,0
33,1,2,20,0,20,0,0.294155466894154,10,0
33,1,10,15,1,14,0,0.260765989572974,9,0
33,1,2,9,13,-4,0,0.196615232911427,-3,0
33,1,10,3,19,-16,1,0.386125534045277,9,0
34,1,10,20,0,20,0,1.14618315643997,10,0
34,1,10,10,9,1,0,1.2862074590239,1,0
34,1,2,10,16,-6,0,0.837745614629966,-6,0
34,1,2,11,8,3,1,0.574988865897694,-2,0
34,1,10,11,5,6,1,0.691136521504859,-5,0
34,1,2,20,3,17,1,0.827115158690731,-7,0
34,1,2,17,3,14,1,0.542009196860135,-7,0
34,1,10,10,20,-10,0,0.892210893642414,-10,0
34,1,2,10,12,-2,1,1.01939698068804,2,0
34,1,10,10,20,-10,0,1.00546569871767,-10,0
34,1,10,6,17,-11,0,0.8242098452954,-7,0
34,1,2,20,8,12,1,0.674310556228647,-2,0
34,1,2,11,0,11,0,0.89038911625471,10,0
34,1,10,0,14,-14,0,1.14580560498962,-4,0
34,1,2,16,9,7,1,0.494735723148551,-1,0
34,1,10,15,0,15,1,0.501946222744436,-10,0
34,1,2,1,20,-19,0,0.524864695457154,-10,0
34,1,10,5,11,-6,0,0.538717901253904,-1,0
34,1,10,1,17,-16,0,0.456850451137598,-7,0
34,1,2,6,20,-14,0,0.434331889718123,-10,0
34,1,2,9,17,-8,0,0.478402040977016,-7,0
34,1,2,7,19,-12,0,0.510361587988427,-9,0
34,1,10,9,19,-10,0,1.32510442230023,-9,0
34,1,10,11,3,8,0,1.06743362150655,7,0
34,1,2,14,3,11,1,0.515352598231857,-7,0
34,1,2,11,0,11,0,0.913684407308665,10,0
34,1,2,13,3,10,1,0.775558492066921,-7,0
34,1,10,9,16,-7,0,0.779682966747714,-6,0
34,1,10,18,4,14,1,0.854860791648662,-6,0
34,1,10,3,17,-14,0,0.735623079023753,-7,0
34,1,10,20,0,20,1,0.781035187428643,-10,0
34,1,10,5,13,-8,0,0.496451932751825,-3,0
34,1,2,6,15,-9,0,0.599181483117718,-5,0
34,1,2,9,17,-8,0,0.641996184164782,-7,0
34,1,10,8,15,-7,0,0.603315854777975,-5,0
34,1,2,11,3,8,1,0.486229452311818,-7,0
34,1,10,13,2,11,1,1.58955941945032,-8,0
34,1,2,17,6,11,1,0.576863793732173,-4,0
34,1,10,11,0,11,0,0.685109993933565,10,0
34,1,2,9,18,-9,0,0.588581451227128,-8,0
34,1,10,0,17,-17,0,0.831264192543586,-7,0
34,1,10,9,20,-11,0,0.624662173926936,-10,0
34,1,2,11,4,7,0,0.786918392070675,6,0
34,1,2,12,6,6,1,0.558125878585997,-4,0
34,1,10,4,13,-9,0,0.530868496630774,-3,0
34,1,10,18,10,8,1,0.744425892698473,0,0
34,1,2,10,2,8,0,0.829675910567857,8,0
34,1,10,11,0,11,0,1.31911381710006,10,0
34,1,2,9,18,-9,0,0.773538775084035,-8,0
34,1,2,19,10,9,1,0.721274291128793,0,0
34,1,10,9,20,-11,0,0.783482673870822,-10,0
34,1,10,11,0,11,0,0.770751492336331,10,0
34,1,10,9,17,-8,0,0.887187626575724,-7,0
34,1,2,13,5,8,1,0.670090044188328,-5,0
34,1,2,13,7,6,1,0.918289801895298,-3,0
34,1,10,10,6,4,0,1.31662124441709,4,0
34,1,2,19,1,18,1,1.49041184265297,-9,0
34,1,2,8,19,-11,0,1.09004272196262,-9,0
34,1,10,11,4,7,0,0.729495748880254,6,0
34,1,2,4,17,-13,0,0.79086178867783,-7,0
34,1,10,9,16,-7,0,0.570211557106177,-6,0
34,1,2,8,16,-8,0,0.854167636509828,-6,0
34,1,10,1,11,-10,0,0.575119725963759,-1,0
34,1,2,12,9,3,1,0.618980207873392,-1,0
34,1,2,11,2,9,1,0.605326041336411,-8,0
34,1,2,11,1,10,1,0.471915120569065,-9,0
34,1,10,11,4,7,1,0.66384321717851,-6,0
34,1,10,10,6,4,0,0.840218759908112,4,0
34,1,2,3,16,-13,0,0.753752146636543,-6,0
34,1,10,9,20,-11,0,0.52622058168572,-10,0
34,1,10,10,20,-10,0,0.715700458743413,-10,0
34,1,10,12,5,7,1,0.649706664516088,-5,0
34,1,10,9,20,-11,0,0.601790620229167,-10,0
34,1,10,9,18,-9,0,0.532521658807127,-8,0
34,1,2,6,17,-11,0,0.465963736733102,-7,0
34,1,2,3,13,-10,0,0.497980466294393,-3,0
34,1,10,9,17,-8,0,0.520600929949524,-7,0
34,1,2,11,4,7,1,0.446631269690897,-6,0
34,1,2,9,19,-10,0,0.423522188478728,-9,0
34,1,2,16,7,9,0,0.489429842326444,3,0
34,1,10,11,3,8,0,0.69223068760175,7,0
34,1,2,9,16,-7,0,0.627627602309985,-6,0
34,1,10,11,0,11,0,0.869628918241688,10,0
34,1,10,10,8,2,1,0.653849466938027,-2,0
34,1,2,11,1,10,0,0.663144197162637,9,0
34,1,10,14,4,10,1,0.558612296814317,-6,0
34,1,2,10,7,3,1,0.907425850544769,-3,0
34,1,2,2,18,-16,0,0.722399614384358,-8,0
34,1,10,10,14,-4,0,0.94411798666124,-4,0
34,1,2,14,1,13,1,1.10154337901213,-9,0
34,1,2,11,2,9,0,0.643788637167745,8,0
34,1,2,11,0,11,0,0.492358615229477,10,0
34,1,10,18,6,12,1,1.12376869658601,-4,0
34,1,10,7,13,-6,0,0.68204632886227,-3,0
34,1,10,9,19,-10,0,0.465843140201741,-9,0
34,1,10,9,11,-2,0,0.609247444654557,-1,0
34,1,2,1,11,-10,0,0.55639427368078,-1,0
34,1,2,12,2,10,1,0.608816376202412,-8,0
34,1,2,11,1,10,0,0.691791554943848,9,0
34,1,10,7,10,-3,0,0.962947907064063,0,0
34,1,10,3,16,-13,0,0.734464765835583,-6,0
34,1,2,19,10,9,0,0.851785396822834,0,0
34,1,10,13,8,5,1,0.70053571984954,-2,0
34,1,2,9,17,-8,0,0.419298377445102,-7,0
34,1,10,11,2,9,1,0.565488131871916,-8,0
34,1,10,9,19,-10,0,0.465358188193022,-9,0
34,1,2,2,16,-14,0,0.480774750238652,-6,0
34,1,10,7,11,-4,0,0.528171386365102,-1,0
34,1,2,11,4,7,0,0.646301736920122,6,0
34,1,2,6,15,-9,0,0.430379695796091,-5,0
34,1,2,15,2,13,1,0.783009451615726,-8,0
34,1,10,1,17,-16,0,0.553749947307551,-7,0
34,1,10,2,13,-11,0,0.510033887991995,-3,0
34,1,10,9,18,-9,0,0.516569193634496,-8,0
34,1,2,18,4,14,0,0.498661158569575,6,0
34,1,2,11,4,7,1,0.520828193929447,-6,0
34,1,2,11,3,8,0,0.534288819528683,7,0
34,1,2,6,20,-14,0,0.483815688912273,-10,0
34,1,10,11,2,9,0,0.642709499818011,8,0
34,1,10,12,8,4,1,0.699717569521908,-2,0
34,1,2,13,9,4,1,0.654507066260521,-1,0
34,1,10,11,0,11,1,0.534567034626889,-10,0
34,1,10,1,19,-18,0,0.483188513638197,-9,0
34,1,10,9,18,-9,0,0.498962833175483,-8,0
34,1,2,10,15,-5,0,0.456990475073326,-5,0
34,1,10,0,10,-10,0,0.761076644777404,0,0
34,1,2,9,20,-11,0,0.805708724554279,-10,0
34,1,2,9,19,-10,0,1.06431094111122,-9,0
34,1,10,20,4,16,1,1.63179423079373,-6,0
34,1,2,18,5,13,1,1.20850297184325,-5,0
34,1,2,1,17,-16,0,0.609844195879305,-7,0
34,1,10,13,10,3,1,0.971289961346884,0,0
34,1,2,11,2,9,0,0.702740913564867,8,0
34,1,10,15,1,14,1,1.01298996922742,-9,0
34,1,10,11,1,10,0,1.21451776966069,9,0
34,1,2,11,0,11,0,0.639831678033261,10,0
34,1,10,16,4,12,1,1.3443327877776,-6,0
34,1,2,18,8,10,0,0.517150183002741,2,0
34,1,10,6,17,-11,0,2.09076520148619,-7,0
34,1,2,9,19,-10,0,1.25729105001483,-9,0
34,1,2,13,8,5,1,0.937784286161786,-2,0
34,1,2,9,17,-8,0,0.598270227868852,-7,0
34,1,10,11,2,9,0,1.19233680521847,8,0
34,1,10,1,19,-18,0,0.571158001616368,-9,0
34,1,2,10,9,1,1,0.78326054165791,-1,0
34,1,2,11,5,6,1,1.40972873111559,-5,0
34,1,10,0,17,-17,0,0.588540030534205,-7,0
34,1,10,9,20,-11,0,0.599269089716472,-10,0
34,1,2,9,19,-10,0,1.37801111027602,-9,0
34,1,10,1,15,-14,0,0.797436315684081,-5,0
34,1,10,11,0,11,0,1.51884329965287,10,0
34,1,2,1,16,-15,0,1.48424895669359,-6,0
34,1,2,12,0,12,0,0.715206709419363,10,0
34,1,2,11,4,7,0,0.736499145010839,6,0
34,1,10,4,18,-14,0,1.08531233218673,-8,0
34,1,10,1,10,-9,0,0.955883662835731,0,0
34,1,10,8,14,-6,1,0.728151958960552,4,0
34,1,10,14,2,12,1,0.932866586880209,-8,0
34,1,2,11,2,9,0,0.473713071894508,8,0
34,1,2,9,17,-8,0,0.432859439060849,-7,0
34,1,2,11,1,10,0,0.708274791476015,9,0
34,1,10,9,17,-8,0,0.514454905511229,-7,0
34,1,2,4,18,-14,0,0.60792784735213,-8,0
34,1,10,16,6,10,1,1.6338773617581,-4,0
34,1,10,8,12,-4,1,0.714643681236339,2,0
34,1,2,1,19,-18,0,1.15271479653438,-9,0
34,1,2,11,3,8,0,0.597402592642084,7,0
34,1,2,9,16,-7,0,1.12749435963769,-6,0
34,1,10,20,2,18,0,1.67691492812764,8,0
34,1,10,15,2,13,0,1.21263917627812,8,0
34,1,10,13,3,10,0,1.16605592526685,7,0
34,1,2,14,10,4,1,0.625412511615195,0,0
34,1,2,9,16,-7,NaN,NaN,0,0
34,1,10,4,16,-12,0,2.03882621819912,-6,0
34,1,10,9,20,-11,0,0.983504667158741,-10,0
34,1,2,9,17,-8,1,0.562473951698848,7,0
34,1,2,11,2,9,1,0.501636117378439,-8,0
34,1,10,16,5,11,0,0.71598930393111,5,0
34,1,2,9,18,-9,0,0.281252737706382,-8,0
34,1,10,11,1,10,0,1.56051911491704,9,0
34,1,10,10,17,-7,1,1.32795915113275,7,0
34,1,2,15,5,10,1,0.741544038810844,-5,0
34,1,10,16,9,7,1,1.18610610661972,-1,0
34,1,2,11,0,11,1,0.444911027984745,-10,0
34,1,2,17,1,16,0,0.293600136358691,9,0
34,1,2,10,6,4,0,0.364554883334677,4,0
34,1,10,11,2,9,0,1.72763401701923,8,0
34,1,10,10,11,-1,1,0.781141121767632,1,0
34,1,2,9,18,-9,0,0.407908053392021,-8,0
34,1,10,16,4,12,0,0.721975510473385,6,0
34,1,2,7,15,-8,0,0.382979760676335,-5,0
34,1,10,18,2,16,0,0.769597577806053,8,0
34,1,2,12,0,12,1,0.485490111268064,-10,0
34,1,2,5,13,-8,0,0.299825703189526,-3,0
34,1,10,4,15,-11,0,0.545659716176488,-5,0
34,1,2,13,6,7,1,0.437708959149404,-4,0
34,1,10,11,0,11,0,0.735127130370529,10,0
34,1,10,9,17,-8,0,0.627854866289908,-7,0
34,1,2,13,3,10,1,0.604605394586997,-7,0
34,1,10,17,7,10,1,2.1827700913268,-3,0
36,1,2,20,8,12,NaN,NaN,0,0
36,1,2,10,12,-2,0,1.15812315920084,-2,0
36,1,2,10,16,-6,0,1.53067506813363,-6,0
36,1,2,11,5,6,1,1.34400304974702,-5,0
36,1,10,11,0,11,1,2.02056673246329,-10,0
36,1,10,10,20,-10,0,1.57440521682724,-10,0
36,1,2,20,0,20,0,1.36252219955668,10,0
36,1,10,17,3,14,0,1.84641993772198,7,0
36,1,10,6,20,-14,0,2.95906447539392,-10,0
36,1,10,15,0,15,0,1.1076450783421,10,0
36,1,10,10,9,1,1,1.61014627423174,-1,0
36,1,10,5,11,-6,0,2.25282477333076,-1,0
36,1,10,0,14,-14,0,1.86948804935309,-4,0
36,1,10,6,17,-11,0,1.34142212789516,-7,0
36,1,2,16,9,7,1,0.930677634026551,-1,0
36,1,2,11,8,3,0,1.95197051422338,2,0
36,1,2,20,3,17,NaN,NaN,0,0
36,1,10,1,20,-19,0,1.16914000428869,-10,0
36,1,2,10,20,-10,1,1.55709973443004,10,0
36,1,2,1,17,-16,0,0.729758677758582,-7,0
36,1,10,7,18,-11,0,0.711029857831136,-8,0
36,1,10,20,0,20,1,0.909631812675116,-10,0
36,1,10,3,14,-11,0,0.772748016473088,-4,0
36,1,2,20,2,18,1,0.904939527399165,-8,0
36,1,2,10,20,-10,0,1.25549733422031,-10,0
36,1,10,18,2,16,0,1.90388604502414,8,0
36,1,2,9,14,-5,1,1.43865334601628,4,0
36,1,2,5,20,-15,0,0.783977464127929,-10,0
36,1,10,15,0,15,0,1.70715535932572,10,0
36,1,2,1,20,-19,0,1.56188512496806,-10,0
36,1,2,19,3,16,1,1.42965842465151,-7,0
36,1,10,3,10,-7,0,1.14311158519035,0,0
36,1,2,3,11,-8,0,1.9722487669967,-1,0
36,1,10,10,20,-10,0,1.95232534057664,-10,0
36,1,2,15,1,14,NaN,NaN,0,0
36,1,10,20,0,20,1,1.31351877408974,-10,0
36,1,10,4,13,-9,0,0.615371898705916,-3,0
36,1,10,8,11,-3,0,0.497445653468731,-1,0
36,1,2,17,3,14,1,0.65604167010315,-7,0
36,1,2,1,18,-17,0,0.648581152782299,-8,0
36,1,2,9,16,-7,0,0.732433437985037,-6,0
36,1,10,4,19,-15,0,0.561742901182015,-9,0
36,1,2,12,7,5,1,0.565713070842548,-3,0
36,1,10,7,10,-3,0,0.713784160742307,0,0
36,1,2,11,5,6,1,0.551790168597563,-5,0
36,1,2,2,12,-10,0,0.620313075607783,-2,0
36,1,2,11,3,8,1,1.31020693927462,-7,0
36,1,10,9,17,-8,0,0.556834714333718,-7,0
36,1,10,11,4,7,1,0.72942657788667,-6,0
36,1,10,1,10,-9,0,0.566845729345914,0,0
36,1,10,6,12,-6,0,0.530695961833999,-2,0
36,1,10,9,17,-8,0,0.384142414395455,-7,0
36,1,2,5,14,-9,0,0.571272994525316,-4,0
36,1,10,9,19,-10,0,0.66325879414012,-9,0
36,1,2,2,19,-17,0,0.97512476654947,-9,0
36,1,10,14,10,4,1,2.9071931146093,0,0
36,1,10,11,3,8,1,0.985857897177311,-7,0
36,1,2,19,1,18,1,0.829139014587099,-9,0
36,1,2,8,20,-12,0,0.830285235668271,-10,0
36,1,2,11,1,10,0,1.35169083188089,9,0
36,1,10,9,18,-9,0,1.26020648107919,-8,0
36,1,2,8,15,-7,0,1.62888572428756,-5,0
36,1,10,11,2,9,1,0.797508517848428,-8,0
36,1,2,10,10,0,1,1.2560013489267,0,0
36,1,2,9,20,-11,0,0.848768829531309,-10,0
36,1,10,1,13,-12,0,1.37736442462597,-3,0
36,1,10,9,19,-10,0,2.9171693067874,-9,0
36,1,10,4,10,-6,0,0.739268977070196,0,0
36,1,2,16,5,11,NaN,NaN,0,0
36,1,2,4,12,-8,0,0.556994166258846,-2,0
36,1,10,1,16,-15,0,0.490011528190962,-6,0
36,1,2,12,2,10,1,0.624895027482353,-8,0
36,1,10,16,8,8,1,0.651006654826915,-2,0
36,1,2,11,2,9,0,0.70759412703751,8,0
36,1,2,9,17,-8,0,0.505459670576101,-7,0
36,1,10,11,0,11,0,0.59216852785562,10,0
36,1,2,11,3,8,0,0.67550030332518,7,0
36,1,10,12,0,12,1,0.787419059820195,-10,0
36,1,2,11,4,7,1,0.934695822542835,-6,0
36,1,10,19,5,14,1,0.715953440037765,-5,0
36,1,2,11,0,11,1,0.829268775464243,-10,0
36,1,10,8,11,-3,0,0.75053288100321,-1,0
36,1,10,10,9,1,0,1.18634028507063,1,0
36,1,2,11,3,8,1,0.605772526250121,-7,0
36,1,10,0,16,-16,0,0.816424281412537,-6,0
36,1,10,11,2,9,1,1.04213672910942,-8,0
36,1,10,15,9,6,1,0.707657541251137,-1,0
36,1,2,9,11,-2,0,0.698292764731377,-1,0
36,1,2,9,17,-8,0,1.07277019312005,-7,0
36,1,2,4,20,-16,0,0.384887256491993,-10,0
36,1,2,13,0,13,1,0.707239667240401,-10,0
36,1,2,14,7,7,1,0.834064429574482,-3,0
36,1,10,20,3,17,1,0.63537156880534,-7,0
36,1,2,17,6,11,1,0.644669998662039,-4,0
36,1,10,11,4,7,0,0.901236577171858,6,0
36,1,10,12,5,7,1,0.715668625909302,-5,0
36,1,2,9,19,-10,1,0.969869817583458,9,0
36,1,10,1,16,-15,0,1.17368126843098,-6,0
36,1,10,9,17,-8,0,0.321792312950947,-7,0
36,1,2,9,20,-11,0,0.399772735187071,-10,0
36,1,2,9,18,-9,0,0.553706524149447,-8,0
36,1,10,10,4,6,0,1.2222495917481,6,0
36,1,10,9,19,-10,0,0.656253173001687,-9,0
36,1,2,6,19,-13,0,0.536863635614054,-9,0
36,1,2,10,10,0,1,0.782170708864669,0,0
36,1,10,5,19,-14,0,0.625432765354617,-9,0
36,1,10,0,17,-17,0,0.61940768191721,-7,0
36,1,2,11,2,9,1,0.813297190896947,-8,0
36,1,2,9,16,-7,0,0.607265142892857,-6,0
36,1,10,12,10,2,1,0.617927894739751,0,0
36,1,10,11,0,11,1,0.731308843716988,-10,0
36,1,2,0,19,-19,0,0.568519424726674,-9,0
36,1,10,9,20,-11,0,0.716450856733445,-10,0
36,1,2,9,19,-10,0,0.962283571503121,-9,0
36,1,2,3,10,-7,0,0.822359925149158,0,0
36,1,10,10,4,6,0,1.25631035576112,6,0
36,1,2,18,0,18,1,0.888901229612657,-10,0
36,1,10,9,16,-7,0,0.784202163047894,-6,0
36,1,10,11,1,10,1,0.979488617515244,-9,0
36,1,2,17,6,11,1,0.701979586487823,-4,0
36,1,10,20,6,14,1,0.692688121197989,-4,0
36,1,10,6,11,-5,0,0.748019405482637,-1,0
36,1,10,20,5,15,1,0.552692629838702,-5,0
36,1,10,0,17,-17,0,0.684581365384929,-7,0
36,1,2,9,17,-8,0,0.659841757709955,-7,0
36,1,2,17,1,16,1,0.77986836968671,-9,0
36,1,2,9,18,-9,0,0.791116511705241,-8,0
36,1,2,5,13,-8,0,0.626426132520919,-3,0
36,1,2,9,19,-10,0,0.523686675134059,-9,0
36,1,10,11,1,10,0,0.561003923983435,9,0
36,1,2,5,10,-5,0,1.35640730986279,0,0
36,1,10,9,20,-11,0,0.736882696533712,-10,0
36,1,2,14,7,7,0,1.62148752151211,3,0
36,1,2,7,18,-11,0,1.26338415634359,-8,0
36,1,10,11,0,11,1,0.487416310648996,-10,0
36,1,10,9,19,-10,0,0.702048499044167,-9,0
36,1,10,4,14,-10,0,0.731994670273707,-4,0
36,1,2,11,3,8,1,1.1525628689617,-7,0
36,1,10,7,11,-4,0,1.59656756821164,-1,0
36,1,2,4,15,-11,0,0.574464598923441,-5,0
36,1,10,9,20,-11,0,0.521115650298043,-10,0
36,1,10,20,8,12,1,0.735040751879978,-2,0
36,1,10,1,14,-13,0,0.652363645694095,-4,0
36,1,2,9,18,-9,0,0.556332898964229,-8,0
36,1,10,1,15,-14,0,0.50494245984828,-5,0
36,1,2,1,17,-16,0,0.462879775081092,-7,0
36,1,10,8,14,-6,0,0.606155577426762,-4,0
36,1,2,11,3,8,1,0.744165800677592,-7,0
36,1,2,13,1,12,1,0.691862270192132,-9,0
36,1,2,11,4,7,1,0.578704920466635,-6,0
36,1,2,19,5,14,1,0.925329213242321,-5,0
36,1,2,11,2,9,1,0.547169728326935,-8,0
36,1,10,19,4,15,1,1.97569659414376,-6,0
36,1,10,9,17,-8,0,1.03566921239917,-7,0
36,1,2,11,4,7,1,0.604219061286358,-6,0
36,1,10,9,19,-10,0,0.550961018586349,-9,0
36,1,10,9,14,-5,0,1.37087784699565,-4,0
36,1,2,5,12,-7,0,0.886934289311739,-2,0
36,1,10,11,0,11,1,0.637493562357577,-10,0
36,1,2,13,2,11,1,0.678219783402028,-8,0
36,1,10,15,8,7,1,0.577392649449394,-2,0
36,1,10,11,0,11,1,0.605515570388889,-10,0
36,1,10,0,11,-11,0,0.751886206308882,-1,0
36,1,2,20,6,14,1,0.692024288010543,-4,0
36,1,2,6,14,-8,0,1.59451522032782,-4,0
36,1,2,11,4,7,1,0.397108605088988,-6,0
36,1,10,9,16,-7,0,0.607074900251064,-6,0
36,1,2,9,19,-10,0,0.689755671998228,-9,0
36,1,2,19,2,17,1,0.832458180525236,-8,0
36,1,10,9,20,-11,0,0.520936037784622,-10,0
36,1,10,16,4,12,1,0.589905776741716,-6,0
36,1,2,11,1,10,1,0.672315296937995,-9,0
36,1,2,14,4,10,1,0.807476279235061,-6,0
36,1,10,5,16,-11,0,0.657552981109575,-6,0
36,1,10,18,0,18,1,1.96952562135857,-10,0
36,1,2,8,10,-2,0,0.460790405026273,0,0
36,1,10,9,18,-9,0,0.532681963054756,-8,0
36,1,2,11,0,11,1,1.04934688857975,-10,0
36,1,2,20,0,20,NaN,NaN,0,0
36,1,10,11,2,9,1,0.853146976186736,-8,0
36,1,10,11,2,9,1,0.596514051013628,-8,0
36,1,10,6,19,-13,0,0.694326260632351,-9,0
36,1,10,19,2,17,1,0.589140774056659,-8,0
36,1,2,9,17,-8,0,0.560232323287892,-7,0
36,1,2,13,6,7,1,0.5883266528474,-4,0
36,1,10,18,6,12,1,0.59896008020246,-4,0
36,1,2,9,18,-9,0,0.920907446404954,-8,0
36,1,2,9,20,-11,0,0.550264561901258,-10,0
36,1,10,9,15,-6,0,0.64946675244073,-5,0
36,1,2,10,9,1,0,1.45741662222167,1,0
36,1,2,11,4,7,1,0.608663921160996,-6,0
36,1,10,6,15,-9,0,0.850638632452501,-5,0
36,1,10,10,6,4,1,0.850602709949499,-4,0
36,1,2,9,16,-7,0,1.01058064326935,-6,0
36,1,2,3,20,-17,0,0.652390404293101,-10,0
36,1,10,7,13,-6,0,0.636454009116278,-3,0
36,1,2,3,13,-10,0,1.1090214966855,-3,0
36,1,2,0,20,-20,0,0.939116489711751,-10,0
36,1,10,11,2,9,1,0.551569135239106,-8,0
36,1,10,11,0,11,1,0.715617674604573,-10,0
37,1,2,20,3,17,NaN,NaN,0,0
37,1,2,5,11,-6,0,1.1108142831747,-1,0
37,1,10,1,17,-16,0,1.94100886879346,-7,0
37,1,10,10,20,-10,0,1.52244946583801,-10,0
37,1,2,20,0,20,1,1.41714156896455,-10,0
37,1,10,10,12,-2,1,1.27596151907642,2,0
37,1,2,10,20,-10,0,0.692683016232877,-10,0
37,1,2,10,9,1,0,1.59677065215601,1,0
37,1,10,11,5,6,1,1.56012543505472,-5,0
37,1,10,10,16,-6,0,0.941737946303419,-6,0
37,1,10,16,9,7,1,1.4594738838864,-1,0
37,1,2,1,20,-19,0,0.740408452020802,-10,0
37,1,2,17,3,14,1,1.01850002107676,-7,0
37,1,10,11,0,11,0,0.949247554621252,10,0
37,1,10,6,17,-11,1,1.6265202402401,7,0
37,1,10,15,0,15,0,1.67660665553558,10,0
37,1,2,0,14,-14,NaN,NaN,0,0
37,1,2,6,20,-14,0,0.882300351342792,-10,0
37,1,2,20,8,12,1,0.890411109543038,-2,0
37,1,10,11,8,3,1,0.850323942810064,-2,0
37,1,10,10,9,1,0,0.592604756781611,1,0
37,1,2,10,16,-6,0,0.891996092525687,-6,0
37,1,10,10,4,6,0,0.716157919141779,6,0
37,1,2,6,11,-5,1,0.842848057534411,1,0
37,1,10,4,18,-14,0,1.02815397501195,-8,0
37,1,10,17,4,13,1,0.830227208996803,-6,0
37,1,2,6,17,-11,0,0.831725685045058,-7,0
37,1,2,3,11,-8,0,0.673071967537908,-1,0
37,1,10,1,11,-10,1,0.889184983715722,1,0
37,1,2,11,0,11,0,1.47311155545708,10,0
37,1,2,4,10,-6,0,1.61671966438257,0,0
37,1,10,1,11,-10,0,0.514788470385156,-1,0
37,1,2,6,18,-12,0,0.664840246251515,-8,0
37,1,10,18,4,14,1,1.1936406406644,-6,0
37,1,2,20,0,20,1,0.637038896963077,-10,0
37,1,10,16,6,10,0,0.839142188442111,4,0
37,1,2,15,0,15,1,1.02431651274424,-10,0
37,1,10,6,17,-11,0,1.32252167713477,-7,0
37,1,2,7,10,-3,0,0.39255673810203,0,0
37,1,10,10,16,-6,0,1.05187410308622,-6,0
37,1,10,18,2,16,1,1.41553166025506,-8,0
37,1,10,1,15,-14,0,0.84153029300569,-5,0
37,1,2,20,0,20,1,0.651689726018731,-10,0
37,1,10,6,17,-11,0,0.620349290074955,-7,0
37,1,10,20,4,16,1,0.718554454465675,-6,0
37,1,2,5,19,-14,0,0.693160637145638,-9,0
37,1,2,6,11,-5,0,0.748634674984942,-1,0
37,1,2,10,6,4,0,1.04141189580309,4,0
37,1,2,16,7,9,1,1.9547400118397,-3,0
37,1,10,16,6,10,1,1.51155252455442,-4,0
37,1,2,7,11,-4,0,0.965599564532795,-1,0
37,1,2,11,1,10,1,0.882184520023884,-9,0
37,1,10,14,7,7,1,1.20173856944643,-3,0
37,1,2,0,16,-16,1,0.70066951235367,6,0
37,1,2,9,16,-7,0,1.21926575406724,-6,0
37,1,2,4,15,-11,0,0.80533777109008,-5,0
37,1,10,2,11,-9,0,1.27275783006894,-1,0
37,1,10,9,18,-9,0,1.27352502927852,-8,0
37,1,10,5,13,-8,0,0.673599806458924,-3,0
37,1,10,11,2,9,1,1.28974031424741,-8,0
37,1,2,13,6,7,0,0.945144340118759,4,0
37,1,10,8,13,-5,0,1.4058436167229,-3,0
37,1,10,1,12,-11,0,1.44855384965035,-2,0
37,1,2,12,5,7,1,0.88940784903798,-5,0
37,1,2,11,3,8,0,1.51276692062811,7,0
37,1,10,13,9,4,0,1.99083906227952,1,0
37,1,10,9,19,-10,0,1.95434156676515,-9,0
37,1,2,9,18,-9,0,0.783091559892455,-8,0
37,1,2,18,8,10,0,0.682488760513252,2,0
37,1,10,11,4,7,0,1.38588030885921,6,0
37,1,2,6,19,-13,0,1.02066416065372,-9,0
37,1,10,16,6,10,1,1.23876940220407,-4,0
37,1,10,19,1,18,1,0.520190755121348,-9,0
37,1,10,10,9,1,0,1.47812016033117,1,0
37,1,2,7,18,-11,0,1.19029729427575,-8,0
37,1,2,12,6,6,1,1.41768736907125,-4,0
37,1,2,10,6,4,0,1.48376986956146,4,0
37,1,2,17,5,12,1,1.21119678311493,-5,0
37,1,10,9,11,-2,0,1.00598987209082,-1,0
37,1,10,7,15,-8,0,0.768599449068006,-5,0
37,1,10,10,4,6,1,0.896767536440166,-6,0
37,1,2,14,2,12,1,1.57546612025567,-8,0
37,1,2,5,11,-6,0,1.07560412814018,-1,0
37,1,2,15,3,12,1,0.547706191660609,-7,0
37,1,2,20,1,19,1,1.16031384422513,-9,0
37,1,10,9,16,-7,0,0.605146429481238,-6,0
37,1,10,11,4,7,1,1.23189430025604,-6,0
37,1,10,6,15,-9,0,2.04931298465408,-5,0
37,1,2,18,3,15,1,1.80201971698307,-7,0
37,1,10,13,6,7,1,0.668097085705995,-4,0
37,1,2,9,18,-9,0,0.699733697933198,-8,0
37,1,10,15,3,12,1,0.890319837396191,-7,0
37,1,2,2,15,-13,0,0.737800781128271,-5,0
37,1,10,9,16,-7,0,0.599162788822241,-6,0
37,1,10,11,2,9,1,1.76164993649445,-8,0
37,1,2,9,20,-11,0,1.25467678113569,-10,0
37,1,2,5,16,-11,0,0.799415345084071,-6,0
37,1,10,11,7,4,1,0.946132938431674,-3,0
37,1,2,20,8,12,0,0.758880614932423,2,0
37,1,10,1,14,-13,0,0.771665313468475,-4,0
37,1,10,13,10,3,1,1.55901147499821,0,0
37,1,2,9,17,-8,0,0.971807536733422,-7,0
37,1,10,19,8,11,0,1.36785387659211,2,0
37,1,2,9,20,-11,1,1.30798851217241,10,0
37,1,2,9,16,-7,0,1.52270605420244,-6,0
37,1,10,15,8,7,0,1.63281398626509,2,0
37,1,2,11,9,2,0,1.41021075068602,1,0
37,1,10,10,11,-1,1,1.46095439874944,1,0
37,1,10,4,18,-14,0,1.66974474956055,-8,0
37,1,2,11,3,8,0,1.49296306410497,7,0
37,1,2,1,16,-15,1,1.22793220935409,6,0
37,1,2,9,19,-10,0,1.36607975132938,-9,0
37,1,10,2,19,-17,0,0.409413127427342,-9,0
37,1,2,9,16,-7,0,0.619335399480406,-6,0
37,1,10,4,18,-14,0,0.59757120785298,-8,0
37,1,10,11,4,7,0,0.999523112197039,6,0
37,1,2,9,18,-9,0,0.715655739057183,-8,0
37,1,10,7,12,-5,0,1.37641366442995,-2,0
37,1,2,10,17,-7,1,1.50852441529923,7,0
37,1,10,13,4,9,0,1.2754853643828,6,0
37,1,10,13,4,9,1,2.12179846450181,-6,0
37,1,2,8,10,-2,0,1.16718051541238,0,0
37,1,2,6,15,-9,0,1.69140154062961,-5,0
37,1,10,3,15,-12,0,0.698639898390866,-5,0
37,1,10,15,8,7,1,0.841426924549978,-2,0
37,1,10,3,18,-15,0,1.09880521460855,-8,0
37,1,2,10,13,-3,1,0.945693072664199,3,0
37,1,10,11,9,2,1,1.36634806944767,-1,0
37,1,2,16,1,15,1,0.850450770773023,-9,0
37,1,2,3,19,-16,0,1.37058434334494,-9,0
37,1,2,12,10,2,0,1.39002384439027,0,0
37,1,10,6,12,-6,1,0.600820716211274,2,0
37,1,10,17,5,12,0,1.42676583196044,5,0
37,1,10,9,18,-9,0,0.723585785738123,-8,0
37,1,10,11,3,8,0,2.07286962928492,7,0
37,1,2,9,12,-3,0,1.00036545514195,-2,0
37,1,2,20,3,17,1,0.923182575450937,-7,0
37,1,2,9,19,-10,0,1.37650420346745,-9,0
37,1,2,11,0,11,0,1.46798528649015,10,0
37,1,10,13,2,11,1,1.27534863943993,-8,0
37,1,2,13,9,4,0,1.18592539510018,1,0
37,1,2,8,20,-12,0,1.18160701292663,-10,0
37,1,10,15,4,11,0,0.960210109215041,6,0
37,1,10,19,5,14,1,0.605091446260303,-5,0
37,1,10,11,3,8,1,0.599859609509167,-7,0
37,1,2,14,9,5,NaN,NaN,0,0
37,1,2,12,10,2,0,1.11848004384001,0,0
37,1,10,6,11,-5,0,0.868815899681067,-1,0
37,1,2,14,2,12,0,1.1008535228666,8,0
37,1,10,7,19,-12,0,1.93987254889407,-9,0
37,1,10,20,0,20,1,1.08901123673741,-10,0
37,1,2,1,11,-10,0,1.65572256199812,-1,0
37,1,2,6,12,-6,0,1.28052036120334,-2,0
37,1,10,10,19,-9,0,1.44789881621136,-9,0
37,1,2,18,9,9,1,0.952009911642108,-1,0
37,1,10,11,3,8,0,1.04406648571103,7,0
37,1,10,11,10,1,1,0.885611074354074,0,0
37,1,10,16,6,10,1,1.0761983134812,-4,0
37,1,2,10,3,7,0,1.66838226534537,7,0
37,1,2,17,8,9,1,1.96383240381147,-2,0
37,1,10,19,4,15,1,1.47164936833451,-6,0
37,1,10,10,4,6,0,0.735079478246007,6,0
37,1,2,6,12,-6,0,1.18849934295031,-2,0
37,1,2,7,18,-11,0,0.583326888077863,-8,0
37,1,10,15,0,15,1,1.09798009973929,-10,0
37,1,10,17,5,12,1,0.808752595666192,-5,0
37,1,10,3,11,-8,0,0.82687873084069,-1,0
37,1,2,10,20,-10,1,1.18823982214735,10,0
37,1,2,9,16,-7,1,1.41562439862082,6,0
37,1,2,17,3,14,1,1.93704897722046,-7,0
37,1,10,0,10,-10,0,1.45307273730305,0,0
37,1,10,13,9,4,1,1.34126802304172,-1,0
37,1,2,15,0,15,1,1.39402222421813,-10,0
37,1,2,19,8,11,1,1.17337015987277,-2,0
37,1,10,6,14,-8,0,0.944829102985295,-4,0
37,1,2,0,15,-15,0,0.461496533308036,-5,0
37,1,2,0,19,-19,0,0.773643976312997,-9,0
37,1,10,20,5,15,0,1.32907567707298,5,0
37,1,10,3,19,-16,0,0.790523458591451,-9,0
37,1,2,17,8,9,0,0.825247928507451,2,0
37,1,10,5,19,-14,0,0.642606497916859,-9,0
37,1,10,10,5,5,1,2.10807281977804,-5,0
37,1,10,9,15,-6,1,2.33820912318242,5,0
37,1,2,12,10,2,1,1.33491892724078,0,0
37,1,10,10,12,-2,0,1.22764116483813,-2,0
37,1,2,5,10,-5,NaN,NaN,0,0
37,1,2,10,13,-3,0,1.23396533491177,-3,0
37,1,2,17,4,13,0,0.762627904718101,6,0
37,1,2,1,10,-9,1,0.934102609687216,0,0
37,1,10,4,13,-9,0,0.946849919632768,-3,0
37,1,10,15,4,11,1,1.58287785844004,-6,0
37,1,10,10,10,0,1,1.45826865168328,0,0
37,1,10,16,10,6,1,1.13029373869404,0,0
37,1,2,1,17,-16,0,0.6713594234825,-7,0
37,1,10,9,19,-10,0,1.64648977953584,-9,0
37,1,2,18,9,9,1,1.3264921987975,-1,0
37,1,2,3,20,-17,0,0.891941842414781,-10,0
37,1,10,1,11,-10,1,1.18674317887326,1,0
37,1,2,17,4,13,0,0.989488674372751,6,0
37,1,2,13,4,9,1,1.85624710192587,-6,0
38,1,10,6,20,-14,1,1.34194709533858,10,0
38,1,2,20,0,20,NaN,NaN,0,0
38,1,2,10,9,1,0,1.43017871314078,1,0
38,1,2,20,8,12,1,0.90380647443385,-2,0
38,1,2,11,8,3,1,1.14267763638986,-2,0
38,1,10,10,16,-6,0,0.780582929971615,-6,0
38,1,10,11,0,11,1,1.12862837527018,-10,0
38,1,10,5,11,-6,0,0.622703954928738,-1,0
38,1,2,15,0,15,1,0.681435716602891,-10,0
38,1,10,10,12,-2,1,1.41737316792,2,0
38,1,2,20,3,17,1,0.587131041030261,-7,0
38,1,10,10,20,-10,1,0.870936892323016,10,0
38,1,10,0,14,-14,0,1.22377795657439,-4,0
38,1,2,17,3,14,1,0.66616583245218,-7,0
38,1,2,1,20,-19,0,0.682966810416701,-10,0
38,1,10,16,9,7,1,0.378268877961546,-1,0
38,1,10,10,20,-10,1,1.00616432958282,10,0
38,1,2,11,5,6,1,0.545523190921131,-5,0
38,1,10,1,17,-16,0,0.550411914453662,-7,0
38,1,2,6,17,-11,0,0.587392760202647,-7,0
38,1,10,10,20,-10,1,0.922819969099464,10,0
38,1,2,2,15,-13,0,0.672642465585113,-5,0
38,1,10,2,11,-9,0,0.392580957914106,-1,0
38,1,10,6,20,-14,0,0.580543708751293,-10,0
38,1,2,12,9,3,1,0.608509905190886,-1,0
38,1,2,11,6,5,1,0.675119267333002,-4,0
38,1,2,10,12,-2,1,0.939750340436603,2,0
38,1,10,1,19,-18,0,0.8489777740308,-9,0
38,1,10,9,13,-4,0,0.738315650183495,-3,0
38,1,2,1,12,-11,0,0.528312039631828,-2,0
38,1,10,9,19,-10,0,0.757568137706812,-9,0
38,1,10,4,14,-10,0,0.53824270604423,-4,0
38,1,2,10,15,-5,1,0.711555048082801,5,0
38,1,2,8,17,-9,0,0.589665391671588,-7,0
38,1,2,19,3,16,1,0.800752167705468,-7,0
38,1,10,9,17,-8,0,0.491414401519023,-7,0
38,1,2,11,1,10,1,0.546677101221803,-9,0
38,1,2,13,8,5,1,0.615774994822459,-2,0
38,1,10,17,1,16,1,0.401933936069327,-9,0
38,1,10,9,16,-7,0,0.517132159018274,-6,0
38,1,10,9,18,-9,0,0.75574746665734,-8,0
38,1,2,11,3,8,1,0.441075981034601,-7,0
38,1,10,12,4,8,1,0.499062172965523,-6,0
38,1,2,5,16,-11,0,0.657546694329312,-6,0
38,1,2,17,7,10,1,0.530234245990414,-3,0
38,1,2,17,2,15,1,0.55881551914058,-8,0
38,1,10,9,17,-8,0,0.611427304200788,-7,0
38,1,10,10,13,-3,1,1.02126669880113,3,0
38,1,10,13,10,3,1,0.51932084974419,0,0
38,1,2,11,0,11,1,0.613893109344644,-10,0
38,1,10,1,15,-14,0,0.543976335308344,-5,0
38,1,10,9,17,-8,0,0.661201232352823,-7,0
38,1,2,5,12,-7,0,0.613003850643963,-2,0
38,1,10,9,20,-11,0,0.455220912608183,-10,0
38,1,2,2,12,-10,0,0.735733647591815,-2,0
38,1,2,11,0,11,1,0.5490970871831,-10,0
38,1,10,9,18,-9,0,0.633699825703843,-8,0
38,1,2,16,8,8,1,0.427014257096971,-2,0
38,1,2,16,4,12,1,0.389060945011352,-6,0
38,1,10,15,4,11,1,0.432247174330996,-6,0
38,1,10,14,3,11,1,0.449670193522024,-7,0
38,1,2,11,2,9,1,0.490169952513043,-8,0
38,1,10,2,15,-13,0,0.490189013293048,-5,0
38,1,10,18,10,8,1,0.801300898239333,0,0
38,1,2,10,19,-9,1,0.884007455697429,9,0
38,1,2,11,3,8,1,0.555332894690991,-7,0
38,1,2,0,11,-11,0,1.00782921541054,-1,0
38,1,10,7,17,-10,0,0.63463380392659,-7,0
38,1,10,11,1,10,1,0.467882035764433,-9,0
38,1,2,9,16,-7,0,0.619827243353029,-6,0
38,1,10,6,15,-9,0,0.405643090558897,-5,0
38,1,10,9,16,-7,0,0.496099321326255,-6,0
38,1,2,8,18,-10,0,0.359042782287361,-8,0
38,1,2,9,19,-10,0,0.556353746084824,-9,0
38,1,10,5,15,-10,0,0.392937980986972,-5,0
38,1,10,11,3,8,1,0.516220907109982,-7,0
38,1,2,9,20,-11,0,0.618138531550358,-10,0
38,1,10,3,14,-11,0,0.548107759387221,-4,0
38,1,2,13,10,3,1,0.472752431624031,0,0
38,1,2,12,3,9,1,0.640711260339231,-7,0
38,1,2,9,18,-9,0,0.625130172298213,-8,0
38,1,2,15,2,13,1,0.491182739730903,-8,0
38,1,2,10,13,-3,1,0.586294199474651,3,0
38,1,10,11,4,7,1,0.565848580430156,-6,0
38,1,10,3,19,-16,0,0.513782226922558,-9,0
38,1,10,11,1,10,1,0.551664427635842,-9,0
38,1,2,9,17,-8,0,0.644421147935191,-7,0
38,1,10,3,12,-9,0,0.533570615607914,-2,0
38,1,10,11,8,3,1,0.442869160574446,-2,0
38,1,2,3,16,-13,0,0.468217432182882,-6,0
38,1,2,16,0,16,1,0.420256844011419,-10,0
38,1,10,11,0,11,1,0.510137585842131,-10,0
38,1,10,0,20,-20,0,0.516862009116267,-10,0
38,1,10,9,19,-10,0,0.570741336051015,-9,0
38,1,2,11,2,9,1,0.502725141718656,-8,0
38,1,2,9,20,-11,0,0.469331754709856,-10,0
38,1,2,16,5,11,1,0.509318338853063,-5,0
38,1,10,18,8,10,1,0.627954466728625,-2,0
38,1,2,4,11,-7,0,0.461796881729697,-1,0
38,1,10,10,9,1,1,0.829798963753547,-1,0
38,1,10,20,8,12,1,0.910381343895097,-2,0
38,1,2,11,4,7,1,0.620929836169125,-6,0
38,1,2,16,3,13,1,0.439058470775763,-7,0
38,1,10,14,1,13,1,0.776234506243327,-9,0
38,1,2,18,0,18,1,0.45224706436511,-10,0
38,1,2,9,19,-10,0,0.492745723695862,-9,0
38,1,2,14,5,9,1,0.412214661038433,-5,0
38,1,10,0,13,-13,0,0.485987210949588,-3,0
38,1,10,11,0,11,1,0.429354700956537,-10,0
38,1,10,9,17,-8,0,0.454597771721183,-7,0
38,1,2,9,17,-8,0,0.455369000206701,-7,0
38,1,2,9,20,-11,0,0.591943887995967,-10,0
38,1,10,7,16,-9,0,0.355207533406428,-6,0
38,1,10,7,14,-7,0,0.415704616557832,-4,0
38,1,2,11,0,11,1,0.513815583287396,-10,0
38,1,10,11,4,7,1,0.471841912822583,-6,0
38,1,10,8,14,-6,0,0.423714176271915,-4,0
38,1,2,1,17,-16,0,0.609683975932057,-7,0
38,1,2,10,1,9,1,0.860177815084626,-9,0
38,1,10,8,16,-8,0,0.588913590519496,-6,0
38,1,2,1,15,-14,0,0.999555004096237,-5,0
38,1,2,11,0,11,1,0.674177958040673,-10,0
38,1,10,11,2,9,1,0.96142611290179,-8,0
38,1,2,14,6,8,1,0.612750562201654,-4,0
38,1,10,11,1,10,1,0.462689805965056,-9,0
38,1,2,2,12,-10,0,0.686686961510077,-2,0
38,1,10,6,18,-12,0,0.981842407669774,-8,0
38,1,10,18,5,13,1,0.657067608953639,-5,0
38,1,2,19,6,13,1,0.545786742860855,-4,0
38,1,10,9,20,-11,0,0.654416694310839,-10,0
38,1,10,10,16,-6,1,0.998975116518068,6,0
38,1,10,2,17,-15,0,0.881630356491314,-7,0
38,1,10,9,20,-11,0,0.768960252775287,-10,0
38,1,2,9,16,-7,0,0.692850191432171,-6,0
38,1,10,11,0,11,1,1.04413633589502,-10,0
38,1,2,11,2,9,1,1.06950146896315,-8,0
38,1,2,18,8,10,1,1.68524127465298,-2,0
38,1,2,8,19,-11,0,0.492615230662977,-9,0
38,1,10,10,10,0,1,0.819947106335349,0,0
38,1,2,5,10,-5,0,1.14188038260863,0,0
38,1,2,9,20,-11,0,0.635185833441938,-10,0
38,1,10,5,18,-13,0,0.780684465280956,-8,0
38,1,10,0,16,-16,0,0.479878597493098,-6,0
38,1,2,2,19,-17,0,0.663128937012971,-9,0
38,1,10,11,3,8,1,0.654990350480148,-7,0
38,1,2,19,0,19,1,1.06365530778567,-10,0
38,1,2,18,6,12,1,1.20742417383417,-4,0
38,1,2,9,19,-10,0,0.705457797783311,-9,0
38,1,10,11,2,9,1,0.68025358168552,-8,0
38,1,10,15,1,14,1,0.687528568260404,-9,0
38,1,2,8,18,-10,0,0.558123466202687,-8,0
38,1,2,7,10,-3,0,0.586751291642486,0,0
38,1,10,12,6,6,1,0.925386942999012,-4,0
38,1,10,10,10,0,1,0.738645181746506,0,0
38,1,2,11,4,7,1,0.839213522890532,-6,0
38,1,2,18,10,8,1,0.519793337157807,0,0
38,1,10,9,18,-9,0,1.06918549987813,-8,0
38,1,10,9,17,-8,0,0.628422555500492,-7,0
38,1,2,9,20,-11,0,0.437822452499404,-10,0
38,1,10,18,2,16,1,0.502150385889308,-8,0
38,1,10,9,20,-11,0,0.556294730977243,-10,0
38,1,10,3,20,-17,0,0.464989928943396,-10,0
38,1,10,11,0,11,1,0.608280809276494,-10,0
38,1,2,11,4,7,1,0.45030506411922,-6,0
38,1,2,16,1,15,1,0.55412033583616,-9,0
38,1,10,16,5,11,1,0.382179270302004,-5,0
38,1,2,9,19,-10,0,0.392052754374618,-9,0
38,1,10,10,4,6,0,1.07462038806989,6,0
38,1,2,13,5,8,1,0.833953480700075,-5,0
38,1,2,11,2,9,1,0.594750954413939,-8,0
38,1,2,9,19,-10,0,0.700523621621414,-9,0
38,1,2,19,8,11,1,0.378541227184087,-2,0
38,1,2,16,0,16,1,0.429088949696052,-10,0
38,1,10,9,16,-7,0,0.445753203219283,-6,0
38,1,10,9,17,-8,0,0.477611464325946,-7,0
38,1,2,4,10,-6,0,0.509007868070057,0,0
38,1,10,1,16,-15,0,0.442930741556211,-6,0
38,1,10,4,14,-10,0,0.483595816158868,-4,0
38,1,2,11,0,11,1,0.513732467836689,-10,0
38,1,10,6,15,-9,0,0.447505695324708,-5,0
38,1,2,15,8,7,1,0.382813774345777,-2,0
38,1,10,11,3,8,1,0.58532723144026,-7,0
38,1,10,11,2,9,1,0.875903691743133,-8,0
38,1,10,7,17,-10,0,0.675339565963895,-7,0
38,1,2,0,13,-13,0,0.834559760127377,-3,0
38,1,2,11,1,10,1,0.899221257168392,-9,0
38,1,10,20,9,11,1,0.985141022281368,-1,0
38,1,2,19,8,11,1,0.603145395263709,-2,0
38,1,2,12,0,12,1,0.581052484957581,-10,0
38,1,10,9,17,-8,0,1.07153547412736,-7,0
38,1,10,3,17,-14,0,0.486263958814106,-7,0
38,1,2,10,15,-5,1,0.813004217197431,5,0
38,1,2,12,2,10,0,0.990213389098244,8,0
38,1,2,19,9,10,1,0.904769410380595,-1,0
38,1,10,9,19,-10,0,0.494854139213203,-9,0
38,1,10,11,4,7,1,0.955435529660463,-6,0
38,1,10,11,2,9,1,0.487374982359597,-8,0
38,1,2,11,1,10,1,0.47002710662855,-9,0
38,1,2,0,14,-14,0,0.429286522012262,-4,0
38,1,10,6,20,-14,0,0.477776046830968,-10,0
39,1,10,11,5,6,1,1.41565219938639,-5,0
39,1,10,11,0,11,1,1.02552531694528,-10,0
39,1,2,6,17,-11,0,0.955454590439331,-7,0
39,1,2,1,17,-16,0,1.28805897114216,-7,0
39,1,2,0,14,-14,0,0.711380935186753,-4,0
39,1,10,10,16,-6,0,0.78932193107903,-6,0
39,1,2,11,8,3,1,0.648507119389251,-2,0
39,1,10,10,9,1,1,0.745202456630068,-1,0
39,1,2,16,9,7,1,0.749587169178994,-1,0
39,1,10,20,8,12,1,0.506491478561657,-2,0
39,1,10,5,11,-6,0,0.753100217552856,-1,0
39,1,10,10,12,-2,0,0.765602256520651,-2,0
39,1,2,15,0,15,1,0.489672906027408,-10,0
39,1,2,20,0,20,1,0.49700214251061,-10,0
39,1,10,1,20,-19,0,1.67153987276834,-10,0
39,1,2,17,3,14,1,0.671497719129547,-7,0
39,1,2,6,20,-14,0,0.647504595661303,-10,0
39,1,10,20,3,17,1,0.4561387624708,-7,0
39,1,10,10,20,-10,0,0.488618698262144,-10,0
39,1,2,10,20,-10,0,0.664021128148306,-10,0
39,1,10,11,3,8,1,0.907329419773305,-7,0
39,1,2,2,20,-18,0,0.561937088437844,-10,0
39,1,2,16,2,14,1,0.901884634629823,-8,0
39,1,2,19,0,19,1,0.82852665669634,-10,0
39,1,10,11,1,10,1,0.845830912556266,-9,0
39,1,2,14,10,4,1,0.702419436129276,0,0
39,1,2,20,5,15,1,0.508906699309591,-5,0
39,1,10,9,19,-10,0,0.643683275819058,-9,0
39,1,10,9,20,-11,0,0.572987575666048,-10,0
39,1,10,0,18,-18,0,0.664777327940101,-8,0
39,1,10,9,16,-7,0,0.760730760986917,-6,0
39,1,10,8,18,-10,0,0.612587079347577,-8,0
39,1,10,17,6,11,1,0.566924414830282,-4,0
39,1,2,11,3,8,1,0.554740544292144,-7,0
39,1,10,1,11,-10,0,0.679268652544124,-1,0
39,1,2,4,20,-16,0,0.470649514405522,-10,0
39,1,2,9,19,-10,0,0.75857359386282,-9,0
39,1,2,9,20,-11,0,0.451168664090801,-10,0
39,1,10,0,12,-12,0,0.523881507921033,-2,0
39,1,2,18,0,18,1,0.745804337435402,-10,0
39,1,2,11,0,11,1,0.63195283189998,-10,0
39,1,2,4,19,-15,0,0.713362156646326,-9,0
39,1,2,12,0,12,1,0.807331435818924,-10,0
39,1,10,18,3,15,1,0.570000531501137,-7,0
39,1,10,1,16,-15,0,0.669967724970775,-6,0
39,1,10,3,10,-7,0,0.485868081072113,0,0
39,1,2,9,20,-11,0,1.50890156757669,-10,0
39,1,10,6,12,-6,0,0.491818343434716,-2,0
39,1,2,9,18,-9,0,0.523109912872314,-8,0
39,1,10,9,16,-7,0,0.497069954901235,-6,0
39,1,10,9,18,-9,0,0.375385201856261,-8,0
39,1,10,4,16,-12,0,1.29154379488318,-6,0
39,1,10,4,10,-6,1,0.818929920467781,0,0
39,1,2,9,20,-11,0,0.428852522716625,-10,0
39,1,10,15,0,15,1,1.4781129094772,-10,0
39,1,2,11,2,9,1,0.645419639564352,-8,0
39,1,10,20,3,17,1,0.757945687772008,-7,0
39,1,2,9,17,-8,0,0.570545596507145,-7,0
39,1,2,13,6,7,1,0.790518361580325,-4,0
39,1,2,14,8,6,1,0.649922382290242,-2,0
39,1,10,9,17,-8,0,0.610491493192967,-7,0
39,1,2,15,8,7,1,0.661159078706987,-2,0
39,1,2,11,4,7,1,0.52489172926289,-6,0
39,1,10,11,2,9,1,0.475107537611621,-8,0
39,1,2,5,12,-7,0,0.659051396301948,-2,0
39,1,2,18,8,10,1,0.395682366768597,-2,0
39,1,10,9,19,-10,0,0.542304484988563,-9,0
39,1,2,1,15,-14,0,0.475492052210029,-5,0
39,1,10,14,6,8,1,0.5235483108263,-4,0
39,1,10,2,11,-9,0,0.537453882978298,-1,0
39,1,2,9,16,-7,0,0.462796839565272,-6,0
39,1,10,8,13,-5,0,0.430536469328217,-3,0
39,1,10,19,5,14,1,0.504035570338601,-5,0
39,1,10,13,9,4,1,0.558642505930038,-1,0
39,1,2,11,3,8,1,0.499128885683604,-7,0
39,1,10,9,19,-10,0,0.665996851312229,-9,0
39,1,2,17,1,16,1,0.473863088613143,-9,0
39,1,2,11,1,10,1,0.561681600665906,-9,0
39,1,10,0,14,-14,0,0.661742998374393,-4,0
39,1,2,6,10,-4,0,0.685726958006853,0,0
39,1,10,11,4,7,1,0.654856558452593,-6,0
39,1,2,11,1,10,1,0.471487822185736,-9,0
39,1,2,5,13,-8,0,0.551090038352413,-3,0
39,1,10,20,9,11,1,0.556033378350548,-1,0
39,1,10,3,13,-10,0,0.528702419076581,-3,0
39,1,2,11,3,8,1,0.381990495254286,-7,0
39,1,10,8,10,-2,0,0.505227235669736,0,0
39,1,2,11,2,9,1,0.551779525412712,-8,0
39,1,2,6,13,-7,0,0.468489781429525,-3,0
39,1,10,20,4,16,1,0.356329186994117,-6,0
39,1,10,7,14,-7,0,0.576127106091008,-4,0
39,1,2,11,0,11,1,0.412216127238935,-10,0
39,1,10,11,4,7,1,0.40635970258154,-6,0
39,1,10,9,18,-9,0,0.608921544713667,-8,0
39,1,10,3,19,-16,0,0.523608059040271,-9,0
39,1,10,11,3,8,1,0.473547119530849,-7,0
39,1,2,2,18,-16,0,0.449544099130435,-8,0
39,1,2,9,19,-10,0,0.690090410411358,-9,0
39,1,2,8,12,-4,0,0.513395146466792,-2,0
39,1,2,13,9,4,1,0.407417575857835,-1,0
39,1,10,10,17,-7,0,0.433408415701706,-7,0
39,1,10,9,20,-11,0,0.914614669833099,-10,0
39,1,2,6,16,-10,0,0.688538423040882,-6,0
39,1,2,7,10,-3,0,0.687659061310114,0,0
39,1,10,6,15,-9,0,0.607022431242513,-5,0
39,1,10,17,4,13,1,1.02575148042524,-6,0
39,1,10,11,4,7,1,0.491738068230916,-6,0
39,1,2,9,16,-7,0,1.64297802696819,-6,0
39,1,2,11,0,11,0,1.18830547831021,10,0
39,1,2,11,9,2,0,0.911318621103419,1,0
39,1,10,20,5,15,1,1.45283171714982,-5,0
39,1,10,9,17,-8,0,1.62945477003814,-7,0
39,1,10,11,9,2,0,0.990494169062003,1,0
39,1,2,3,13,-10,0,0.674017041077605,-3,0
39,1,10,11,4,7,1,0.52188599089277,-6,0
39,1,2,20,0,20,1,0.735398984281346,-10,0
39,1,2,9,16,-7,0,0.644600392581197,-6,0
39,1,2,18,2,16,1,0.557866878778441,-8,0
39,1,10,19,10,9,1,0.721773092402145,0,0
39,1,2,11,0,11,0,0.615785991423763,10,0
39,1,2,9,20,-11,0,0.651719593908638,-10,0
39,1,10,11,3,8,1,0.51568060729187,-7,0
39,1,10,3,18,-15,0,0.544934872596059,-8,0
39,1,10,12,7,5,1,0.829540543549228,-3,0
39,1,10,9,15,-6,0,0.846885486855172,-5,0
39,1,10,18,5,13,1,0.494817483850056,-5,0
39,1,2,11,4,7,0,0.492699537950102,6,0
39,1,2,11,1,10,1,0.420095927023795,-9,0
39,1,2,1,13,-12,0,0.61379597269115,-3,0
39,1,2,8,15,-7,0,0.551351390982745,-5,0
39,1,2,11,3,8,1,0.419246622681385,-7,0
39,1,10,0,15,-15,0,0.772520586557221,-5,0
39,1,2,4,13,-9,0,0.544542660412844,-3,0
39,1,2,12,5,7,1,0.660497449687682,-5,0
39,1,2,9,19,-10,0,0.63705855506123,-9,0
39,1,10,9,16,-7,0,0.597467848681845,-6,0
39,1,10,9,18,-9,0,0.528183745918795,-8,0
39,1,2,0,19,-19,0,0.516935319814365,-9,0
39,1,10,10,12,-2,0,0.778227090864675,-2,0
39,1,10,6,18,-12,0,0.748881187202642,-8,0
39,1,10,17,8,9,1,0.489007611497073,-2,0
39,1,10,9,20,-11,0,0.487958168931073,-10,0
39,1,10,1,13,-12,0,0.831386506819399,-3,0
39,1,2,9,17,-8,0,0.648679032979999,-7,0
39,1,10,9,13,-4,0,0.528667596488958,-3,0
39,1,2,10,10,0,1,1.71711529756431,0,0
39,1,10,12,8,4,0,0.835182901006192,2,0
39,1,2,9,18,-9,0,0.876481013459852,-8,0
39,1,2,10,10,0,1,1.1484255612304,0,0
39,1,2,9,19,-10,0,0.616339120606426,-9,0
39,1,10,11,4,7,1,2.2331045428873,-6,0
39,1,10,11,0,11,1,0.545647819089936,-10,0
39,1,2,9,19,-10,0,0.589414302550722,-9,0
39,1,10,3,18,-15,0,1.00815691420576,-8,0
39,1,2,11,1,10,0,0.722136713447981,9,0
39,1,10,17,10,7,0,1.2792462927755,0,0
39,1,10,13,7,6,0,0.774229458824266,3,0
39,1,2,14,7,7,1,0.537392668571556,-3,0
39,1,2,18,2,16,1,0.694008500373457,-8,0
39,1,2,16,4,12,1,0.476650727679953,-6,0
39,1,10,11,1,10,0,0.777698887337465,9,0
39,1,10,9,17,-8,0,0.98103782281396,-7,0
39,1,2,19,3,16,1,0.544333724916214,-7,0
39,1,10,20,6,14,1,0.549594500218518,-4,0
39,1,2,2,15,-13,0,0.48957760212943,-5,0
39,1,2,16,10,6,1,0.55217576972791,0,0
39,1,2,17,10,7,0,0.508116776618408,0,0
39,1,2,11,0,11,0,1.10604648262961,10,0
39,1,10,8,12,-4,0,0.807856706902385,-2,0
39,1,10,11,3,8,0,0.970030588883674,7,0
39,1,10,11,2,9,0,0.661319629114587,8,0
39,1,2,9,19,-10,0,0.581006299238652,-9,0
39,1,10,16,8,8,0,0.511568243993679,2,0
39,1,2,2,13,-11,1,0.421204751270125,3,0
39,1,2,9,18,-9,0,0.799109275074443,-8,0
39,1,2,7,15,-8,0,0.60909749037819,-5,0
39,1,10,11,1,10,0,0.698883661447326,9,0
39,1,10,16,7,9,1,0.513071479770588,-3,0
39,1,2,8,17,-9,0,0.766272316221148,-7,0
39,1,10,17,0,17,1,0.521480949304532,-10,0
39,1,2,20,7,13,1,0.502215998974862,-3,0
39,1,10,0,14,-14,0,0.620119386469014,-4,0
39,1,2,3,12,-9,1,0.517368219443597,2,0
39,1,10,11,2,9,0,0.658518427575473,8,0
39,1,2,10,13,-3,0,0.810376395413186,-3,0
39,1,2,9,19,-10,0,0.572649979934795,-9,0
39,1,10,9,17,-8,0,0.424051772017265,-7,0
39,1,10,9,16,-7,0,0.785218731616624,-6,0
39,1,10,6,15,-9,0,0.475787494302494,-5,0
39,1,2,11,4,7,1,0.723103681491921,-6,0
39,1,2,11,0,11,0,1.03171933733393,10,0
39,1,10,20,1,19,1,0.920356363261817,-9,0
39,1,2,7,15,-8,0,0.613697736349422,-5,0
39,1,10,11,1,10,0,0.742933490721043,9,0
39,1,2,9,16,-7,0,0.45952241748455,-6,0
39,1,2,9,17,-8,0,0.443615829979535,-7,0
39,1,2,13,4,9,1,0.659493459766963,-6,0
39,1,10,4,12,-8,0,0.595293086982565,-2,0
39,1,10,9,10,-1,0,0.509376620844705,0,0
39,1,10,12,0,12,1,1.04330755851697,-10,0
40,1,10,1,20,-19,0,1.93003531754948,-10,0
40,1,2,5,11,-6,0,0.910753068543272,-1,0
40,1,2,6,20,-14,0,1.86149836608092,-10,0
40,1,2,6,17,-11,0,1.94220567026059,-7,0
40,1,10,10,12,-2,1,1.59572193885106,2,0
40,1,2,10,16,-6,0,1.13436432983144,-6,0
40,1,10,17,3,14,1,2.54780882698833,-7,0
40,1,10,11,5,6,1,3.35246297338745,-5,0
40,1,2,0,14,-14,NaN,NaN,0,0
40,1,10,16,9,7,1,1.0742302807048,-1,0
40,1,10,20,0,20,0,1.64214537196676,10,0
40,1,10,10,20,-10,1,2.0515533676371,10,0
40,1,2,11,8,3,1,1.27649595597177,-2,0
40,1,10,10,9,1,0,1.43652095503057,1,0
40,1,2,15,0,15,NaN,NaN,0,0
40,1,2,20,3,17,1,1.1548133227916,-7,0
40,1,2,1,17,-16,1,1.51150890454301,7,0
40,1,10,20,8,12,1,1.2141644108051,-2,0
40,1,10,11,0,11,0,1.37628463713918,10,0
40,1,2,10,20,-10,1,0.996425724093569,10,0
40,1,2,11,6,5,1,0.884533769800328,-4,0
40,1,10,10,12,-2,1,0.707972750300542,2,0
40,1,10,10,20,-10,1,0.650636980601121,10,0
40,1,2,14,9,5,1,1.12338124815142,-1,0
40,1,10,11,0,11,0,0.833473784907255,10,0
40,1,2,2,18,-16,0,0.802867191698169,-8,0
40,1,2,11,5,6,0,0.909610883740243,5,0
40,1,2,6,10,-4,0,1.02043139835587,0,0
40,1,10,10,7,3,0,0.726514192065224,3,0
40,1,10,0,11,-11,0,0.812598122138297,-1,0
40,1,2,8,15,-7,1,1.16599104506895,5,0
40,1,2,10,12,-2,1,0.658085374278016,2,0
40,1,10,9,13,-4,1,0.986802560742944,3,0
40,1,10,0,11,-11,0,0.694259935000446,-1,0
40,1,10,14,10,4,1,0.757647891121451,0,0
40,1,10,20,5,15,0,1.10641122685047,5,0
40,1,10,11,2,9,0,0.769128021114739,8,0
40,1,2,1,17,-16,0,0.661179463379085,-7,0
40,1,2,12,2,10,0,0.749994226760464,8,0
40,1,2,10,9,1,0,0.578735056013102,1,0
40,1,2,19,2,17,0,0.819439867598703,8,0
40,1,10,5,19,-14,0,0.917459188698558,-9,0
40,1,10,9,12,-3,1,0.675697599624982,2,0
40,1,10,1,10,-9,0,0.571777479228331,0,0
40,1,2,13,6,7,0,0.903796957980376,4,0
40,1,2,11,5,6,0,0.686580978363054,5,0
40,1,2,7,15,-8,0,0.861953627172625,-5,0
40,1,10,0,11,-11,0,0.574033624085132,-1,0
40,1,2,20,5,15,0,0.681942593859276,5,0
40,1,10,1,17,-16,0,0.577516261284472,-7,0
40,1,2,17,0,17,0,0.676934355549747,10,0
40,1,10,10,9,1,0,1.26900577507331,1,0
40,1,2,9,15,-6,1,1.68506893981248,5,0
40,1,10,4,16,-12,0,0.636477334977826,-6,0
40,1,2,10,14,-4,1,0.621975693764398,4,0
40,1,2,2,11,-9,0,0.695920794853009,-1,0
40,1,2,1,17,-16,0,0.686720635741949,-7,0
40,1,10,6,13,-7,1,1.71808783020242,3,0
40,1,10,13,6,7,1,1.17217849020381,-4,0
40,1,10,9,13,-4,1,1.0243128472066,3,0
40,1,10,13,6,7,0,0.729726311867125,4,0
40,1,2,2,18,-16,0,0.735049787326716,-8,0
40,1,2,3,17,-14,0,0.660544957005186,-7,0
40,1,2,6,12,-6,0,0.621294268377824,-2,0
40,1,2,10,9,1,0,1.25535527407192,1,0
40,1,10,3,14,-11,0,0.528117136243964,-4,0
40,1,2,10,20,-10,NaN,NaN,0,0
40,1,10,16,8,8,1,1.37017746749916,-2,0
40,1,10,14,3,11,0,0.934366895700805,7,0
40,1,10,1,12,-11,0,0.731627998204203,-2,0
40,1,2,6,13,-7,0,1.16050995106343,-3,0
40,1,10,10,7,3,1,0.677315939101391,-3,0
40,1,10,14,8,6,0,0.789160607819213,2,0
40,1,2,1,11,-10,0,0.648594903788762,-1,0
40,1,10,14,6,8,0,1.28949838806875,4,0
40,1,10,3,12,-9,0,0.696963276714087,-2,0
40,1,2,16,8,8,1,0.775671757495729,-2,0
40,1,2,15,7,8,1,0.587689623382175,-3,0
40,1,2,12,2,10,0,1.5510055514751,8,0
40,1,10,19,0,19,0,0.739922400331125,10,0
40,1,10,16,5,11,0,1.36534590861993,5,0
40,1,2,9,15,-6,1,0.633407071960391,5,0
40,1,2,10,16,-6,1,0.570854860794498,6,0
40,1,10,13,6,7,1,1.23890649370151,-4,0
40,1,10,6,13,-7,1,0.96034720071475,3,0
40,1,2,6,15,-9,1,1.02903957144008,5,0
40,1,10,1,14,-13,0,0.806461261585355,-4,0
40,1,2,8,13,-5,1,0.881227445439436,3,0
40,1,2,9,13,-4,1,0.928519613429671,3,0
40,1,10,10,7,3,0,1.07068936128053,3,0
40,1,2,5,10,-5,0,0.734112506674137,0,0
40,1,2,10,7,3,0,1.06753039197065,3,0
40,1,2,14,4,10,0,1.09160791098839,6,0
40,1,10,0,15,-15,0,0.658911588834599,-5,0
40,1,10,20,5,15,0,1.09974542769487,5,0
40,1,2,10,4,6,0,1.23450527014211,6,0
40,1,2,4,20,-16,0,0.955926916300086,-10,0
40,1,10,9,15,-6,1,0.824689665547339,5,0
40,1,10,10,16,-6,1,1.72265986830462,6,0
40,1,10,1,13,-12,0,0.848874951654579,-3,0
40,1,10,1,11,-10,0,0.897579821874388,-1,0
40,1,2,14,8,6,1,0.976372610311955,-2,0
40,1,10,6,13,-7,0,0.900344744790345,-3,0
40,1,2,8,18,-10,1,0.611179555038689,8,0
40,1,2,9,16,-7,1,0.677921487629646,6,0
40,1,10,2,10,-8,0,0.773296115803532,0,0
40,1,2,14,6,8,1,1.71281493932474,-4,0
40,1,10,2,16,-14,0,0.734200846374733,-6,0
40,1,10,4,13,-9,0,0.835552517237375,-3,0
40,1,2,10,7,3,0,1.31629427755252,3,0
40,1,10,14,4,10,0,1.20170741228503,6,0
40,1,2,0,18,-18,0,0.883749709028052,-8,0
40,1,10,20,2,18,0,1.07519102087826,8,0
40,1,2,6,15,-9,1,0.898463585530408,5,0
40,1,10,0,16,-16,0,0.73732425988419,-6,0
40,1,10,16,1,15,0,1.19011145099648,9,0
40,1,10,12,2,10,0,1.11281750519993,8,0
40,1,2,0,14,-14,0,0.574135892849881,-4,0
40,1,2,9,12,-3,1,0.706240778847132,2,0
40,1,2,12,0,12,0,0.632443032809533,10,0
40,1,2,17,10,7,1,0.931910245388281,0,0
40,1,10,13,6,7,0,0.55280753489933,4,0
40,1,2,6,17,-11,NaN,NaN,0,0
40,1,2,2,18,-16,0,0.625488021905767,-8,0
40,1,2,16,3,13,0,0.706838263198733,7,0
40,1,10,11,0,11,0,0.848934700101381,10,0
40,1,10,4,17,-13,0,0.665670859452803,-7,0
40,1,10,10,4,6,0,0.76110853505088,6,0
40,1,2,18,9,9,1,1.02183163771406,-1,0
40,1,10,14,6,8,1,0.807917583821109,-4,0
40,1,2,0,12,-12,0,0.601290639460785,-2,0
40,1,10,10,19,-9,1,0.91607031255262,9,0
40,1,10,10,9,1,1,0.489511584048159,-1,0
40,1,2,3,20,-17,0,1.31208879424958,-10,0
40,1,10,14,6,8,1,0.98235625095549,-4,0
40,1,2,6,13,-7,0,0.689000973216025,-3,0
40,1,10,16,7,9,1,0.855745654960629,-3,0
40,1,2,0,16,-16,0,0.496534774138127,-6,0
40,1,10,18,10,8,1,0.575274412083672,0,0
40,1,2,14,8,6,1,0.803190126491245,-2,0
40,1,10,19,9,10,1,0.541421976056881,-1,0
40,1,10,9,12,-3,1,0.802732299518539,2,0
40,1,2,10,18,-8,1,0.789412797515979,8,0
40,1,10,8,18,-10,1,0.688313682941953,8,0
40,1,10,19,2,17,0,0.935030726453988,8,0
40,1,2,3,10,-7,0,0.87580866573262,0,0
40,1,2,15,3,12,1,0.923725076543633,-7,0
40,1,2,1,17,-16,0,0.62533040335984,-7,0
40,1,2,16,1,15,0,0.866679251717869,9,0
40,1,10,0,18,-18,0,0.562126091186656,-8,0
40,1,2,14,6,8,0,0.757489539450034,4,0
40,1,10,20,10,10,1,0.601589015073841,0,0
40,1,2,0,12,-12,0,0.691712745669065,-2,0
40,1,2,1,12,-11,0,0.546423982945271,-2,0
40,1,2,20,2,18,0,1.31112805407611,8,0
40,1,10,9,12,-3,1,1.37388516936335,2,0
40,1,10,13,6,7,1,1.3692849065701,-4,0
40,1,10,1,11,-10,0,0.581284078129102,-1,0
40,1,10,1,19,-18,0,1.24002118688077,-9,0
40,1,2,9,15,-6,1,0.840870860905852,5,0
40,1,10,19,8,11,1,1.26685373182409,-2,0
40,1,2,20,7,13,1,0.930330394156044,-3,0
40,1,10,3,18,-15,0,0.750942137499806,-8,0
40,1,2,1,17,-16,0,0.731025748624234,-7,0
40,1,10,2,19,-17,0,1.25641168505535,-9,0
40,1,10,8,17,-9,1,1.368681557331,7,0
40,1,10,10,14,-4,1,2.10076811557519,4,0
40,1,2,14,4,10,0,1.13074716698611,6,0
40,1,2,16,3,13,0,1.71140846851631,7,0
40,1,2,16,2,14,NaN,NaN,0,0
40,1,10,6,15,-9,0,0.993104004417546,-5,0
40,1,2,14,0,14,0,1.13189228420379,10,0
40,1,10,10,20,-10,1,1.05666717374697,10,0
40,1,2,19,3,16,1,1.32147772904136,-7,0
40,1,2,6,16,-10,0,1.19882335906732,-6,0
40,1,10,7,18,-11,0,2.46487470241846,-8,0
40,1,2,1,11,-10,0,1.07304997424944,-1,0
40,1,10,10,7,3,0,1.30440727173118,3,0
40,1,2,10,1,9,0,0.814439326932188,9,0
40,1,10,20,3,17,1,1.09582768991822,-7,0
40,1,2,20,0,20,0,0.997234343987657,10,0
40,1,10,1,17,-16,0,0.663275057217106,-7,0
40,1,10,0,19,-19,0,0.726683906948892,-9,0
40,1,2,10,16,-6,NaN,NaN,0,0
40,1,10,3,16,-13,0,0.70503188110888,-6,0
40,1,2,17,0,17,NaN,NaN,0,0
40,1,2,11,2,9,0,0.843240637710551,8,0
40,1,10,3,12,-9,0,0.748021795356181,-2,0
40,1,2,14,6,8,0,0.632023327547358,4,0
40,1,10,1,14,-13,0,0.536961004079785,-4,0
40,1,2,10,14,-4,0,0.836864050332224,-4,0
40,1,10,9,18,-9,0,0.581631205568556,-8,0
40,1,10,7,20,-13,1,1.11231862410204,10,0
40,1,10,10,1,9,0,0.813603215414332,9,0
40,1,2,10,20,-10,1,0.735184312914498,10,0
40,1,2,0,13,-13,0,0.595975961332442,-3,0
40,1,10,20,0,20,0,0.654559117043391,10,0
40,1,2,6,10,-4,0,0.99805872575962,0,0
40,1,2,17,3,14,0,0.704081037954893,7,0
40,1,10,16,5,11,1,1.18220926247886,-5,0
