subj,exp,tp,self,other,fair,resp,rt,given,gen
1,1,10,75,0,75,1,2.5011031507338,-50,0
1,1,10,0,68,-68,1,5.62095015019622,18,0
1,1,10,25,55,-30,0,3.6081797004872,-5,0
1,1,10,53,0,53,0,4.58017371095957,50,0
1,1,10,30,100,-70,0,4.20946631257357,-50,0
1,1,10,53,23,30,1,3.13345832897994,-27,0
1,1,10,100,0,100,0,3.53210170466991,50,0
1,1,10,48,100,-52,1,4.05934104200878,50,0
1,1,10,48,80,-32,1,3.38926686937248,30,0
1,1,10,80,45,35,1,4.17789189892574,-5,0
1,1,10,28,85,-57,0,3.84715524935928,-35,0
1,1,10,3,100,-97,0,2.95385058071679,-50,0
1,1,10,48,60,-12,0,3.11182051944616,-10,0
1,1,10,30,100,-70,0,2.79975074181857,-50,0
1,1,10,53,23,30,1,3.55568959292123,-27,0
1,1,10,85,15,70,1,4.06564983990665,-35,0
1,1,10,53,0,53,0,3.15498507200027,50,0
1,1,10,48,100,-52,0,3.82485433974944,-50,0
1,1,10,100,15,85,0,3.70816302218191,35,0
1,1,10,53,40,13,1,3.42815041265112,-10,0
1,1,1.5,48,60,-12,1,0.456081258167615,10,0
1,1,1.5,100,15,85,1,0.602038052194075,-35,0
1,1,1.5,85,15,70,0,0.565990920404147,35,0
1,1,1.5,50,100,-50,1,0.683321878453171,50,0
1,1,1.5,48,80,-32,1,0.827978131260352,30,0
1,1,1.5,50,43,7,0,1.02333276517129,7,0
1,1,1.5,0,68,-68,0,0.698612768250314,-18,0
1,1,1.5,3,100,-97,0,0.77124843526326,-50,0
1,1,1.5,50,43,7,1,0.46452304630111,-7,0
1,1,1.5,5,83,-78,0,0.586552154525634,-33,0
1,1,1.5,100,0,100,1,0.77523839895639,-50,0
1,1,1.5,80,45,35,0,0.66849138318139,5,0
1,1,1.5,28,85,-57,0,1.06178780431037,-35,0
1,1,1.5,75,0,75,0,1.29574996471911,50,0
1,1,1.5,5,83,-78,0,1.16038004541679,-33,0
1,1,1.5,50,100,-50,0,1.25435257936442,-50,0
1,1,1.5,98,38,60,1,1.33626101730351,-12,0
1,1,1.5,53,40,13,1,1.2230215590007,-10,0
1,1,1.5,98,38,60,1,0.858285360297486,-12,0
1,1,1.5,25,55,-30,0,0.90021388551304,-5,0
1,1,10,75,0,75,0,1.76949336441703,50,0
1,1,10,75,31,44,0,4.83727472833561,19,0
1,1,10,5,66,-61,0,5.28781695652106,-16,0
1,1,10,74,35,39,1,5.53642743379532,-15,0
1,1,10,0,68,-68,0,5.591131173951,-18,0
1,1,10,20,84,-64,0,5.18767198356363,-34,0
1,1,10,15,86,-71,0,6.51222849644091,-36,0
1,1,10,20,64,-44,0,4.52820704557598,-14,0
1,1,10,70,23,47,1,4.7034802673661,-27,0
1,1,10,85,15,70,0,5.12742224885824,35,0
1,1,10,80,45,35,0,4.96537254017949,5,0
1,1,10,73,22,51,1,4.3072491977,-28,0
1,1,10,48,80,-32,1,4.66727001808977,30,0
1,1,10,58,19,39,1,4.27655525192495,-31,0
1,1,10,86,33,53,1,4.66980841942859,-17,0
1,1,10,12,92,-80,1,3.35916381211064,42,0
1,1,10,8,65,-57,0,3.88512533471112,-15,0
1,1,10,0,68,-68,0,4.22168142971532,-18,0
1,1,10,70,41,29,1,4.4889855375277,-9,0
1,1,10,0,98,-98,0,3.6896299432392,-48,0
1,1,1.5,79,43,36,1,0.576210139310206,-7,0
1,1,1.5,80,45,35,0,0.405481114110444,5,0
1,1,1.5,100,0,100,0,0.497509067682586,50,0
1,1,1.5,48,80,-32,0,0.522167666448695,-30,0
1,1,1.5,59,46,13,1,0.481376564965103,-4,0
1,1,1.5,6,57,-51,0,0.778808655856665,-7,0
1,1,1.5,85,12,73,0,0.56808139012719,38,0
1,1,1.5,18,63,-45,0,0.653420793631085,-13,0
1,1,1.5,0,68,-68,0,0.631383437893419,-18,0
1,1,1.5,7,75,-68,1,0.594728556006885,25,0
1,1,1.5,80,45,35,0,0.445992899807607,5,0
1,1,1.5,58,15,43,1,0.520710972308734,-35,0
1,1,1.5,33,63,-30,1,0.775973710593462,13,0
1,1,1.5,30,66,-36,0,0.653315225459664,-16,0
1,1,1.5,6,71,-65,0,0.615243970609299,-21,0
1,1,1.5,81,27,54,1,0.538584616737353,-23,0
1,1,1.5,38,57,-19,1,0.521240279389531,7,0
1,1,1.5,75,31,44,1,0.376540406400636,-19,0
1,1,1.5,48,100,-52,1,0.461866613882194,50,0
1,1,1.5,1,74,-73,0,0.375877306325492,-24,0
1,1,10,4,82,-78,0,0.945814570240145,-32,0
1,1,10,72,44,28,1,2.82286687230408,-6,0
1,1,10,75,0,75,0,3.77822069979175,50,0
1,1,10,86,25,61,1,2.52692703149933,-25,0
1,1,10,37,57,-20,1,2.8781505042889,7,0
1,1,10,39,68,-29,0,4.33546595701409,-18,0
1,1,10,15,83,-68,1,3.15804434962774,33,0
1,1,10,38,57,-19,1,2.36334988334329,7,0
1,1,10,0,68,-68,0,4.44129914830683,-18,0
1,1,10,92,1,91,0,4.30727082451358,49,0
1,1,10,2,88,-86,0,3.98654079128482,-38,0
1,1,10,20,52,-32,0,4.47911381385165,-2,0
1,1,10,87,2,85,0,3.57642200876398,48,0
1,1,10,19,59,-40,1,3.44507797565711,9,0
1,1,10,26,90,-64,1,3.98363839968897,40,0
1,1,10,85,12,73,1,2.81168434383744,-38,0
1,1,10,93,9,84,0,3.15954832951138,41,0
1,1,10,33,63,-30,1,3.09284390756147,13,0
1,1,10,8,76,-68,0,3.20550054158684,-26,0
1,1,10,75,0,75,0,4.18476702607495,50,0
1,1,1.5,93,23,70,1,0.506735285978721,-27,0
1,1,1.5,56,10,46,1,0.418719289467845,-40,0
1,1,1.5,44,59,-15,1,0.74935770198681,9,0
1,1,1.5,80,45,35,1,0.746725828828858,-5,0
1,1,1.5,54,12,42,1,0.673391872350294,-38,0
1,1,1.5,85,15,70,1,0.697992921800505,-35,0
1,1,1.5,28,97,-69,0,0.945930401983787,-47,0
1,1,1.5,1,99,-98,0,0.679925369167904,-49,0
1,1,1.5,48,80,-32,1,0.777186644892936,30,0
1,1,1.5,74,13,61,0,0.333895997023319,37,0
1,1,1.5,15,83,-68,1,0.563247614178181,33,0
1,1,1.5,3,85,-82,1,0.584572751316045,35,0
1,1,1.5,53,0,53,0,0.796497189430738,50,0
1,1,1.5,99,50,49,1,0.808488340765507,0,0
1,1,1.5,74,13,61,1,1.05973545642701,-37,0
1,1,1.5,89,31,58,1,0.733088107269396,-19,0
1,1,1.5,89,28,61,1,0.667097003587514,-22,0
1,1,1.5,27,77,-50,1,0.611690575292414,27,0
1,1,1.5,63,35,28,1,0.87102831829543,-15,0
1,1,1.5,80,21,59,1,0.511676096323754,-29,0
1,1,10,48,100,-52,1,4.88351138798316,50,0
1,1,10,11,59,-48,0,2.78735161348868,-9,0
1,1,10,38,57,-19,1,2.23140066603264,7,0
1,1,10,16,68,-52,0,3.41806681952039,-18,0
1,1,10,29,62,-33,1,2.66871388276468,12,0
1,1,10,10,54,-44,0,2.94929282154771,-4,0
1,1,10,55,8,47,1,3.05859913236236,-42,0
1,1,10,50,100,-50,1,2.25992899807352,50,0
1,1,10,26,86,-60,1,2.16522408493984,36,0
1,1,10,51,49,2,1,2.72249646731507,-1,0
1,1,10,87,2,85,1,2.28849948407333,-48,0
1,1,10,49,66,-17,1,2.20837837391991,16,0
1,1,10,97,30,67,1,3.32375595424674,-20,0
1,1,10,47,83,-36,1,3.56233122380399,33,0
1,1,10,70,17,53,0,3.56759863567822,33,0
1,1,10,48,100,-52,1,3.81228916148575,50,0
1,1,10,84,23,61,1,4.63945720365336,-27,0
1,1,10,26,86,-60,1,3.99351855415625,36,0
1,1,10,53,48,5,1,4.02942016315501,-2,0
1,1,10,20,92,-72,0,3.76805683086423,-42,0
1,1,1.5,93,29,64,1,0.52276918509051,-21,0
1,1,1.5,7,74,-67,1,0.473292169077467,24,0
1,1,1.5,0,68,-68,0,0.521979623143125,-18,0
1,1,1.5,5,61,-56,1,0.544615931630688,11,0
1,1,1.5,93,9,84,1,0.614620092042969,-41,0
1,1,1.5,65,28,37,1,0.585855697840088,-22,0
1,1,1.5,15,83,-68,0,0.781788390799193,-33,0
1,1,1.5,56,49,7,1,0.473870228126543,-1,0
1,1,1.5,89,14,75,1,0.498522961992421,-36,0
1,1,1.5,2,62,-60,0,0.962492508508149,-12,0
1,1,1.5,72,10,62,0,1.03117376777664,40,0
1,1,1.5,85,15,70,1,0.625771096682001,-35,0
1,1,1.5,60,49,11,1,0.892400374621502,-1,0
1,1,1.5,8,76,-68,NaN,NaN,0,0
1,1,1.5,16,98,-82,1,0.699725999276779,48,0
1,1,1.5,80,19,61,1,0.459004543463379,-31,0
1,1,1.5,48,60,-12,1,0.348330245096804,10,0
1,1,1.5,50,32,18,1,0.706299084158672,-18,0
1,1,1.5,59,36,23,1,0.305623887732509,-14,0
1,1,1.5,44,59,-15,1,0.360907886271889,9,0
1,1,10,12,92,-80,0,1.22822812255436,-42,0
1,1,10,40,71,-31,0,1.42937800919572,-21,0
1,1,10,73,36,37,1,2.74265302344793,-14,0
1,1,10,7,75,-68,0,4.18059268463912,-25,0
1,1,10,53,38,15,1,3.97716465152371,-12,0
1,1,10,28,57,-29,1,3.79775154457639,7,0
1,1,10,90,28,62,1,4.31373247632473,-22,0
1,1,10,80,47,33,1,3.6570779243375,-3,0
1,1,10,74,13,61,1,4.85031239747877,-37,0
1,1,10,75,36,39,1,3.80361387708399,-14,0
1,1,10,64,48,16,1,4.12626246520085,-2,0
1,1,10,90,22,68,1,5.1727667108371,-28,0
1,1,10,83,48,35,1,4.39338366149423,-2,0
1,1,10,48,60,-12,1,4.75738014988565,10,0
1,1,10,47,83,-36,1,4.61064479059678,33,0
1,1,10,87,42,45,1,5.38996479228081,-8,0
1,1,10,33,63,-30,1,5.02584257513081,13,0
1,1,10,68,37,31,1,4.71649117790912,-13,0
1,1,10,88,4,84,1,4.65108326506197,-46,0
1,1,10,81,15,66,1,5.36429743099143,-35,0
1,1,1.5,33,58,-25,1,0.343474475777839,8,0
1,1,1.5,62,50,12,0,0.381671825944068,0,0
1,1,1.5,84,45,39,1,0.426353554403249,-5,0
1,1,1.5,73,50,23,1,0.316965135012651,0,0
1,1,1.5,100,15,85,1,0.307631149209556,-35,0
1,1,1.5,38,57,-19,1,0.386976626547039,7,0
1,1,1.5,22,53,-31,1,0.678859790439674,3,0
1,1,1.5,75,17,58,0,0.471566789279677,33,0
1,1,1.5,46,96,-50,1,0.360229390838867,46,0
1,1,1.5,29,62,-33,1,0.429522432319573,12,0
1,1,1.5,83,13,70,1,0.51879828231904,-37,0
1,1,1.5,37,88,-51,1,0.397458666211605,38,0
1,1,1.5,85,15,70,1,0.280795206910625,-35,0
1,1,1.5,87,47,40,1,0.329389555716261,-3,0
1,1,1.5,100,15,85,1,0.431385270674582,-35,0
1,1,1.5,50,2,48,1,0.346064561535968,-48,0
1,1,1.5,71,19,52,1,0.359375681566235,-31,0
1,1,1.5,22,53,-31,1,0.356711551467015,3,0
1,1,1.5,69,47,22,1,0.329983010122305,-3,0
1,1,1.5,75,2,73,1,0.296664522313222,-48,0
2,1,10,5,83,-78,1,2.78228087056141,33,0
2,1,10,53,23,30,0,2.9466109507448,27,0
2,1,10,48,80,-32,1,2.50459234822483,30,0
2,1,10,50,43,7,0,2.61652380297801,7,0
2,1,10,53,40,13,0,1.56391294387231,10,0
2,1,10,53,0,53,0,4.42443326460489,50,0
2,1,10,30,100,-70,0,4.00366405498244,-50,0
2,1,10,48,60,-12,1,5.3915209163797,10,0
2,1,10,100,15,85,0,3.27623037800731,35,0
2,1,10,48,100,-52,1,4.88536522336744,50,0
2,1,10,50,100,-50,1,6.50993741122511,50,0
2,1,10,50,100,-50,1,2.89395793814401,50,0
2,1,10,25,55,-30,1,3.23865182130612,5,0
2,1,10,85,15,70,0,2.69725507445582,35,0
2,1,10,53,23,30,0,2.88989507445604,27,0
2,1,10,100,15,85,0,3.1704547995414,35,0
2,1,10,28,85,-57,1,3.63975770904926,35,0
2,1,10,48,60,-12,1,3.5783583963339,10,0
2,1,10,98,38,60,0,5.16766020618525,12,0
2,1,10,5,83,-78,1,3.23687880870511,33,0
2,1,1.5,48,80,-32,1,0.890989965635526,30,0
2,1,1.5,3,100,-97,1,0.675413699885212,50,0
2,1,1.5,75,0,75,0,0.700786071019138,50,0
2,1,1.5,100,0,100,0,0.804809530355669,50,0
2,1,1.5,80,45,35,0,0.664778923252925,5,0
2,1,1.5,100,0,100,0,0.746035830469737,50,0
2,1,1.5,48,100,-52,0,0.71270744559024,-50,0
2,1,1.5,30,100,-70,0,0.928676288659517,-50,0
2,1,1.5,28,85,-57,1,0.895991202749428,35,0
2,1,1.5,50,43,7,0,0.808590148912117,7,0
2,1,1.5,0,68,-68,1,0.836560274914518,18,0
2,1,1.5,53,40,13,1,0.583249301260366,-10,0
2,1,1.5,3,100,-97,1,0.843790515464207,50,0
2,1,1.5,53,0,53,0,0.582518029782477,50,0
2,1,1.5,25,55,-30,1,0.795116059564862,5,0
2,1,1.5,0,68,-68,1,0.719822222222319,18,0
2,1,1.5,75,0,75,1,0.79104953035494,-50,0
2,1,1.5,85,15,70,1,0.595679083619871,-35,0
2,1,1.5,98,38,60,0,0.856246323024607,12,0
2,1,1.5,80,45,35,0,0.650272989690166,5,0
2,1,10,40,90,-50,1,2.44452361970252,40,0
2,1,10,66,18,48,0,2.91907702176468,32,0
2,1,10,38,65,-27,1,1.47038497136327,15,0
2,1,10,47,100,-53,1,3.19020132875085,50,0
2,1,10,58,45,13,0,2.45085947308144,5,0
2,1,10,53,34,19,0,2.59676517754815,16,0
2,1,10,48,88,-40,1,2.28941745704469,38,0
2,1,10,43,85,-42,1,2.34612746849962,35,0
2,1,10,83,43,40,0,3.78321741122545,7,0
2,1,10,55,11,44,0,3.10779821305823,39,0
2,1,10,62,45,17,0,3.14645809851118,5,0
2,1,10,81,7,74,0,4.54501021764008,43,0
2,1,10,93,39,54,0,4.94351908361932,11,0
2,1,10,23,87,-64,1,4.36622332187835,37,0
2,1,10,53,10,43,0,3.69955958762876,40,0
2,1,10,32,60,-28,1,3.49138217640302,10,0
2,1,10,0,65,-65,1,3.81203097365415,15,0
2,1,10,61,32,29,0,3.12001319587671,18,0
2,1,10,4,73,-69,1,3.92726506300096,23,0
2,1,10,47,100,-53,0,5.2144975028632,-50,0
2,1,1.5,84,48,36,1,0.630595738832199,-2,0
2,1,1.5,88,49,39,0,0.761800870561274,1,0
2,1,1.5,80,21,59,0,0.59980169530354,29,0
2,1,1.5,33,78,-45,1,0.723806643756689,28,0
2,1,1.5,47,100,-53,1,1.06708710194744,50,0
2,1,1.5,48,56,-8,0,0.764448476516918,-6,0
2,1,1.5,35,92,-57,1,0.538373791523554,42,0
2,1,1.5,11,94,-83,1,0.705039541810038,44,0
2,1,1.5,96,9,87,0,0.74498052691888,41,0
2,1,1.5,35,94,-59,0,0.759637846505939,-44,0
2,1,1.5,92,32,60,0,0.79628865979339,18,0
2,1,1.5,45,56,-11,0,0.93696843069938,-6,0
2,1,1.5,7,86,-79,1,0.671558671248931,36,0
2,1,1.5,53,40,13,0,0.68091931271465,10,0
2,1,1.5,47,81,-34,1,0.746120870561754,31,0
2,1,1.5,3,81,-78,1,0.848789186712565,31,0
2,1,1.5,49,99,-50,0,1.03480485681575,-49,0
2,1,1.5,21,85,-64,1,0.717405177549153,35,0
2,1,1.5,32,87,-55,1,0.732740985108649,37,0
2,1,1.5,10,56,-46,1,0.931350652920628,6,0
2,1,10,73,11,62,0,1.61686506300157,39,0
2,1,10,3,98,-95,1,4.05059702176368,48,0
2,1,10,76,10,66,0,4.46854781214279,40,0
2,1,10,0,63,-63,1,2.89375193585329,13,0
2,1,10,69,40,29,0,2.6704656128295,10,0
2,1,10,49,98,-49,1,2.31979766323093,48,0
2,1,10,16,97,-81,1,2.75044508591054,47,0
2,1,10,59,4,55,1,3.88426116838491,-46,0
2,1,10,56,28,28,0,5.11617649484469,22,0
2,1,10,16,85,-69,1,3.66749287514358,35,0
2,1,10,26,53,-27,1,4.46742396334412,3,0
2,1,10,91,23,68,0,2.85273878579574,27,0
2,1,10,100,29,71,0,4.01403601374477,21,0
2,1,10,49,98,-49,1,5.08992476517778,48,0
2,1,10,49,90,-41,1,3.49793502863758,40,0
2,1,10,90,28,62,1,5.05780930125911,-22,0
2,1,10,66,18,48,1,5.4350258877439,-32,0
2,1,10,40,52,-12,1,2.93372114547674,2,0
2,1,10,11,91,-80,1,2.92362226804107,41,0
2,1,10,92,33,59,0,5.89088989690754,17,0
2,1,1.5,44,61,-17,1,0.724944054982188,11,0
2,1,1.5,78,23,55,1,0.323567285224271,-27,0
2,1,1.5,24,77,-53,1,0.282175486827327,27,0
2,1,1.5,49,98,-49,1,0.266100343642393,48,0
2,1,1.5,46,66,-20,1,0.274811454753944,16,0
2,1,1.5,97,18,79,1,0.275456586483415,-32,0
2,1,1.5,14,98,-84,1,0.756744650629116,48,0
2,1,1.5,11,90,-79,1,0.714079816723824,40,0
2,1,1.5,46,82,-36,1,0.769423321879003,32,0
2,1,1.5,28,76,-48,0,0.733974432989271,-26,0
2,1,1.5,82,41,41,0,0.475299702176926,9,0
2,1,1.5,31,75,-44,1,0.707920274913704,25,0
2,1,1.5,49,98,-49,1,0.715247285223086,48,0
2,1,1.5,26,53,-27,1,0.60191706758269,3,0
2,1,1.5,28,75,-47,1,0.5492248339051,25,0
2,1,1.5,98,4,94,0,0.586535074455242,46,0
2,1,1.5,43,99,-56,1,0.758379839633562,49,0
2,1,1.5,69,38,31,1,0.307771088200752,-12,0
2,1,1.5,21,65,-44,1,0.539151615119408,15,0
2,1,1.5,26,77,-51,1,0.504998487971534,27,0
2,1,10,6,81,-75,1,0.87385658648418,31,0
2,1,10,89,34,55,0,2.80087276059567,16,0
2,1,10,7,95,-88,1,4.68421681557811,45,0
2,1,10,32,79,-47,1,2.52421534937093,29,0
2,1,10,26,86,-60,1,4.32273704467298,36,0
2,1,10,49,98,-49,1,7.32118469644956,48,0
2,1,10,16,94,-78,1,1.68003702176247,44,0
2,1,10,6,98,-92,1,2.78459821305842,48,0
2,1,10,86,6,80,0,3.5325969301266,44,0
2,1,10,32,70,-38,1,3.38647935853442,20,0
2,1,10,53,23,30,0,3.01370098510961,27,0
2,1,10,54,38,16,0,3.94500032073302,12,0
2,1,10,86,8,78,0,1.92702570446636,42,0
2,1,10,44,60,-16,1,3.18078203894584,10,0
2,1,10,54,33,21,0,3.04150542955358,17,0
2,1,10,75,22,53,0,2.73138400916287,28,0
2,1,10,49,98,-49,1,2.83337640320678,48,0
2,1,10,26,88,-62,1,3.58727514318525,38,0
2,1,10,10,96,-86,1,4.49526359679294,46,0
2,1,10,15,97,-82,1,2.87915143184364,47,0
2,1,1.5,6,54,-48,1,0.371190836196547,4,0
2,1,1.5,70,31,39,1,0.295880137457061,-19,0
2,1,1.5,28,93,-65,1,0.295821855670511,43,0
2,1,1.5,49,98,-49,1,0.583796197021002,48,0
2,1,1.5,50,50,0,0,0.515706575028162,0,0
2,1,1.5,49,85,-36,1,0.618342634594228,35,0
2,1,1.5,25,60,-35,1,1.03703642611799,10,0
2,1,1.5,92,34,58,0,0.599041832760122,16,0
2,1,1.5,24,86,-62,1,0.602350332188507,36,0
2,1,1.5,15,91,-76,1,0.573593951890871,41,0
2,1,1.5,40,80,-40,1,0.648949003436428,30,0
2,1,1.5,23,76,-53,1,0.578190515463575,26,0
2,1,1.5,4,97,-93,1,0.718839495990323,47,0
2,1,1.5,19,88,-69,1,0.541524673539243,38,0
2,1,1.5,22,58,-36,1,0.627468682703693,8,0
2,1,1.5,49,53,-4,1,0.886143780069688,3,0
2,1,1.5,17,90,-73,1,0.534114455898816,40,0
2,1,1.5,16,81,-65,1,0.604136174111773,31,0
2,1,1.5,89,37,52,0,0.887347903781119,13,0
2,1,1.5,27,98,-71,1,0.65534863688481,48,0
2,1,10,49,98,-49,1,2.50476792668996,48,0
2,1,10,85,15,70,0,4.66396517754947,35,0
2,1,10,5,79,-74,1,3.32923528064202,29,0
2,1,10,50,72,-22,1,2.15188600229158,22,0
2,1,10,21,85,-64,1,2.6356504925534,35,0
2,1,10,91,9,82,0,2.97363977090572,41,0
2,1,10,35,86,-51,1,2.33835473081308,36,0
2,1,10,3,85,-82,1,1.92831156930151,35,0
2,1,10,75,50,25,0,2.64549315005752,0,0
2,1,10,30,82,-52,1,2.67946446735368,32,0
2,1,10,13,94,-81,1,4.11070460481096,44,0
2,1,10,61,8,53,0,2.74198286368846,42,0
2,1,10,96,33,63,0,3.02794153493596,17,0
2,1,10,14,70,-56,1,3.97451876288687,20,0
2,1,10,0,86,-86,1,3.06716407789281,36,0
2,1,10,32,70,-38,1,3.4197347995414,20,0
2,1,10,62,15,47,0,2.9424010996554,35,0
2,1,10,51,1,50,0,3.46831138602647,49,0
2,1,10,21,81,-60,1,3.32494625429536,31,0
2,1,10,53,43,10,0,3.20349250858999,7,0
2,1,1.5,7,65,-58,1,0.530180618558006,15,0
2,1,1.5,10,93,-83,1,0.536868361970846,43,0
2,1,1.5,7,96,-89,1,0.478820801832626,46,0
2,1,1.5,58,9,49,0,0.495494524628157,41,0
2,1,1.5,46,71,-25,1,0.919413150057153,21,0
2,1,1.5,49,98,-49,1,0.734090263458711,48,0
2,1,1.5,52,43,9,1,0.764021809851329,-7,0
2,1,1.5,26,82,-56,1,0.545323619700866,32,0
2,1,1.5,84,10,74,0,0.663324077893776,40,0
2,1,1.5,86,35,51,0,0.832663825887721,15,0
2,1,1.5,33,95,-62,1,0.72189507445546,45,0
2,1,1.5,4,67,-63,1,0.447885269186372,17,0
2,1,1.5,33,63,-30,1,0.585844123712377,13,0
2,1,1.5,0,98,-98,1,0.541174982816301,48,0
2,1,1.5,55,11,44,0,0.699121191293671,39,0
2,1,1.5,37,99,-62,1,0.530477525773676,49,0
2,1,1.5,49,98,-49,1,0.649111019474731,48,0
2,1,1.5,92,38,54,0,0.554461030927996,12,0
2,1,1.5,19,93,-74,1,0.423027170676505,43,0
2,1,1.5,50,57,-7,1,0.353740022908823,7,0
3,1,10,25,55,-30,0,3.08771749760672,-5,0
3,1,10,30,100,-70,0,3.19230585951482,-50,0
3,1,10,48,80,-32,1,2.46107623101398,30,0
3,1,10,48,60,-12,1,1.75124373367908,10,0
3,1,10,53,40,13,1,1.71737370952997,-10,0
3,1,10,53,40,13,1,2.87493383615492,-10,0
3,1,10,50,43,7,1,3.36434542146253,-7,0
3,1,10,85,15,70,0,1.89845627467821,35,0
3,1,10,50,100,-50,0,1.39448937639554,-50,0
3,1,10,53,0,53,0,5.83003186128281,50,0
3,1,10,48,80,-32,0,5.0174965800079,-30,0
3,1,10,50,43,7,1,3.64504178036077,-7,0
3,1,10,53,23,30,0,3.99978409692449,27,0
3,1,10,100,15,85,0,4.30793680234729,35,0
3,1,10,98,38,60,0,6.44399716136923,12,0
3,1,10,3,100,-97,0,3.80684738988202,-50,0
3,1,10,100,0,100,0,3.04292952249125,50,0
3,1,10,80,45,35,1,1.84571800785579,-5,0
3,1,10,53,0,53,0,4.35241723471063,50,0
3,1,10,100,0,100,0,2.87855140399279,50,0
3,1,1.5,50,100,-50,0,1.20299141226224,-50,0
3,1,1.5,80,45,35,1,0.98297078233918,-5,0
3,1,1.5,0,68,-68,0,0.92366341700199,-18,0
3,1,1.5,75,0,75,0,0.955051838732288,50,0
3,1,1.5,0,68,-68,0,0.641091010660602,-18,0
3,1,1.5,28,85,-57,1,0.80387166633227,35,0
3,1,1.5,85,15,70,1,1.11994900435366,-35,0
3,1,1.5,98,38,60,0,1.23923710336476,12,0
3,1,1.5,53,23,30,1,0.714061485090497,-27,0
3,1,1.5,48,60,-12,1,0.857994425375182,10,0
3,1,1.5,3,100,-97,0,0.716092586863851,-50,0
3,1,1.5,25,55,-30,1,0.851471879816017,5,0
3,1,1.5,5,83,-78,0,0.773600515527505,-33,0
3,1,1.5,48,100,-52,1,0.738986010654116,50,0
3,1,1.5,5,83,-78,0,0.825592102272822,-33,0
3,1,1.5,100,15,85,0,1.24495651880625,35,0
3,1,1.5,30,100,-70,1,0.639688557063891,50,0
3,1,1.5,75,0,75,0,0.70644256245123,50,0
3,1,1.5,28,85,-57,1,1.13052202357994,35,0
3,1,1.5,48,100,-52,0,1.08985820043108,-50,0
3,1,10,11,66,-55,0,1.30105576237656,-16,0
3,1,10,44,54,-10,1,4.1559710946467,4,0
3,1,10,97,21,76,1,3.40210463344829,-29,0
3,1,10,60,43,17,1,2.41425018951122,-7,0
3,1,10,66,13,53,0,3.01831437247347,37,0
3,1,10,100,26,74,0,3.1336949557126,24,0
3,1,10,23,65,-42,1,2.82042692359028,15,0
3,1,10,17,75,-58,0,2.43183877575302,-25,0
3,1,10,60,46,14,1,1.64328523105723,-4,0
3,1,10,93,17,76,0,1.268867509556,33,0
3,1,10,75,27,48,1,1.42890410677774,-23,0
3,1,10,72,12,60,1,1.87914376285698,-38,0
3,1,10,97,7,90,0,1.40061347264509,43,0
3,1,10,48,54,-6,0,3.01149308157073,-4,0
3,1,10,48,60,-12,1,3.76751490794231,10,0
3,1,10,100,39,61,0,2.98107457416882,11,0
3,1,10,8,94,-86,0,2.29032548946543,-44,0
3,1,10,67,4,63,0,2.09112099516278,46,0
3,1,10,86,43,43,1,2.07590514340518,-7,0
3,1,10,98,17,81,0,2.31730311032425,33,0
3,1,1.5,64,35,29,0,1.02758097648348,15,0
3,1,1.5,25,55,-30,1,0.606835000197862,5,0
3,1,1.5,11,93,-82,0,0.842894406167034,-43,0
3,1,1.5,25,96,-71,0,1.39767110593675,-46,0
3,1,1.5,87,5,82,0,0.914322035016085,45,0
3,1,1.5,98,38,60,1,0.786437034745177,-12,0
3,1,1.5,57,40,17,1,1.03916826364093,-10,0
3,1,1.5,83,13,70,0,0.841802427791663,37,0
3,1,1.5,48,98,-50,1,0.788665711658723,48,0
3,1,1.5,93,9,84,0,0.633289908345432,41,0
3,1,1.5,93,13,80,0,0.659394752932712,37,0
3,1,1.5,70,30,40,1,0.661411192357264,-20,0
3,1,1.5,81,17,64,0,0.591438068440766,33,0
3,1,1.5,8,98,-90,0,1.14816082836296,-48,0
3,1,1.5,47,71,-24,0,1.03486266511572,-21,0
3,1,1.5,72,32,40,1,1.00563547349884,-18,0
3,1,1.5,33,90,-57,0,0.913599547811828,-40,0
3,1,1.5,98,17,81,0,0.753746963060621,33,0
3,1,1.5,81,29,52,1,0.959735359278056,-21,0
3,1,1.5,95,12,83,0,0.621830550175218,38,0
3,1,10,74,3,71,0,1.8783853529003,47,0
3,1,10,87,0,87,0,4.52771440385186,50,0
3,1,10,99,12,87,0,2.97518874107664,38,0
3,1,10,98,4,94,0,2.50857087559234,46,0
3,1,10,13,50,-37,0,3.77267348856731,0,0
3,1,10,65,41,24,1,3.1861139499033,-9,0
3,1,10,86,37,49,0,3.25488109568687,13,0
3,1,10,19,99,-80,0,2.70495873282016,-49,0
3,1,10,52,38,14,1,2.27308000216908,-12,0
3,1,10,53,23,30,1,2.99379636051162,-27,0
3,1,10,21,53,-32,0,3.51726418178987,-3,0
3,1,10,95,2,93,0,2.25203623359448,48,0
3,1,10,89,14,75,0,3.07809166606785,36,0
3,1,10,66,41,25,1,1.71089185198616,-9,0
3,1,10,94,11,83,0,1.99097679096849,39,0
3,1,10,34,64,-30,0,2.56300447641479,-14,0
3,1,10,4,81,-77,0,2.14500512449013,-31,0
3,1,10,80,6,74,0,2.26314332885158,44,0
3,1,10,17,99,-82,0,2.75326383869105,-49,0
3,1,10,93,13,80,0,2.44667780516465,37,0
3,1,1.5,12,60,-48,0,1.03222600836671,-10,0
3,1,1.5,87,5,82,0,1.01092821461134,45,0
3,1,1.5,74,2,72,NaN,NaN,0,0
3,1,1.5,36,97,-61,0,0.862463875640969,-47,0
3,1,1.5,9,97,-88,0,0.767803023081797,-47,0
3,1,1.5,100,11,89,1,0.965188286543707,-39,0
3,1,1.5,55,35,20,1,0.9938689391347,-15,0
3,1,1.5,71,16,55,0,0.790618369868753,34,0
3,1,1.5,67,33,34,1,1.00265645092077,-17,0
3,1,1.5,100,20,80,1,1.02209469237823,-30,0
3,1,1.5,44,54,-10,1,0.73609569528162,4,0
3,1,1.5,86,37,49,1,0.774130925970894,-13,0
3,1,1.5,68,44,24,1,0.674899819507118,-6,0
3,1,1.5,68,41,27,1,0.636275162423772,-9,0
3,1,1.5,100,12,88,0,0.774361124837014,38,0
3,1,1.5,66,50,16,1,0.587061724087107,0,0
3,1,1.5,41,53,-12,1,0.67902470459012,3,0
3,1,1.5,73,17,56,0,0.85572799291549,33,0
3,1,1.5,35,84,-49,1,0.569132604810875,34,0
3,1,1.5,34,74,-40,1,0.57388613807052,24,0
3,1,10,45,52,-7,1,1.38759184128321,2,0
3,1,10,98,12,86,0,3.31032383262027,38,0
3,1,10,95,8,87,0,2.64583611306989,42,0
3,1,10,28,61,-33,1,1.4479475645112,11,0
3,1,10,48,54,-6,0,1.88886599933539,-4,0
3,1,10,50,7,43,0,1.16089984296741,43,0
3,1,10,99,26,73,0,1.541158310838,24,0
3,1,10,5,70,-65,0,4.01796210956127,-20,0
3,1,10,97,9,88,0,3.64483724060483,41,0
3,1,10,57,24,33,1,2.6229844769714,-26,0
3,1,10,33,62,-29,0,1.95303356651311,-12,0
3,1,10,47,81,-34,1,2.31037258492688,31,0
3,1,10,99,49,50,0,1.68589218188936,1,0
3,1,10,4,95,-91,0,5.44472588007193,-45,0
3,1,10,35,84,-49,0,3.91883877135297,-34,0
3,1,10,93,49,44,0,4.34164224163942,1,0
3,1,10,99,7,92,0,3.13971238337945,43,0
3,1,10,3,98,-95,0,3.16987833183703,-48,0
3,1,10,5,96,-91,0,3.24657597515579,-46,0
3,1,10,75,0,75,0,3.6086659609191,50,0
3,1,1.5,67,0,67,0,1.0607834972343,50,0
3,1,1.5,42,97,-55,1,0.750173748825546,47,0
3,1,1.5,99,2,97,0,0.787563836198387,48,0
3,1,1.5,100,11,89,0,0.879555041721687,39,0
3,1,1.5,85,15,70,0,0.928364165807579,35,0
3,1,1.5,66,44,22,0,1.42302267239029,6,0
3,1,1.5,17,77,-60,0,1.08967235517048,-27,0
3,1,1.5,3,75,-72,0,0.833824644181732,-25,0
3,1,1.5,66,0,66,0,1.05188601783811,50,0
3,1,1.5,71,38,33,1,0.893258472271555,-12,0
3,1,1.5,95,13,82,0,0.804620545761281,37,0
3,1,1.5,33,95,-62,0,1.48799740183131,-45,0
3,1,1.5,28,71,-43,0,1.30405604535918,-21,0
3,1,1.5,98,18,80,0,1.07145622042844,32,0
3,1,1.5,36,82,-46,1,0.712210730200241,32,0
3,1,1.5,39,50,-11,1,0.791614676423706,0,0
3,1,1.5,5,84,-79,0,0.811640144922421,-34,0
3,1,1.5,29,95,-66,1,0.999056111340906,45,0
3,1,1.5,95,8,87,0,0.722427820926896,42,0
3,1,1.5,32,70,-38,1,0.937108790225466,20,0
3,1,10,93,12,81,0,2.58659546141644,38,0
3,1,10,60,45,15,1,3.47856291393509,-5,0
3,1,10,49,65,-16,1,0.919368815239068,15,0
3,1,10,68,22,46,0,1.68493619679066,28,0
3,1,10,49,92,-43,1,0.981075307287028,42,0
3,1,10,71,16,55,0,1.58571058870803,34,0
3,1,10,1,59,-58,0,1.66984240908278,-9,0
3,1,10,8,100,-92,0,2.00660868685372,-50,0
3,1,10,98,10,88,0,3.60081280726808,40,0
3,1,10,79,6,73,0,3.29221363334364,44,0
3,1,10,63,13,50,0,2.61903847253598,37,0
3,1,10,90,43,47,1,3.22979748364742,-7,0
3,1,10,93,17,76,0,1.84050664277675,33,0
3,1,10,52,28,24,1,1.78661041701162,-22,0
3,1,10,92,12,80,0,3.07623834526566,38,0
3,1,10,60,49,11,1,2.49291112124411,-1,0
3,1,10,83,28,55,0,2.21229393902468,22,0
3,1,10,90,14,76,0,1.83171143325853,36,0
3,1,10,6,60,-54,0,1.83453393527088,-10,0
3,1,10,25,56,-31,1,2.22855778211306,6,0
3,1,1.5,97,5,92,0,0.822243221962708,45,0
3,1,1.5,99,4,95,0,0.648888447389254,46,0
3,1,1.5,81,47,34,1,0.78693665425817,-3,0
3,1,1.5,32,74,-42,1,0.574971518388338,24,0
3,1,1.5,99,1,98,0,0.635686469146094,49,0
3,1,1.5,10,89,-79,1,0.821695949820423,39,0
3,1,1.5,84,12,72,0,0.752454843634041,38,0
3,1,1.5,18,51,-33,0,1.1898532152336,-1,0
3,1,1.5,91,12,79,0,0.601265507266362,38,0
3,1,1.5,42,99,-57,1,0.844667817171285,49,0
3,1,1.5,7,92,-85,0,0.669419033782106,-42,0
3,1,1.5,35,81,-46,1,0.67810720815578,31,0
3,1,1.5,97,17,80,0,0.830160156829152,33,0
3,1,1.5,84,36,48,1,1.06482040822993,-14,0
3,1,1.5,34,80,-46,0,0.61029494779541,-30,0
3,1,1.5,36,72,-36,0,1.18163460255528,-22,0
3,1,1.5,35,84,-49,1,0.522333322092891,34,0
3,1,1.5,94,7,87,0,0.489064087658335,43,0
3,1,1.5,63,10,53,0,0.433053917853613,40,0
3,1,1.5,35,100,-65,1,0.546426859074927,50,0
4,1,10,85,15,70,1,2.19487847747223,-35,0
4,1,10,5,83,-78,0,1.014710997968,-33,0
4,1,10,100,0,100,0,1.11259395292291,50,0
4,1,10,30,100,-70,0,7.15111094005078,-50,0
4,1,10,50,100,-50,1,2.70907684666417,50,0
4,1,10,100,0,100,0,1.07706476497333,50,0
4,1,10,75,0,75,0,1.4450222591222,50,0
4,1,10,25,55,-30,1,2.38220296580585,5,0
4,1,10,98,38,60,1,1.61881825962701,-12,0
4,1,10,50,43,7,1,1.35005562489459,-7,0
4,1,10,80,45,35,0,4.23457907440934,5,0
4,1,10,53,40,13,1,1.62923248640618,-10,0
4,1,10,53,0,53,0,1.53523062796557,50,0
4,1,10,3,100,-97,0,3.37382019321194,-50,0
4,1,10,100,15,85,0,2.22714494913089,35,0
4,1,10,30,100,-70,0,1.83044945282381,-50,0
4,1,10,48,80,-32,1,3.04176504117277,30,0
4,1,10,50,43,7,1,2.17237852787366,-7,0
4,1,10,50,100,-50,0,1.81622964009694,-50,0
4,1,10,53,23,30,1,1.61954147491087,-27,0
4,1,1.5,75,0,75,0,0.877485937990059,50,0
4,1,1.5,25,55,-30,1,0.862779705252251,5,0
4,1,1.5,48,60,-12,0,1.41668820184168,-10,0
4,1,1.5,0,68,-68,0,0.812030372842855,-18,0
4,1,1.5,85,15,70,1,0.832027110493073,-35,0
4,1,1.5,3,100,-97,0,0.866585291201773,-50,0
4,1,1.5,53,40,13,1,0.795960551227836,-10,0
4,1,1.5,53,0,53,0,1.02453580245492,50,0
4,1,1.5,28,85,-57,0,0.979920787216543,-35,0
4,1,1.5,100,15,85,1,1.38519443054429,-35,0
4,1,1.5,48,80,-32,0,1.31786539691711,-30,0
4,1,1.5,48,100,-52,0,1.11716344188972,-50,0
4,1,1.5,53,23,30,1,1.01245227897016,-27,0
4,1,1.5,48,100,-52,0,1.32045401644791,-50,0
4,1,1.5,28,85,-57,NaN,NaN,0,0
4,1,1.5,80,45,35,NaN,NaN,0,0
4,1,1.5,48,60,-12,1,0.526289223798813,10,0
4,1,1.5,5,83,-78,0,0.69363640195661,-33,0
4,1,1.5,0,68,-68,0,0.5742640927092,-18,0
4,1,1.5,98,38,60,1,0.5715724708989,-12,0
4,1,10,0,80,-80,0,1.04884617288008,-30,0
4,1,10,7,87,-80,0,4.27330389887538,-37,0
4,1,10,30,58,-28,0,3.43459850188628,-8,0
4,1,10,48,60,-12,0,4.5171594097701,-10,0
4,1,10,32,54,-22,0,4.38040537444795,-4,0
4,1,10,58,41,17,1,4.53770964720752,-9,0
4,1,10,75,0,75,0,4.9602810752549,50,0
4,1,10,80,19,61,1,4.13425632172039,-31,0
4,1,10,14,52,-38,0,3.9248794488467,-2,0
4,1,10,80,45,35,1,4.4201319968688,-5,0
4,1,10,48,80,-32,0,4.81479823833251,-30,0
4,1,10,53,0,53,0,3.84273055007179,50,0
4,1,10,7,77,-70,0,4.36541249480069,-27,0
4,1,10,14,54,-40,0,4.53133083708599,-4,0
4,1,10,84,6,78,0,4.61063635980281,44,0
4,1,10,19,85,-66,0,4.12654068131815,-35,0
4,1,10,65,45,20,1,4.15777969608826,-5,0
4,1,10,25,55,-30,0,3.45980986732502,-5,0
4,1,10,2,87,-85,0,1.67775059153064,-37,0
4,1,10,43,66,-23,0,3.36560860234022,-16,0
4,1,1.5,34,88,-54,0,1.24500759687726,-38,0
4,1,1.5,92,2,90,1,0.631599706021007,-48,0
4,1,1.5,25,55,-30,0,0.810863258060635,-5,0
4,1,1.5,76,50,26,1,0.702880214947072,0,0
4,1,1.5,80,45,35,1,0.702832562648837,-5,0
4,1,1.5,75,0,75,1,1.06285484926229,-50,0
4,1,1.5,76,31,45,NaN,NaN,0,0
4,1,1.5,30,61,-31,0,0.808155874337899,-11,0
4,1,1.5,19,76,-57,1,1.16404340757799,26,0
4,1,1.5,84,8,76,1,0.666027759296412,-42,0
4,1,1.5,85,48,37,1,0.650752997971722,-2,0
4,1,1.5,10,56,-46,0,0.628621437303082,-6,0
4,1,1.5,53,0,53,0,0.687965411761979,50,0
4,1,1.5,72,4,68,0,0.760612075458994,46,0
4,1,1.5,14,57,-43,1,0.734606749398154,7,0
4,1,1.5,78,47,31,1,0.813230844234567,-3,0
4,1,1.5,80,45,35,1,0.793249501943137,-5,0
4,1,1.5,25,55,-30,0,0.645859473368546,-5,0
4,1,1.5,53,40,13,0,0.888557399945057,10,0
4,1,1.5,31,57,-26,0,0.777205705811866,-7,0
4,1,10,32,91,-59,0,3.3804405638366,-41,0
4,1,10,21,91,-70,0,1.00172024801213,-41,0
4,1,10,75,39,36,1,1.40422932485853,-11,0
4,1,10,37,74,-37,0,2.23076579078042,-24,0
4,1,10,22,89,-67,0,3.63340389539189,-39,0
4,1,10,75,0,75,0,4.05203814383276,50,0
4,1,10,50,100,-50,0,2.69407040444094,-50,0
4,1,10,4,74,-70,0,3.05461210111753,-24,0
4,1,10,53,40,13,1,2.28862814527929,-10,0
4,1,10,57,43,14,1,2.75326335776481,-7,0
4,1,10,74,42,32,0,3.00657675044204,8,0
4,1,10,1,84,-83,0,2.57847472320464,-34,0
4,1,10,100,0,100,0,3.15184771791246,50,0
4,1,10,8,92,-84,0,3.78175796664073,-42,0
4,1,10,10,94,-84,0,4.42694664225382,-44,0
4,1,10,25,55,-30,0,4.75829360781063,-5,0
4,1,10,83,35,48,1,4.73154124031498,-15,0
4,1,10,64,33,31,0,3.57085292117881,17,0
4,1,10,37,97,-60,0,4.25549476832748,-47,0
4,1,10,75,0,75,0,3.58542132880211,50,0
4,1,1.5,81,23,58,1,0.735442863977369,-27,0
4,1,1.5,64,33,31,1,0.614084186951004,-17,0
4,1,1.5,63,37,26,1,0.721374072385515,-13,0
4,1,1.5,49,88,-39,1,1.06469092901898,38,0
4,1,1.5,84,6,78,1,0.874646594051228,-44,0
4,1,1.5,53,0,53,0,0.931955082209242,50,0
4,1,1.5,51,0,51,0,1.13859524686632,50,0
4,1,1.5,62,43,19,1,0.537347123176005,-7,0
4,1,1.5,8,78,-70,0,0.671234689407356,-28,0
4,1,1.5,8,85,-77,0,0.5845294976898,-35,0
4,1,1.5,10,61,-51,0,0.86858632122312,-11,0
4,1,1.5,89,37,52,1,0.869130290551766,-13,0
4,1,1.5,18,90,-72,0,0.733832216254086,-40,0
4,1,1.5,63,41,22,0,1.45175223003571,9,0
4,1,1.5,19,76,-57,0,0.885105174123964,-26,0
4,1,1.5,42,98,-56,0,0.941091127691834,-48,0
4,1,1.5,100,15,85,0,0.723023575059415,35,0
4,1,1.5,14,57,-43,0,0.625679457643855,-7,0
4,1,1.5,36,75,-39,0,0.660339907517482,-25,0
4,1,1.5,43,76,-33,0,0.374316143681426,-26,0
4,1,10,39,59,-20,1,3.94422078410025,9,0
4,1,10,84,41,43,1,5.71819309811508,-9,0
4,1,10,83,17,66,0,5.88475181399554,33,0
4,1,10,70,47,23,0,5.32465511648115,3,0
4,1,10,57,11,46,0,5.17125283393761,39,0
4,1,10,50,100,-50,0,4.12788374305092,-50,0
4,1,10,14,57,-43,0,6.16653122416938,-7,0
4,1,10,12,98,-86,0,1.50717148779586,-48,0
4,1,10,100,0,100,0,5.44100626994259,50,0
4,1,10,28,91,-63,0,4.71498316590987,-41,0
4,1,10,48,80,-32,0,5.28894155078888,-30,0
4,1,10,80,45,35,0,6.04078267069235,5,0
4,1,10,99,18,81,0,6.42740080532531,32,0
4,1,10,90,39,51,0,5.75001896928006,11,0
4,1,10,37,67,-30,0,5.48330245097713,-17,0
4,1,10,63,41,22,1,4.31525844957832,-9,0
4,1,10,11,52,-41,0,3.64234200055216,-2,0
4,1,10,2,74,-72,0,4.58844101836621,-24,0
4,1,10,37,92,-55,0,5.14441102674209,-42,0
4,1,10,56,40,16,1,5.24634222781788,-10,0
4,1,1.5,53,0,53,0,0.973037962388844,50,0
4,1,1.5,82,17,65,1,0.657600999966235,-33,0
4,1,1.5,64,33,31,1,0.802968005147704,-17,0
4,1,1.5,64,24,40,1,0.710174682333673,-26,0
4,1,1.5,68,15,53,1,0.773494691349697,-35,0
4,1,1.5,100,0,100,0,0.706253631196887,50,0
4,1,1.5,84,39,45,1,0.625569857355003,-11,0
4,1,1.5,34,91,-57,0,0.780159415269736,-41,0
4,1,1.5,8,91,-83,0,0.680855322119896,-41,0
4,1,1.5,56,3,53,0,0.825466121963473,47,0
4,1,1.5,74,42,32,1,0.667447064710359,-8,0
4,1,1.5,28,84,-56,0,0.708015300055195,-34,0
4,1,1.5,100,23,77,0,0.611421156521828,27,0
4,1,1.5,57,11,46,1,0.702651483910813,-39,0
4,1,1.5,43,60,-17,0,1.03006017019288,-10,0
4,1,1.5,69,17,52,0,0.800630843134059,33,0
4,1,1.5,58,42,16,1,0.963966430786968,-8,0
4,1,1.5,25,55,-30,0,0.689260821194694,-5,0
4,1,1.5,83,16,67,0,0.889232962928872,34,0
4,1,1.5,15,88,-73,0,1.08124203885927,-38,0
4,1,10,66,20,46,0,3.74907142163283,30,0
4,1,10,89,43,46,1,4.34641938788809,-7,0
4,1,10,100,23,77,0,0.768409457881717,27,0
4,1,10,7,93,-86,0,0.771551210642428,-43,0
4,1,10,36,88,-52,0,3.74274136347958,-38,0
4,1,10,1,51,-50,0,5.97273152144589,-1,0
4,1,10,99,18,81,0,4.37738788421848,32,0
4,1,10,34,51,-17,0,5.23796568667785,-1,0
4,1,10,33,86,-53,0,6.56791753952893,-36,0
4,1,10,64,33,31,1,6.38851249681647,-17,0
4,1,10,8,81,-73,0,6.61572379260906,-31,0
4,1,10,11,79,-68,0,5.53836578271512,-29,0
4,1,10,1,82,-81,0,6.01629378742291,-32,0
4,1,10,64,11,53,0,6.53088913692591,39,0
4,1,10,50,100,-50,0,5.32951161891287,-50,0
4,1,10,63,0,63,0,6.47209756258417,50,0
4,1,10,75,0,75,0,6.80070342125146,50,0
4,1,10,25,78,-53,0,1.98797255960562,-28,0
4,1,10,87,24,63,0,3.29594387292309,26,0
4,1,10,25,55,-30,0,3.50382043147329,-5,0
4,1,1.5,69,17,52,1,0.910541605038816,-33,0
4,1,1.5,81,21,60,1,0.789093854869861,-29,0
4,1,1.5,49,73,-24,0,0.937154681196262,-23,0
4,1,1.5,66,20,46,1,1.32706705594865,-30,0
4,1,1.5,93,8,85,0,0.821785165106121,42,0
4,1,1.5,14,89,-75,0,0.904377963377556,-39,0
4,1,1.5,39,85,-46,0,1.34360753566034,-35,0
4,1,1.5,74,38,36,1,0.821632677747402,-12,0
4,1,1.5,63,36,27,1,1.43154618882363,-14,0
4,1,1.5,50,100,-50,0,0.794256798240895,-50,0
4,1,1.5,54,17,37,1,1.15754143459162,-33,0
4,1,1.5,27,71,-44,0,1.17022317771261,-21,0
4,1,1.5,63,12,51,0,0.918910081943977,38,0
4,1,1.5,93,9,84,0,0.92545164299554,41,0
4,1,1.5,100,15,85,0,0.852131982206629,35,0
4,1,1.5,50,27,23,NaN,NaN,0,0
4,1,1.5,49,61,-12,0,1.41278547851107,-11,0
4,1,1.5,74,42,32,1,0.927405020718652,-8,0
4,1,1.5,17,61,-44,0,0.822079509694959,-11,0
4,1,1.5,48,80,-32,0,0.7527131569841,-30,0
5,1,10,75,0,75,1,3.67776073310415,-50,0
5,1,10,53,40,13,1,2.31843262313851,-10,0
5,1,10,30,100,-70,1,2.48565296678134,50,0
5,1,10,48,60,-12,1,2.54224934707963,10,0
5,1,10,50,100,-50,1,2.15684985108783,50,0
5,1,10,25,55,-30,1,8.44934634593483,5,0
5,1,10,50,43,7,NaN,NaN,0,0
5,1,10,0,68,-68,0,1.0225726460485,-18,0
5,1,10,85,15,70,1,8.96020930125997,-35,0
5,1,10,98,38,60,NaN,NaN,0,0
5,1,10,5,83,-78,1,2.41818575028628,33,0
5,1,10,3,100,-97,0,2.677389049255,-50,0
5,1,10,50,43,7,1,4.99064009163885,-7,0
5,1,10,53,23,30,1,2.81129970217626,-27,0
5,1,10,53,0,53,1,1.92726689576193,-50,0
5,1,10,75,0,75,1,3.22253342497061,-50,0
5,1,10,53,0,53,1,4.62578767468403,-50,0
5,1,10,100,0,100,1,3.30108920962084,-50,0
5,1,10,30,100,-70,1,6.43696824742256,50,0
5,1,10,80,45,35,1,1.88760412371266,-5,0
5,1,1.5,100,0,100,1,0.735035967927615,-50,0
5,1,1.5,48,80,-32,1,0.997587720503361,30,0
5,1,1.5,28,85,-57,1,0.882237800688017,35,0
5,1,1.5,50,100,-50,1,1.0508495761751,50,0
5,1,1.5,48,100,-52,NaN,NaN,0,0
5,1,1.5,3,100,-97,0,1.06806139748005,-50,0
5,1,1.5,48,80,-32,1,0.541437067584411,30,0
5,1,1.5,5,83,-78,0,0.596038304696776,-33,0
5,1,1.5,0,68,-68,NaN,NaN,0,0
5,1,1.5,25,55,-30,0,0.584035189003771,-5,0
5,1,1.5,28,85,-57,1,0.372646781213916,35,0
5,1,1.5,53,40,13,1,0.593926597939571,-10,0
5,1,1.5,48,100,-52,1,0.286606002291592,50,0
5,1,1.5,48,60,-12,1,0.311247835050381,10,0
5,1,1.5,53,23,30,1,0.303232806414599,-27,0
5,1,1.5,100,15,85,1,0.287207880870483,-35,0
5,1,1.5,80,45,35,1,0.575791065291924,-5,0
5,1,1.5,100,15,85,1,0.421047056128373,-35,0
5,1,1.5,98,38,60,1,0.56828957617472,-12,0
5,1,1.5,85,15,70,1,0.517790423824408,-35,0
5,1,10,26,71,-45,1,1.52423550973799,21,0
5,1,10,32,99,-67,NaN,NaN,0,0
5,1,10,47,68,-21,1,3.38921053837294,18,0
5,1,10,52,26,26,1,3.24178107674561,-24,0
5,1,10,36,75,-39,0,2.82836453608252,-25,0
5,1,10,26,94,-68,1,1.91959715922167,44,0
5,1,10,76,31,45,1,2.34949718213102,-19,0
5,1,10,61,31,30,1,0.531560320732751,-19,0
5,1,10,94,43,51,1,4.58462753722779,-7,0
5,1,10,46,89,-43,1,3.02124756013654,39,0
5,1,10,50,82,-32,1,4.82313347079071,32,0
5,1,10,48,60,-12,1,2.85851381443354,10,0
5,1,10,12,91,-79,0,3.22038506300123,-41,0
5,1,10,78,27,51,1,1.87981525773284,-23,0
5,1,10,7,59,-52,1,4.07218840779024,9,0
5,1,10,8,66,-58,1,3.15353621993199,16,0
5,1,10,14,57,-43,1,2.60749195876269,7,0
5,1,10,33,57,-24,1,2.72344265750326,7,0
5,1,10,40,88,-48,1,2.61873557846411,38,0
5,1,10,48,72,-24,1,3.13394657502977,22,0
5,1,1.5,67,26,41,1,0.555363848798152,-24,0
5,1,1.5,3,59,-56,1,1.2492975945006,9,0
5,1,1.5,56,30,26,NaN,NaN,0,0
5,1,1.5,44,77,-33,1,0.524620022908493,27,0
5,1,1.5,84,15,69,1,0.379776953035616,-35,0
5,1,1.5,16,69,-53,1,0.313251408935685,19,0
5,1,1.5,53,4,49,1,0.417167101946688,-46,0
5,1,1.5,38,94,-56,1,0.324489530356004,44,0
5,1,1.5,49,73,-24,1,0.771776219929961,23,0
5,1,1.5,94,26,68,1,0.72907509736433,-24,0
5,1,1.5,50,1,49,1,0.814954959909301,-49,0
5,1,1.5,56,27,29,1,0.714408980526059,-23,0
5,1,1.5,35,81,-46,1,0.641661947309331,31,0
5,1,1.5,93,19,74,1,0.404272164947542,-31,0
5,1,1.5,78,41,37,1,0.408316701032163,-9,0
5,1,1.5,68,39,29,1,0.284324948454014,-11,0
5,1,1.5,52,37,15,1,0.460934524628101,-13,0
5,1,1.5,19,66,-47,1,0.518842428407879,16,0
5,1,1.5,43,80,-37,1,0.302210859106708,30,0
5,1,1.5,35,89,-54,1,0.254145612829234,39,0
5,1,10,38,83,-45,1,0.944854066437983,33,0
5,1,10,55,0,55,1,2.74992678121453,-50,0
5,1,10,40,51,-11,1,4.86782680412398,1,0
5,1,10,90,6,84,1,4.10044297823697,-44,0
5,1,10,3,60,-57,1,3.78840998854503,10,0
5,1,10,99,8,91,1,3.05703550973703,-42,0
5,1,10,38,84,-46,1,2.13900536082474,34,0
5,1,10,30,78,-48,1,3.16960146620841,28,0
5,1,10,37,98,-61,1,2.91886882016115,48,0
5,1,10,55,29,26,1,2.45424348224515,-21,0
5,1,10,86,11,75,1,1.30284096219839,-39,0
5,1,10,96,34,62,1,5.04461672394063,-16,0
5,1,10,92,8,84,1,1.4792155784653,-42,0
5,1,10,71,41,30,1,3.15049567010283,-9,0
5,1,10,34,90,-56,1,3.29168531500545,40,0
5,1,10,49,93,-44,1,3.4683773654051,43,0
5,1,10,21,53,-32,1,3.47766396334373,3,0
5,1,10,68,33,35,1,3.23820902634543,-17,0
5,1,10,33,87,-54,1,3.90480128293348,37,0
5,1,10,36,71,-35,1,4.01606268041178,21,0
5,1,1.5,43,66,-23,1,0.569464742267883,16,0
5,1,1.5,67,15,52,1,0.294005956471665,-35,0
5,1,1.5,79,8,71,1,0.294085131730753,-42,0
5,1,1.5,40,78,-38,1,0.278763619702659,28,0
5,1,1.5,25,74,-49,1,0.29599450171736,24,0
5,1,1.5,89,30,59,1,0.296002932416741,-20,0
5,1,1.5,92,5,87,1,0.279954180985442,-45,0
5,1,1.5,89,26,63,1,0.256579518900253,-24,0
5,1,1.5,50,59,-9,1,0.305905337914737,9,0
5,1,1.5,28,73,-45,1,0.273276334479306,23,0
5,1,1.5,7,66,-59,1,0.24856998854375,16,0
5,1,1.5,47,82,-35,1,0.313860985108477,32,0
5,1,1.5,49,74,-25,1,0.25720778923278,24,0
5,1,1.5,55,29,26,1,0.25853434135206,-21,0
5,1,1.5,32,86,-54,1,0.291849163802908,36,0
5,1,1.5,28,76,-48,1,0.267735166095008,26,0
5,1,1.5,87,19,68,1,0.252434547535813,-31,0
5,1,1.5,71,22,49,1,0.333654799542273,-28,0
5,1,1.5,30,53,-23,1,0.283745062999515,3,0
5,1,1.5,50,82,-32,NaN,NaN,0,0
5,1,10,79,28,51,1,1.87293690721526,-22,0
5,1,10,45,63,-18,1,0.290244032074042,13,0
5,1,10,42,57,-15,1,4.01674116838331,7,0
5,1,10,99,22,77,1,2.02733342497049,-28,0
5,1,10,72,26,46,1,3.63792824742268,-24,0
5,1,10,31,94,-63,1,3.83989993127216,44,0
5,1,10,12,93,-81,0,2.39387051546328,-43,0
5,1,10,92,31,61,1,3.50978345933618,-19,0
5,1,10,49,89,-40,0,3.74910167239432,-39,0
5,1,10,72,3,69,1,3.34636646048057,-47,0
5,1,10,50,16,34,1,2.65496119129421,-34,0
5,1,10,47,70,-23,0,3.92821699885462,-20,0
5,1,10,25,90,-65,0,5.11882190148935,-40,0
5,1,10,10,100,-90,0,2.23743743413434,-50,0
5,1,10,78,23,55,1,2.19135083619767,-27,0
5,1,10,65,0,65,1,2.3793403894615,-50,0
5,1,10,35,75,-40,0,1.77600879725105,-25,0
5,1,10,36,68,-32,0,1.40470652920885,-18,0
5,1,10,99,25,74,1,1.63847697594429,-25,0
5,1,10,93,21,72,1,0.696518304695928,-29,0
5,1,1.5,1,67,-66,0,0.617543550974005,-17,0
5,1,1.5,10,52,-42,NaN,NaN,0,0
5,1,1.5,98,38,60,1,1.39549287514456,-12,0
5,1,1.5,22,85,-63,0,0.655419014890867,-35,0
5,1,1.5,48,86,-38,0,0.760716609393057,-36,0
5,1,1.5,47,71,-24,0,0.49405434135042,-21,0
5,1,1.5,34,90,-56,0,0.478072302405053,-40,0
5,1,1.5,9,89,-80,0,0.534642290949705,-39,0
5,1,1.5,29,84,-55,0,0.68466547537173,-34,0
5,1,1.5,87,6,81,0,0.34058739977263,44,0
5,1,1.5,49,71,-22,0,0.401304558992706,-21,0
5,1,1.5,63,22,41,0,0.284496861397201,28,0
5,1,1.5,61,42,19,1,0.556485131730369,-8,0
5,1,1.5,19,98,-79,0,0.609842290950837,-48,0
5,1,1.5,26,71,-45,0,0.597175349370445,-21,0
5,1,1.5,68,19,49,1,0.497145108820405,-31,0
5,1,1.5,25,63,-38,0,1.19310808705632,-13,0
5,1,1.5,37,98,-61,0,0.741080045818308,-48,0
5,1,1.5,5,98,-93,0,0.706995463917337,-48,0
5,1,1.5,45,66,-21,NaN,NaN,0,0
5,1,10,62,49,13,1,1.24093214204004,-1,0
5,1,10,45,63,-18,0,0.714884032073314,-13,0
5,1,10,42,99,-57,0,1.06410703321853,-49,0
5,1,10,92,37,55,1,1.52057512027568,-13,0
5,1,10,50,6,44,1,2.04724343642556,-44,0
5,1,10,49,66,-17,0,2.28118506300052,-16,0
5,1,10,49,55,-6,0,2.48980820160432,-5,0
5,1,10,91,36,55,1,2.29782066437656,-14,0
5,1,10,58,5,53,1,2.63303770905077,-45,0
5,1,10,53,14,39,1,2.28308893470785,-36,0
5,1,10,25,74,-49,0,2.21831221076718,-24,0
5,1,10,32,97,-65,0,1.97148481099612,-47,0
5,1,10,90,1,89,1,2.22342194730845,-49,0
5,1,10,81,43,38,1,2.97663413516602,-7,0
5,1,10,12,85,-73,0,2.38124646047982,-35,0
5,1,10,24,56,-32,0,2.009902405498,-6,0
5,1,10,48,80,-32,0,1.92372636884284,-30,0
5,1,10,28,59,-31,0,2.18632687285208,-9,0
5,1,10,16,69,-53,0,1.45441612829381,-19,0
5,1,10,94,22,72,1,0.702169072164907,-28,0
5,1,1.5,88,42,46,1,1.14879450171793,-8,0
5,1,1.5,3,59,-56,0,0.658033264604455,-9,0
5,1,1.5,26,94,-68,0,0.667366048110125,-44,0
5,1,1.5,21,53,-32,0,0.70805553264654,-3,0
5,1,1.5,99,33,66,1,0.650661901489002,-17,0
5,1,1.5,48,55,-7,0,0.707972691867326,-5,0
5,1,1.5,83,48,35,1,0.635319495990188,-2,0
5,1,1.5,86,39,47,1,0.733255990837279,-11,0
5,1,1.5,34,61,-27,0,0.531232623137839,-11,0
5,1,1.5,8,59,-51,0,0.673895807560257,-9,0
5,1,1.5,48,60,-12,0,0.625139243986268,-10,0
5,1,1.5,68,5,63,1,0.939778052690599,-45,0
5,1,1.5,80,33,47,1,0.729814066438848,-17,0
5,1,1.5,100,37,63,1,0.527811225660116,-13,0
5,1,1.5,80,43,37,1,0.678360045818408,-7,0
5,1,1.5,36,71,-35,1,0.44642016036596,21,0
5,1,1.5,9,57,-48,0,0.584351890034668,-7,0
5,1,1.5,92,14,78,NaN,NaN,0,0
5,1,1.5,49,73,-24,1,0.955667720503698,23,0
5,1,1.5,9,94,-85,0,0.640946437571984,-44,0
6,1,10,85,15,70,1,2.87417029437529,-35,0
6,1,10,0,68,-68,0,2.81940019266221,-18,0
6,1,10,5,83,-78,1,2.97484564212937,33,0
6,1,10,28,85,-57,0,2.4442959067128,-35,0
6,1,10,3,100,-97,0,2.64705565387521,-50,0
6,1,10,48,100,-52,1,1.45781019297101,50,0
6,1,10,48,60,-12,1,3.08384187244155,10,0
6,1,10,100,0,100,0,3.1885911536192,50,0
6,1,10,53,0,53,1,2.01736828446155,-50,0
6,1,10,80,45,35,0,4.63670843480759,5,0
6,1,10,53,0,53,1,1.79950008724154,-50,0
6,1,10,0,68,-68,0,2.29159048354995,-18,0
6,1,10,100,15,85,1,1.31523755203307,-35,0
6,1,10,100,15,85,1,3.69814220718035,-35,0
6,1,10,53,23,30,1,2.21894881227672,-27,0
6,1,10,25,55,-30,0,3.14229478944071,-5,0
6,1,10,3,100,-97,1,4.21305564800969,50,0
6,1,10,100,0,100,1,2.62521498667957,-50,0
6,1,10,48,80,-32,0,3.01263674472284,-30,0
6,1,10,48,60,-12,1,2.71265719870098,10,0
6,1,1.5,53,40,13,1,0.97828176341136,-10,0
6,1,1.5,50,100,-50,1,0.839538561243899,50,0
6,1,1.5,53,23,30,NaN,NaN,0,0
6,1,1.5,75,0,75,1,0.93776786277158,-50,0
6,1,1.5,80,45,35,1,1.06441462774455,-5,0
6,1,1.5,5,83,-78,0,0.674486341289594,-33,0
6,1,1.5,30,100,-70,0,0.747882023815691,-50,0
6,1,1.5,48,80,-32,0,0.706597983340544,-30,0
6,1,1.5,50,43,7,1,0.626602777929293,-7,0
6,1,1.5,98,38,60,1,0.622016761995837,-12,0
6,1,1.5,50,43,7,1,0.681350153001404,-7,0
6,1,1.5,25,55,-30,0,0.8267925820237,-5,0
6,1,1.5,75,0,75,1,0.694175308899503,-50,0
6,1,1.5,98,38,60,1,1.43087216045387,-12,0
6,1,1.5,48,100,-52,0,0.634327636033049,-50,0
6,1,1.5,53,40,13,1,0.620964738518524,-10,0
6,1,1.5,85,15,70,1,1.00033540121331,-35,0
6,1,1.5,28,85,-57,0,1.16435759120941,-35,0
6,1,1.5,30,100,-70,1,1.13843455973984,50,0
6,1,1.5,50,100,-50,1,0.761224394042074,50,0
6,1,10,79,26,53,1,1.28471640819407,-24,0
6,1,10,31,57,-26,1,1.38026066722341,7,0
6,1,10,77,21,56,1,2.00053957441196,-29,0
6,1,10,43,85,-42,1,1.1326165400078,35,0
6,1,10,48,100,-52,1,0.874099915105035,50,0
6,1,10,3,100,-97,0,0.731486586151732,-50,0
6,1,10,100,0,100,1,2.00228879254246,-50,0
6,1,10,24,76,-52,0,1.43045391697342,-26,0
6,1,10,47,89,-42,1,1.11380254802316,39,0
6,1,10,4,91,-87,0,1.48195028291047,-41,0
6,1,10,57,41,16,1,1.40883281844071,-9,0
6,1,10,94,32,62,1,1.85961938010587,-18,0
6,1,10,72,22,50,1,1.87775743784368,-28,0
6,1,10,3,100,-97,0,1.65522001586396,-50,0
6,1,10,85,2,83,0,1.7932876503437,48,0
6,1,10,43,85,-42,0,1.37277407227702,-35,0
6,1,10,55,34,21,1,2.52108995497292,-16,0
6,1,10,7,58,-51,0,3.22442190026959,-8,0
6,1,10,47,89,-42,1,2.93196010668362,39,0
6,1,10,99,45,54,0,3.11524935522357,5,0
6,1,1.5,1,62,-61,0,0.790200859506513,-12,0
6,1,1.5,3,100,-97,1,1.05086991711323,50,0
6,1,1.5,75,17,58,1,0.508954295994045,-33,0
6,1,1.5,100,0,100,0,1.28491325021787,50,0
6,1,1.5,37,72,-35,NaN,NaN,0,0
6,1,1.5,93,36,57,1,0.645207098335959,-14,0
6,1,1.5,13,72,-59,1,0.85582916311796,22,0
6,1,1.5,30,100,-70,0,0.305886272963107,-50,0
6,1,1.5,73,5,68,1,0.457953517425267,-45,0
6,1,1.5,66,29,37,1,0.588007812099022,-21,0
6,1,1.5,83,45,38,0,0.303431795888173,5,0
6,1,1.5,62,37,25,1,0.359392113708964,-13,0
6,1,1.5,58,13,45,0,0.405427121531829,37,0
6,1,1.5,80,45,35,1,0.34552776388955,-5,0
6,1,1.5,68,22,46,1,0.45621932819995,-28,0
6,1,1.5,5,83,-78,0,0.570282866019625,-33,0
6,1,1.5,84,2,82,1,0.455617438810805,-48,0
6,1,1.5,48,60,-12,0,0.353693592114723,-10,0
6,1,1.5,36,73,-37,1,0.495675706981274,23,0
6,1,1.5,73,37,36,1,0.688463591190157,-13,0
6,1,10,31,57,-26,0,0.914599519954209,-7,0
6,1,10,45,88,-43,1,1.09740014574345,38,0
6,1,10,64,38,26,1,3.53813126906971,-12,0
6,1,10,64,21,43,1,2.03292650204821,-29,0
6,1,10,87,22,65,0,2.09163014520163,28,0
6,1,10,68,19,49,1,2.5163547496486,-31,0
6,1,10,58,13,45,1,2.32377543734037,-37,0
6,1,10,30,72,-42,0,2.25056120137378,-22,0
6,1,10,30,100,-70,1,2.14061961616972,50,0
6,1,10,48,62,-14,1,2.53019417347605,12,0
6,1,10,85,2,83,0,3.07233082949278,48,0
6,1,10,36,73,-37,0,3.02505062175624,-23,0
6,1,10,43,85,-42,1,1.85249531171576,35,0
6,1,10,54,10,44,0,2.63786749342762,40,0
6,1,10,75,27,48,1,2.52058593675611,-23,0
6,1,10,54,24,30,1,2.6961063401468,-26,0
6,1,10,97,14,83,0,2.63210702341166,36,0
6,1,10,57,36,21,1,2.08289505131143,-14,0
6,1,10,88,1,87,0,1.76360079411279,49,0
6,1,10,43,53,-10,0,2.20099659980042,-3,0
6,1,1.5,96,38,58,1,0.713380419019813,-12,0
6,1,1.5,57,50,7,1,0.608683189178919,0,0
6,1,1.5,78,37,41,1,1.11674418161419,-13,0
6,1,1.5,17,76,-59,0,0.555533276932692,-26,0
6,1,1.5,58,13,45,0,0.832895784427819,37,0
6,1,1.5,52,16,36,0,0.850959430748844,34,0
6,1,1.5,43,85,-42,1,1.04426562896515,35,0
6,1,1.5,91,3,88,0,0.854335436402835,47,0
6,1,1.5,80,45,35,1,0.575715999115346,-5,0
6,1,1.5,85,28,57,1,0.733113373675224,-22,0
6,1,1.5,13,96,-83,0,0.730554060810391,-46,0
6,1,1.5,68,45,23,1,0.78523178973046,-5,0
6,1,1.5,47,89,-42,1,1.38926371552589,39,0
6,1,1.5,80,45,35,1,0.83330852952713,-5,0
6,1,1.5,56,5,51,1,1.01934183651792,-45,0
6,1,1.5,14,70,-56,0,0.8221336209117,-20,0
6,1,1.5,37,67,-30,0,1.4888001653926,-17,0
6,1,1.5,53,32,21,1,1.13690124468667,-18,0
6,1,1.5,29,63,-34,1,0.798962345623295,13,0
6,1,1.5,88,1,87,0,0.882328058309213,49,0
6,1,10,82,30,52,0,3.72916736923798,20,0
6,1,10,94,18,76,1,2.57589964502404,-32,0
6,1,10,19,80,-61,0,3.02862860125606,-30,0
6,1,10,85,2,83,1,1.3353722550255,-48,0
6,1,10,55,39,16,1,3.86817889237682,-11,0
6,1,10,99,45,54,1,3.52506051884302,-5,0
6,1,10,50,100,-50,1,2.37986991564867,50,0
6,1,10,80,13,67,1,3.00060995368221,-37,0
6,1,10,1,66,-65,0,2.81201550103469,-16,0
6,1,10,61,44,17,1,3.92746792977778,-6,0
6,1,10,4,61,-57,1,3.12555918530234,11,0
6,1,10,99,45,54,0,3.0202978216148,5,0
6,1,10,71,4,67,0,3.20708733920947,46,0
6,1,10,23,68,-45,1,2.89848999808055,18,0
6,1,10,48,60,-12,1,3.08259777220337,10,0
6,1,10,50,100,-50,1,1.45870129717696,50,0
6,1,10,96,13,83,0,3.56279590451413,37,0
6,1,10,78,41,37,1,3.73635741819453,-9,0
6,1,10,59,29,30,1,4.14249896263937,-21,0
6,1,10,63,35,28,1,3.26062177153472,-15,0
6,1,1.5,47,89,-42,0,0.900756797098438,-39,0
6,1,1.5,63,4,59,0,0.844117612557966,46,0
6,1,1.5,8,54,-46,1,0.646187276306591,4,0
6,1,1.5,97,28,69,1,0.456195135326197,-22,0
6,1,1.5,57,40,17,1,0.849612694075404,-10,0
6,1,1.5,8,53,-45,0,0.770981087036489,-3,0
6,1,1.5,98,22,76,1,0.591694292974353,-28,0
6,1,1.5,50,61,-11,1,1.10778475379811,11,0
6,1,1.5,96,13,83,0,1.15512800963006,37,0
6,1,1.5,54,10,44,1,0.632594179927764,-40,0
6,1,1.5,66,25,41,1,1.37794988116184,-25,0
6,1,1.5,60,21,39,NaN,NaN,0,0
6,1,1.5,60,49,11,1,0.845991827207399,-1,0
6,1,1.5,54,10,44,1,0.640065012852574,-40,0
6,1,1.5,1,54,-53,0,0.690174320658116,-4,0
6,1,1.5,56,5,51,1,0.450106228712684,-45,0
6,1,1.5,83,48,35,1,0.835591823686627,-2,0
6,1,1.5,48,100,-52,0,0.8136881083974,-50,0
6,1,1.5,88,6,82,0,0.841027156135169,44,0
6,1,1.5,8,54,-46,0,0.72300661711779,-4,0
6,1,10,72,43,29,1,3.08126789722701,-7,0
6,1,10,38,100,-62,1,2.16998646665161,50,0
6,1,10,3,100,-97,0,2.89471480999782,-50,0
6,1,10,41,80,-39,1,2.51885651279372,30,0
6,1,10,62,42,20,0,2.90954210952987,8,0
6,1,10,70,4,66,0,3.18898227175487,46,0
6,1,10,16,81,-65,0,2.8250873509387,-31,0
6,1,10,99,45,54,1,2.36389235490606,-5,0
6,1,10,25,98,-73,1,2.51326282698938,48,0
6,1,10,97,14,83,0,2.48062883878629,36,0
6,1,10,87,22,65,0,3.30482215304801,28,0
6,1,10,66,45,21,1,1.75217479278581,-5,0
6,1,10,48,62,-14,0,3.25242515237733,-12,0
6,1,10,100,9,91,1,0.629817131193704,-41,0
6,1,10,21,99,-78,0,3.26343584269671,-49,0
6,1,10,50,61,-11,1,2.36082205921048,11,0
6,1,10,1,52,-51,1,3.10231239892164,2,0
6,1,10,44,89,-45,1,3.74890692194822,39,0
6,1,10,58,43,15,0,5.63444420170163,7,0
6,1,10,10,59,-49,1,3.93259975162073,9,0
6,1,1.5,10,59,-49,0,0.769419180403929,-9,0
6,1,1.5,90,24,66,1,0.526108876732906,-26,0
6,1,1.5,57,0,57,1,0.62881972496325,-50,0
6,1,1.5,48,62,-14,0,0.703618594203363,-12,0
6,1,1.5,53,44,9,1,0.390341764672485,-6,0
6,1,1.5,13,57,-44,1,0.474341623912551,7,0
6,1,1.5,93,35,58,0,0.738327671222578,15,0
6,1,1.5,74,42,32,1,0.431743103930785,-8,0
6,1,1.5,67,5,62,0,0.45783585207937,45,0
6,1,1.5,71,4,67,1,0.819220578898239,-46,0
6,1,1.5,55,27,28,1,0.65328715182477,-23,0
6,1,1.5,74,8,66,1,0.477966156367984,-42,0
6,1,1.5,52,40,12,NaN,NaN,0,0
6,1,1.5,10,59,-49,0,0.678084114957528,-9,0
6,1,1.5,26,100,-74,0,0.910821032846798,-50,0
6,1,1.5,91,3,88,1,0.302191361237419,-47,0
6,1,1.5,99,19,80,1,0.269567270119296,-31,0
6,1,1.5,48,60,-12,1,0.365644138946664,10,0
6,1,1.5,29,89,-60,0,0.338963430636795,-39,0
6,1,1.5,50,2,48,1,0.312299950588567,-48,0
7,1,10,53,40,13,0,1.84483934760283,10,0
7,1,10,48,60,-12,1,1.32657000581094,10,0
7,1,10,100,15,85,0,2.90850538562518,35,0
7,1,10,53,23,30,0,1.86051952003254,27,0
7,1,10,85,15,70,0,1.71042357395709,35,0
7,1,10,100,0,100,0,1.60498076496515,50,0
7,1,10,30,100,-70,0,3.32092687388285,-50,0
7,1,10,53,0,53,0,0.952305913102464,50,0
7,1,10,80,45,35,1,2.0382688286154,-5,0
7,1,10,50,43,7,1,1.06344610433371,-7,0
7,1,10,75,0,75,0,1.18396610088894,50,0
7,1,10,30,100,-70,1,3.307184317262,50,0
7,1,10,50,43,7,0,3.17914662062685,7,0
7,1,10,48,60,-12,1,3.6004699249861,10,0
7,1,10,3,100,-97,0,2.28449522468873,-50,0
7,1,10,98,38,60,0,2.6610414959905,12,0
7,1,10,100,0,100,0,3.46307991473805,50,0
7,1,10,80,45,35,1,1.48100414391956,-5,0
7,1,10,100,15,85,0,4.05671063507543,35,0
7,1,10,0,68,-68,0,4.17885007669975,-18,0
7,1,1.5,48,100,-52,NaN,NaN,0,0
7,1,1.5,48,100,-52,1,0.814163363076659,50,0
7,1,1.5,75,0,75,0,1.05006717141441,50,0
7,1,1.5,3,100,-97,0,1.10802483051157,-50,0
7,1,1.5,5,83,-78,0,1.03603650166406,-33,0
7,1,1.5,28,85,-57,0,1.01469523605556,-35,0
7,1,1.5,53,0,53,0,0.882598663170938,50,0
7,1,1.5,53,40,13,1,1.13929207011097,-10,0
7,1,1.5,28,85,-57,NaN,NaN,0,0
7,1,1.5,98,38,60,0,1.28927804933483,12,0
7,1,1.5,25,55,-30,0,0.905854818105581,-5,0
7,1,1.5,25,55,-30,0,0.74585635764015,-5,0
7,1,1.5,5,83,-78,0,0.824437565410335,-33,0
7,1,1.5,50,100,-50,1,0.947817433043383,50,0
7,1,1.5,48,80,-32,1,1.17839701330013,30,0
7,1,1.5,48,80,-32,1,0.647687122331263,30,0
7,1,1.5,0,68,-68,0,0.690249056573521,-18,0
7,1,1.5,85,15,70,0,0.978958210765995,35,0
7,1,1.5,50,100,-50,1,1.08836642419192,50,0
7,1,1.5,53,23,30,1,1.04898033242716,-27,0
7,1,10,40,86,-46,0,4.16089285747148,-36,0
7,1,10,39,73,-34,0,1.1588372105798,-23,0
7,1,10,78,9,69,0,2.98872876494352,41,0
7,1,10,35,52,-17,1,2.18539676954242,2,0
7,1,10,83,22,61,0,0.950003573922004,28,0
7,1,10,94,21,73,0,4.3544916874198,29,0
7,1,10,34,82,-48,0,1.68843570330137,-32,0
7,1,10,31,67,-36,0,1.06368803139048,-17,0
7,1,10,39,99,-60,0,5.30489150854191,-49,0
7,1,10,15,97,-82,0,5.72085319609687,-47,0
7,1,10,90,26,64,0,3.33552790500471,24,0
7,1,10,48,71,-23,1,2.47013208851058,21,0
7,1,10,28,79,-51,0,2.60743742428167,-29,0
7,1,10,4,73,-69,0,6.42733702455371,-23,0
7,1,10,72,13,59,0,5.05469274346979,37,0
7,1,10,20,80,-60,0,5.24857748722206,-30,0
7,1,10,13,54,-41,0,4.49114052113146,-4,0
7,1,10,48,59,-11,1,3.69176183380841,9,0
7,1,10,34,56,-22,0,1.58846081239608,-6,0
7,1,10,51,21,30,0,3.4555842080299,29,0
7,1,1.5,27,92,-65,0,0.907675135946192,-42,0
7,1,1.5,3,76,-73,0,0.795506021600886,-26,0
7,1,1.5,78,16,62,0,1.02422386317267,34,0
7,1,1.5,80,11,69,0,0.811477239611122,39,0
7,1,1.5,96,10,86,0,0.839487994369847,40,0
7,1,1.5,99,23,76,0,0.770037333742948,27,0
7,1,1.5,60,11,49,0,0.815514489047928,39,0
7,1,1.5,16,80,-64,0,1.03544597970176,-30,0
7,1,1.5,98,24,74,0,0.734132792294986,26,0
7,1,1.5,94,29,65,0,0.580714747837192,21,0
7,1,1.5,97,11,86,0,0.58545798441628,39,0
7,1,1.5,1,77,-76,0,0.734075976091844,-27,0
7,1,1.5,3,91,-88,0,0.828711976671912,-41,0
7,1,1.5,47,56,-9,1,1.14399938418501,6,0
7,1,1.5,55,47,8,1,0.918626367485558,-3,0
7,1,1.5,51,0,51,0,0.813952959848393,50,0
7,1,1.5,7,81,-74,0,0.729833455214248,-31,0
7,1,1.5,27,51,-24,0,0.665239297017251,-1,0
7,1,1.5,85,18,67,0,0.754594689700752,32,0
7,1,1.5,75,34,41,0,1.06453880821573,16,0
7,1,10,52,43,9,0,3.19849088833143,7,0
7,1,10,60,3,57,0,3.68239412483672,47,0
7,1,10,14,76,-62,0,3.78768041435251,-26,0
7,1,10,84,45,39,0,4.00828123653991,5,0
7,1,10,89,30,59,0,3.90816448840633,20,0
7,1,10,18,60,-42,0,3.50011454879859,-10,0
7,1,10,96,9,87,0,2.82750710660548,41,0
7,1,10,55,25,30,0,3.95073118788059,25,0
7,1,10,15,79,-64,0,3.71672833973935,-29,0
7,1,10,94,25,69,0,3.2200000366538,25,0
7,1,10,49,88,-39,0,3.47786275771432,-38,0
7,1,10,76,49,27,0,2.6072614773293,1,0
7,1,10,96,26,70,0,2.35450818244863,24,0
7,1,10,96,47,49,0,4.46444570295716,3,0
7,1,10,41,100,-59,1,4.88179517208846,50,0
7,1,10,78,29,49,0,2.97108165221289,21,0
7,1,10,96,32,64,0,2.74362036512684,18,0
7,1,10,65,38,27,0,3.67826340358079,12,0
7,1,10,3,54,-51,0,3.63957560128983,-4,0
7,1,10,48,88,-40,1,2.18613977885616,38,0
7,1,1.5,97,30,67,0,1.2708853613949,20,0
7,1,1.5,28,67,-39,0,0.895487510515522,-17,0
7,1,1.5,50,18,32,0,1.09550437210055,32,0
7,1,1.5,98,29,69,0,1.37552504586347,21,0
7,1,1.5,94,14,80,0,0.868165881322057,36,0
7,1,1.5,88,27,61,0,0.74072420498851,23,0
7,1,1.5,6,94,-88,0,1.33864326572439,-44,0
7,1,1.5,100,49,51,NaN,NaN,0,0
7,1,1.5,100,23,77,0,0.983965367777273,27,0
7,1,1.5,18,77,-59,0,0.891981400938676,-27,0
7,1,1.5,37,61,-24,0,0.659273962235602,-11,0
7,1,1.5,100,43,57,0,0.884458935630391,7,0
7,1,1.5,41,100,-59,0,0.765154072716541,-50,0
7,1,1.5,23,71,-48,0,1.04185814643643,-21,0
7,1,1.5,57,12,45,0,1.09977841680666,38,0
7,1,1.5,21,68,-47,0,0.915110727451975,-18,0
7,1,1.5,88,40,48,0,1.2823728645817,10,0
7,1,1.5,80,28,52,0,1.09026811749573,22,0
7,1,1.5,17,71,-54,0,0.514231725799618,-21,0
7,1,1.5,38,57,-19,0,0.9696117620515,-7,0
7,1,10,97,7,90,0,2.6850333291186,43,0
7,1,10,82,12,70,0,1.50897494405217,38,0
7,1,10,98,35,63,0,3.91474160540747,15,0
7,1,10,34,56,-22,0,4.24203959172883,-6,0
7,1,10,32,66,-34,0,3.36408739431863,-16,0
7,1,10,94,8,86,0,2.80140134416069,42,0
7,1,10,48,63,-15,1,3.22060888642227,13,0
7,1,10,69,7,62,0,5.67923734327633,43,0
7,1,10,96,10,86,0,3.7525240140094,40,0
7,1,10,17,89,-72,0,4.2457341111658,-39,0
7,1,10,80,36,44,0,3.92715796187258,14,0
7,1,10,14,95,-81,0,3.65374006403727,-45,0
7,1,10,26,57,-31,0,3.45498158971895,-7,0
7,1,10,93,49,44,0,3.76026238089253,1,0
7,1,10,97,27,70,0,5.46160709212927,23,0
7,1,10,67,6,61,0,3.62281812033689,44,0
7,1,10,64,19,45,0,5.48149862816354,31,0
7,1,10,79,8,71,0,3.81007369611325,42,0
7,1,10,96,29,67,0,5.70937925548787,21,0
7,1,10,44,70,-26,0,5.61258057362284,-20,0
7,1,1.5,13,70,-57,0,1.15189720299531,-20,0
7,1,1.5,74,15,59,0,0.845241826256824,35,0
7,1,1.5,62,43,19,0,0.783235921036976,7,0
7,1,1.5,89,23,66,0,0.843205606845004,27,0
7,1,1.5,90,17,73,0,0.861148163829057,33,0
7,1,1.5,38,62,-24,0,0.614511591422342,-12,0
7,1,1.5,41,71,-30,0,0.881754117799574,-21,0
7,1,1.5,3,66,-63,0,0.802337895122037,-16,0
7,1,1.5,93,38,55,0,1.12572509388337,12,0
7,1,1.5,60,36,24,0,0.812404993226664,14,0
7,1,1.5,71,25,46,0,0.871045546435198,25,0
7,1,1.5,89,49,40,0,0.991686506520637,1,0
7,1,1.5,73,39,34,0,0.779666030692169,11,0
7,1,1.5,74,20,54,NaN,NaN,0,0
7,1,1.5,2,96,-94,0,0.615653780383582,-46,0
7,1,1.5,100,14,86,0,1.08219398517758,36,0
7,1,1.5,11,83,-72,0,0.610851528264902,-33,0
7,1,1.5,67,19,48,0,0.542163670987065,31,0
7,1,1.5,85,20,65,0,0.636113478452899,30,0
7,1,1.5,100,35,65,0,0.59013267499904,15,0
7,1,10,86,33,53,0,1.88008848665413,17,0
7,1,10,10,87,-77,0,0.912727745919256,-37,0
7,1,10,68,36,32,0,6.01454934670619,14,0
7,1,10,81,34,47,0,5.11372257930998,16,0
7,1,10,74,42,32,0,4.23305456737944,8,0
7,1,10,7,73,-66,0,1.28306822160084,-23,0
7,1,10,93,15,78,0,3.52159070707057,35,0
7,1,10,7,65,-58,0,2.01628865563544,-15,0
7,1,10,71,38,33,0,5.62546538884999,12,0
7,1,10,58,47,11,1,3.57209701274769,-3,0
7,1,10,44,61,-17,0,2.65602664129983,-11,0
7,1,10,88,33,55,0,3.08933816454373,17,0
7,1,10,49,81,-32,1,1.50532624413609,31,0
7,1,10,23,74,-51,1,2.43116863599062,24,0
7,1,10,93,36,57,0,2.9457731493967,14,0
7,1,10,7,59,-52,0,4.29564549621864,-9,0
7,1,10,92,13,79,0,2.10370496628457,37,0
7,1,10,64,19,45,0,2.27895362881463,31,0
7,1,10,91,46,45,0,3.50358840143235,4,0
7,1,10,49,93,-44,1,2.8228679719723,43,0
7,1,1.5,33,93,-60,0,0.741576814587461,-43,0
7,1,1.5,5,96,-91,0,0.931575696595246,-46,0
7,1,1.5,82,50,32,0,0.858158898423426,0,0
7,1,1.5,77,28,49,0,1.45945394130467,22,0
7,1,1.5,94,8,86,0,1.20399986070697,42,0
7,1,1.5,79,30,49,0,0.919333820849715,20,0
7,1,1.5,15,54,-39,NaN,NaN,0,0
7,1,1.5,78,41,37,0,1.07673816344322,9,0
7,1,1.5,85,22,63,0,0.828704645551625,28,0
7,1,1.5,98,44,54,0,0.695332823823264,6,0
7,1,1.5,95,34,61,0,0.422614681672712,16,0
7,1,1.5,41,74,-33,0,1.17725555744983,-24,0
7,1,1.5,21,59,-38,0,0.861905835390644,-9,0
7,1,1.5,38,58,-20,NaN,NaN,0,0
7,1,1.5,53,12,41,0,0.750507588629262,38,0
7,1,1.5,12,53,-41,0,0.363221955249173,-3,0
7,1,1.5,92,41,51,0,0.312246457691799,9,0
7,1,1.5,81,10,71,0,0.639798833984969,40,0
7,1,1.5,100,36,64,0,0.649784190067294,14,0
7,1,1.5,91,18,73,0,0.538329860213707,32,0
8,1,10,5,83,-78,0,2.20418859106576,-33,0
8,1,10,25,55,-30,0,2.21595051546683,-5,0
8,1,10,48,60,-12,1,2.28316847651513,10,0
8,1,10,75,0,75,0,2.45979344788066,50,0
8,1,10,53,23,30,0,2.61383770905013,27,0
8,1,10,28,85,-57,1,2.39377961053833,35,0
8,1,10,53,23,30,0,2.65437030927933,27,0
8,1,10,53,40,13,1,5.93629360824707,-10,0
8,1,10,30,100,-70,1,2.60684829324236,50,0
8,1,10,50,43,7,0,2.23483088201465,7,0
8,1,10,53,40,13,0,2.17341910652613,10,0
8,1,10,48,100,-52,1,2.21083308133166,50,0
8,1,10,48,80,-32,1,2.63876948453617,30,0
8,1,10,48,100,-52,1,2.27340939289934,50,0
8,1,10,100,0,100,0,1.63463550973756,50,0
8,1,10,53,0,53,0,3.78711569301231,50,0
8,1,10,28,85,-57,1,5.65575294386872,35,0
8,1,10,25,55,-30,0,3.34566964490296,-5,0
8,1,10,98,38,60,1,2.72832843069773,-12,0
8,1,10,50,100,-50,1,2.63958139748138,50,0
8,1,1.5,85,15,70,1,0.950224788088235,-35,0
8,1,1.5,3,100,-97,0,0.836092554411152,-50,0
8,1,1.5,100,15,85,1,0.758715601376025,-35,0
8,1,1.5,3,100,-97,0,0.780739518897462,-50,0
8,1,1.5,100,0,100,0,0.841999541808036,50,0
8,1,1.5,53,0,53,0,1.19668526918758,50,0
8,1,1.5,75,0,75,0,1.12122135166283,50,0
8,1,1.5,50,100,-50,1,1.15259161511858,50,0
8,1,1.5,48,80,-32,1,0.814566414661385,30,0
8,1,1.5,48,60,-12,1,0.721867949596344,10,0
8,1,1.5,85,15,70,NaN,NaN,0,0
8,1,1.5,100,15,85,1,0.880567422678723,-35,0
8,1,1.5,80,45,35,1,0.569743688429298,-5,0
8,1,1.5,98,38,60,1,0.591036701032863,-12,0
8,1,1.5,0,68,-68,0,0.63569704467227,-18,0
8,1,1.5,5,83,-78,0,0.734412462770706,-33,0
8,1,1.5,30,100,-70,1,0.66892792669023,50,0
8,1,1.5,80,45,35,1,0.57430982817823,-5,0
8,1,1.5,0,68,-68,0,0.811609072163264,-18,0
8,1,1.5,50,43,7,0,0.975553906071582,7,0
8,1,10,63,0,63,0,5.72799303551074,50,0
8,1,10,32,70,-38,0,4.39921081328794,-20,0
8,1,10,42,74,-32,1,3.57116407788999,24,0
8,1,10,43,50,-7,0,3.8004376632307,0,0
8,1,10,6,54,-48,0,2.71636636884068,-4,0
8,1,10,27,94,-67,1,3.22754712485403,44,0
8,1,10,60,11,49,0,2.28686405498593,39,0
8,1,10,11,67,-56,0,2.67959019472983,-17,0
8,1,10,17,78,-61,0,3.76080164948507,-28,0
8,1,10,46,83,-37,1,2.98271999999997,33,0
8,1,10,28,95,-67,0,2.55408458190141,-45,0
8,1,10,44,68,-24,1,2.56001612829277,18,0
8,1,10,87,26,61,1,5.02988609392924,-24,0
8,1,10,36,83,-47,1,3.64120815578644,33,0
8,1,10,3,92,-89,0,2.3879217411195,-42,0
8,1,10,49,70,-21,1,1.4325421305839,20,0
8,1,10,4,52,-48,0,5.38560366552338,-2,0
8,1,10,48,75,-27,1,2.95829516609228,25,0
8,1,10,29,71,-42,0,3.82021388316207,-21,0
8,1,10,23,52,-29,0,3.58350918671204,-2,0
8,1,1.5,37,73,-36,1,1.05016998854626,23,0
8,1,1.5,59,7,52,0,0.740068361967133,43,0
8,1,1.5,28,100,-72,1,0.530739243986318,50,0
8,1,1.5,75,31,44,0,0.546044994272961,19,0
8,1,1.5,86,30,56,1,0.768662359678274,-20,0
8,1,1.5,89,29,60,1,0.597948041238851,-21,0
8,1,1.5,63,32,31,1,0.786628545247368,-18,0
8,1,1.5,41,99,-58,1,0.75928339060556,49,0
8,1,1.5,31,54,-23,0,0.89325379152433,-4,0
8,1,1.5,31,94,-63,1,0.669862634593301,44,0
8,1,1.5,17,68,-51,0,0.750609301259828,-18,0
8,1,1.5,46,78,-32,1,0.580528018326731,28,0
8,1,1.5,47,100,-53,1,0.62580710194743,50,0
8,1,1.5,84,9,75,0,0.957184513175889,41,0
8,1,1.5,19,64,-45,0,0.883113127147226,-14,0
8,1,1.5,51,32,19,0,0.747734799540922,18,0
8,1,1.5,13,94,-81,1,0.770391752579599,44,0
8,1,1.5,30,97,-67,1,0.879682199312811,47,0
8,1,1.5,36,91,-55,1,0.800969896907191,41,0
8,1,1.5,18,51,-33,1,0.956934158075455,1,0
8,1,10,60,48,12,1,4.61606561283043,-2,0
8,1,10,87,17,70,1,4.68323518900434,-33,0
8,1,10,50,8,42,0,3.06732279495918,42,0
8,1,10,43,91,-48,1,3.82046387170703,41,0
8,1,10,99,43,56,1,3.19111001145211,-7,0
8,1,10,45,95,-50,1,3.51574323024033,45,0
8,1,10,48,89,-41,1,4.17039578465119,39,0
8,1,10,9,65,-56,0,2.59154254295572,-15,0
8,1,10,93,29,64,1,3.36358231386112,-21,0
8,1,10,48,94,-46,1,2.68156444444321,44,0
8,1,10,35,94,-59,1,3.09019124856786,44,0
8,1,10,96,18,78,1,5.042674730812,-32,0
8,1,10,41,56,-15,1,2.91669846506193,6,0
8,1,10,55,46,9,1,1.39606103092592,-4,0
8,1,10,76,28,48,1,7.11044581901297,-22,0
8,1,10,36,85,-49,1,4.79836884307224,35,0
8,1,10,46,70,-24,1,3.08175028637197,20,0
8,1,10,49,83,-34,1,2.27366341351808,33,0
8,1,10,38,79,-41,1,2.96230634593303,29,0
8,1,10,69,25,44,1,3.93551578465122,-25,0
8,1,1.5,77,42,35,1,0.756226345933101,-8,0
8,1,1.5,36,55,-19,1,0.721485635738645,5,0
8,1,1.5,44,85,-41,1,0.888042153492279,35,0
8,1,1.5,39,92,-53,1,0.672057182131539,42,0
8,1,1.5,0,80,-80,0,0.680688751432172,-30,0
8,1,1.5,95,39,56,1,1.08135037800821,-11,0
8,1,1.5,28,54,-26,0,0.82530089346983,-4,0
8,1,1.5,32,94,-62,1,0.71601924398783,44,0
8,1,1.5,10,97,-87,1,0.730642840779183,47,0
8,1,1.5,23,100,-77,1,0.977212920963211,50,0
8,1,1.5,39,96,-57,1,0.765122199314646,46,0
8,1,1.5,50,96,-46,1,0.673841557847481,46,0
8,1,1.5,48,60,-12,1,0.70655596792858,10,0
8,1,1.5,46,83,-37,1,0.833841924399167,33,0
8,1,1.5,21,75,-54,0,0.995775120274629,-25,0
8,1,1.5,33,76,-43,1,0.831808659793751,26,0
8,1,1.5,62,15,47,0,1.1456953035522,35,0
8,1,1.5,84,30,54,0,0.991669003436982,20,0
8,1,1.5,83,34,49,1,0.755738465060858,-16,0
8,1,1.5,66,9,57,0,0.881003253150993,41,0
8,1,10,84,24,60,1,3.40146877434381,-26,0
8,1,10,55,47,8,1,3.30878460481108,-3,0
8,1,10,1,72,-71,0,2.64406103092551,-22,0
8,1,10,83,19,64,1,3.18996453607906,-31,0
8,1,10,50,80,-30,1,3.00994162657662,30,0
8,1,10,40,70,-30,1,3.22916728522614,20,0
8,1,10,49,62,-13,1,3.02378190148738,12,0
8,1,10,43,84,-41,1,2.7944317067595,34,0
8,1,10,41,90,-49,1,3.4063655441023,40,0
8,1,10,71,42,29,1,3.28170739977213,-8,0
8,1,10,47,75,-28,1,3.08022799541868,25,0
8,1,10,36,77,-41,1,3.79288595647449,27,0
8,1,10,74,37,37,1,2.97286231385806,-13,0
8,1,10,67,5,62,0,2.85738556701108,45,0
8,1,10,3,93,-90,0,3.09870772050272,-43,0
8,1,10,50,92,-42,1,2.86603179839585,42,0
8,1,10,86,50,36,1,3.37051931271344,0,0
8,1,10,38,86,-48,1,3.18323903780038,36,0
8,1,10,88,34,54,1,3.29114391752591,-16,0
8,1,10,52,19,33,0,3.00305264604685,31,0
8,1,1.5,32,83,-51,1,0.654462680413417,33,0
8,1,1.5,47,68,-21,1,0.719701260022703,18,0
8,1,1.5,71,37,34,1,0.878373608247784,-13,0
8,1,1.5,50,38,12,0,1.04703743413484,12,0
8,1,1.5,37,79,-42,1,0.665040641466476,29,0
8,1,1.5,98,19,79,1,0.850345933562494,-31,0
8,1,1.5,26,85,-59,1,1.17160907216385,35,0
8,1,1.5,9,60,-51,0,0.672222130586306,-10,0
8,1,1.5,46,65,-19,1,0.752811546390149,15,0
8,1,1.5,23,56,-33,0,0.686199862542708,-6,0
8,1,1.5,38,82,-44,1,0.901560595648334,32,0
8,1,1.5,38,56,-18,0,0.876796334479877,-6,0
8,1,1.5,99,34,65,1,0.65342203894761,-16,0
8,1,1.5,74,38,36,1,0.622702038945135,-12,0
8,1,1.5,90,12,78,1,0.913354043525032,-38,0
8,1,1.5,8,82,-74,0,0.760676288660761,-32,0
8,1,1.5,43,84,-41,1,1.31801512027596,34,0
8,1,1.5,33,83,-50,1,0.644645315005619,33,0
8,1,1.5,62,15,47,0,0.662556151200988,35,0
8,1,1.5,94,48,46,1,0.511935853377508,-2,0
8,1,10,73,37,36,0,4.28042849942722,13,0
8,1,10,42,78,-36,1,1.92105896907015,28,0
8,1,10,56,33,23,0,2.71968183276113,17,0
8,1,10,60,43,17,1,2.49428783504845,-7,0
8,1,10,92,15,77,1,2.48624788086818,-35,0
8,1,10,45,56,-11,1,3.19814524627873,6,0
8,1,10,42,67,-25,1,2.2254097594523,17,0
8,1,10,76,28,48,1,2.5801075830459,-22,0
8,1,10,30,99,-69,1,2.0161099656325,49,0
8,1,10,2,79,-77,0,2.80918652920809,-29,0
8,1,10,44,85,-41,1,2.97121392898043,35,0
8,1,10,46,77,-31,1,3.18378446735369,27,0
8,1,10,76,35,41,1,3.69900756013885,-15,0
8,1,10,69,24,45,0,2.7623334707896,26,0
8,1,10,90,7,83,0,2.78362575028586,43,0
8,1,10,36,100,-64,1,1.61964499427268,50,0
8,1,10,60,11,49,0,2.90810135165884,39,0
8,1,10,88,45,43,1,1.83543276059572,-5,0
8,1,10,88,16,72,0,2.02062588774425,34,0
8,1,10,44,71,-27,1,2.78988022909471,21,0
8,1,1.5,28,99,-71,0,0.892525452461996,-49,0
8,1,1.5,78,34,44,1,0.916445910650509,-16,0
8,1,1.5,97,46,51,1,0.699134753722319,-4,0
8,1,1.5,47,91,-44,1,0.466435005724634,41,0
8,1,1.5,80,33,47,1,0.722374158074672,-17,0
8,1,1.5,39,96,-57,1,0.688993356241554,46,0
8,1,1.5,12,64,-52,0,0.640302405499824,-14,0
8,1,1.5,22,79,-57,1,0.578367193586018,29,0
8,1,1.5,5,59,-54,0,0.606350882015249,-9,0
8,1,1.5,95,47,48,1,0.657581672392553,-3,0
8,1,1.5,71,39,32,1,0.650290217639849,-11,0
8,1,1.5,36,62,-26,1,0.946778831614211,12,0
8,1,1.5,37,97,-60,1,1.43219573883107,47,0
8,1,1.5,34,94,-60,1,0.729457777779317,44,0
8,1,1.5,0,52,-52,0,0.736065979381237,-2,0
8,1,1.5,28,85,-57,0,1.06139381443427,-35,0
8,1,1.5,71,12,59,0,0.774689576173841,38,0
8,1,1.5,44,76,-32,1,0.675294936998398,26,0
8,1,1.5,27,53,-26,0,0.81930996563824,-3,0
8,1,1.5,15,62,-47,0,0.638000458191527,-12,0
9,1,10,53,40,13,0,4.05505345158963,10,0
9,1,10,100,15,85,0,3.8889745007109,35,0
9,1,10,53,0,53,0,4.2737361422478,50,0
9,1,10,53,23,30,0,4.21917607867363,27,0
9,1,10,0,68,-68,0,4.19066221029061,-18,0
9,1,10,48,100,-52,0,4.03547811717726,-50,0
9,1,10,85,15,70,0,4.66221908773878,35,0
9,1,10,98,38,60,0,4.55235411330068,12,0
9,1,10,5,83,-78,0,5.07836035360015,-33,0
9,1,10,80,45,35,0,4.99188219096322,5,0
9,1,10,3,100,-97,0,4.86869757294335,-50,0
9,1,10,75,0,75,0,4.71013564138411,50,0
9,1,10,25,55,-30,0,5.08632347485764,-5,0
9,1,10,5,83,-78,0,6.14303010619915,-33,0
9,1,10,50,100,-50,1,5.72588117046325,50,0
9,1,10,28,85,-57,0,4.5573920961142,-35,0
9,1,10,30,100,-70,0,4.27552091657344,-50,0
9,1,10,48,60,-12,1,4.37301233543258,10,0
9,1,10,80,45,35,0,4.29042042816945,5,0
9,1,10,48,80,-32,1,4.17119867628571,30,0
9,1,1.5,100,0,100,0,0.751490427683166,50,0
9,1,1.5,30,100,-70,0,0.781508652984485,-50,0
9,1,1.5,50,100,-50,0,0.778860632915894,-50,0
9,1,1.5,28,85,-57,0,1.05621214364874,-35,0
9,1,1.5,48,80,-32,1,0.882304965110961,30,0
9,1,1.5,100,15,85,0,0.85098912200192,35,0
9,1,1.5,48,100,-52,1,0.709070788347162,50,0
9,1,1.5,98,38,60,0,0.909111036497052,12,0
9,1,1.5,53,23,30,1,1.05316640738602,-27,0
9,1,1.5,50,43,7,1,1.49523253751249,-7,0
9,1,1.5,0,68,-68,0,0.855909072914073,-18,0
9,1,1.5,53,0,53,0,1.12998391540532,50,0
9,1,1.5,53,40,13,0,1.26604427442726,10,0
9,1,1.5,25,55,-30,0,0.875435655019828,-5,0
9,1,1.5,85,15,70,0,0.844840832880436,35,0
9,1,1.5,3,100,-97,0,0.791525602657202,-50,0
9,1,1.5,50,43,7,0,0.908232761841646,7,0
9,1,1.5,48,60,-12,1,1.02021314655212,10,0
9,1,1.5,100,0,100,0,0.687677322770469,50,0
9,1,1.5,75,0,75,0,0.800382027482556,50,0
9,1,10,59,47,12,0,4.14799917597702,3,0
9,1,10,40,67,-27,NaN,NaN,0,0
9,1,10,52,11,41,0,3.75041274509931,39,0
9,1,10,86,48,38,0,2.91642021702864,2,0
9,1,10,28,86,-58,0,3.21183867311629,-36,0
9,1,10,82,20,62,0,2.87192109017633,30,0
9,1,10,97,33,64,0,2.60135384791283,17,0
9,1,10,64,31,33,0,2.90946439908657,19,0
9,1,10,26,75,-49,0,3.78949633368029,-25,0
9,1,10,2,92,-90,0,3.9142424917809,-42,0
9,1,10,60,49,11,0,3.84974502176556,1,0
9,1,10,15,76,-61,0,3.81982466764021,-26,0
9,1,10,44,63,-19,0,3.05523233223721,-13,0
9,1,10,9,64,-55,0,3.68943643798775,-14,0
9,1,10,41,97,-56,1,2.90616170517023,47,0
9,1,10,21,90,-69,0,2.28225863209082,-40,0
9,1,10,4,84,-80,0,2.04302922645729,-34,0
9,1,10,81,43,38,0,2.1337895278557,7,0
9,1,10,91,46,45,0,3.04446503689906,4,0
9,1,10,72,37,35,0,3.19122451134172,13,0
9,1,1.5,66,23,43,0,0.839464149823471,27,0
9,1,1.5,91,9,82,0,0.618142603067099,41,0
9,1,1.5,2,97,-95,0,0.789456378781324,-47,0
9,1,1.5,92,16,76,0,0.882247415393067,34,0
9,1,1.5,57,18,39,0,0.787566768667602,32,0
9,1,1.5,80,41,39,0,0.696308313992631,9,0
9,1,1.5,44,57,-13,1,1.22507584099367,7,0
9,1,1.5,94,43,51,0,0.604438072838093,7,0
9,1,1.5,74,42,32,0,0.912479710976186,8,0
9,1,1.5,23,89,-66,0,0.68853763604784,-39,0
9,1,1.5,40,63,-23,0,0.871976807095052,-13,0
9,1,1.5,98,4,94,0,0.66529488181186,46,0
9,1,1.5,85,23,62,0,0.611342206011614,27,0
9,1,1.5,9,85,-76,0,0.631400664791727,-35,0
9,1,1.5,12,72,-60,0,0.642769482961739,-22,0
9,1,1.5,7,75,-68,0,0.533530957349285,-25,0
9,1,1.5,89,46,43,0,0.588218949913426,4,0
9,1,1.5,100,23,77,0,0.760934446105239,27,0
9,1,1.5,10,66,-56,0,0.638947741925222,-16,0
9,1,1.5,7,59,-52,0,0.50566479819463,-9,0
9,1,10,97,7,90,0,0.890559500541713,43,0
9,1,10,27,91,-64,0,3.71401529869399,-41,0
9,1,10,78,4,74,0,3.08947404690844,46,0
9,1,10,94,32,62,0,2.92228698907275,18,0
9,1,10,65,40,25,0,2.84152750876456,10,0
9,1,10,87,29,58,0,2.51642586203525,21,0
9,1,10,62,22,40,0,2.52380065658144,28,0
9,1,10,63,47,16,0,2.29924239647153,3,0
9,1,10,38,76,-38,0,2.32325785645298,-26,0
9,1,10,12,81,-69,0,2.33877905160989,-31,0
9,1,10,23,79,-56,0,2.18298463826068,-29,0
9,1,10,40,55,-15,1,3.74772843571554,5,0
9,1,10,83,49,34,0,2.91385650546727,1,0
9,1,10,47,91,-44,1,2.65790065966212,41,0
9,1,10,66,29,37,0,3.21132622404912,21,0
9,1,10,34,78,-44,0,3.5034845070295,-28,0
9,1,10,68,35,33,0,2.90288723627964,15,0
9,1,10,95,13,82,0,3.07894134914022,37,0
9,1,10,95,47,48,0,2.96842353365355,3,0
9,1,10,3,84,-81,0,2.64581778513457,-34,0
9,1,1.5,74,45,29,0,0.575321948508645,5,0
9,1,1.5,4,51,-47,0,0.556641750448762,-1,0
9,1,1.5,52,18,34,0,1.27403158856396,32,0
9,1,1.5,14,71,-57,0,0.643436619800923,-21,0
9,1,1.5,85,27,58,0,0.605523453155911,23,0
9,1,1.5,61,38,23,0,0.593581337176147,12,0
9,1,1.5,99,47,52,0,0.55763255862621,3,0
9,1,1.5,91,4,87,0,0.482945856347214,46,0
9,1,1.5,4,75,-71,0,0.475039185123023,-25,0
9,1,1.5,94,28,66,0,0.563662815846328,22,0
9,1,1.5,76,47,29,0,0.50449254346313,3,0
9,1,1.5,47,81,-34,1,1.44787022062519,31,0
9,1,1.5,68,39,29,0,0.75388772160295,11,0
9,1,1.5,87,47,40,0,0.639935617626179,3,0
9,1,1.5,16,89,-73,0,0.585954716807464,-39,0
9,1,1.5,35,78,-43,0,0.549988709994068,-28,0
9,1,1.5,58,43,15,0,0.891402952114731,7,0
9,1,1.5,48,80,-32,1,1.05151835945799,30,0
9,1,1.5,51,2,49,0,1.05290285167939,48,0
9,1,1.5,39,75,-36,0,0.5422235304286,-25,0
9,1,10,96,24,72,0,3.5916103510317,26,0
9,1,10,21,98,-77,0,3.49984494566888,-48,0
9,1,10,86,40,46,0,3.34723116218083,10,0
9,1,10,90,19,71,0,2.94530504282011,31,0
9,1,10,86,49,37,0,3.61545169562669,1,0
9,1,10,27,96,-69,0,3.33814417193935,-46,0
9,1,10,97,16,81,0,3.83229132912675,34,0
9,1,10,46,97,-51,1,3.75434298751134,47,0
9,1,10,32,60,-28,0,3.73582260904732,-10,0
9,1,10,97,13,84,0,3.86194226260341,37,0
9,1,10,93,24,69,0,3.38272834040981,26,0
9,1,10,89,12,77,0,3.4748056872304,38,0
9,1,10,55,34,21,0,3.45156549890817,16,0
9,1,10,43,81,-38,1,3.11696741586275,31,0
9,1,10,65,49,16,0,3.02776095680383,1,0
9,1,10,4,79,-75,0,3.29455264442731,-29,0
9,1,10,50,71,-21,1,3.32660050526465,21,0
9,1,10,24,89,-65,0,3.3493513377216,-39,0
9,1,10,30,68,-38,0,3.2908511346468,-18,0
9,1,10,2,86,-84,0,3.53888381408979,-36,0
9,1,1.5,54,30,24,0,0.763030062211328,20,0
9,1,1.5,48,60,-12,1,0.880475104066136,10,0
9,1,1.5,83,43,40,0,0.569218012988131,7,0
9,1,1.5,43,70,-27,1,0.869920046214247,20,0
9,1,1.5,34,59,-25,0,0.774644108154462,-9,0
9,1,1.5,78,43,35,0,0.635287286717357,7,0
9,1,1.5,94,24,70,0,0.485420494151185,26,0
9,1,1.5,77,15,62,0,0.45348516683589,35,0
9,1,1.5,22,95,-73,0,0.422864319029031,-45,0
9,1,1.5,85,49,36,0,0.425553393673908,1,0
9,1,1.5,79,30,49,0,0.555615386081627,20,0
9,1,1.5,12,59,-47,0,0.481012259187992,-9,0
9,1,1.5,6,92,-86,0,0.449633734540839,-42,0
9,1,1.5,47,92,-45,1,0.867004804851604,42,0
9,1,1.5,46,57,-11,1,0.691739892874466,7,0
9,1,1.5,98,11,87,0,0.723851901486341,39,0
9,1,1.5,65,40,25,0,0.594561881705886,10,0
9,1,1.5,71,48,23,0,0.462631906149909,2,0
9,1,1.5,23,81,-58,0,0.479995425346715,-31,0
9,1,1.5,100,11,89,0,0.400665890538221,39,0
9,1,10,77,40,37,0,3.21011731344697,10,0
9,1,10,95,34,61,0,3.24552688414769,16,0
9,1,10,32,63,-31,0,3.23160168558388,-13,0
9,1,10,2,73,-71,0,3.33034123682592,-23,0
9,1,10,57,40,17,0,3.10514113243335,10,0
9,1,10,9,93,-84,0,3.56054266816864,-43,0
9,1,10,85,15,70,0,3.45392320448445,35,0
9,1,10,49,64,-15,1,3.83939193776314,14,0
9,1,10,78,40,38,0,3.74553128285334,10,0
9,1,10,84,24,60,0,3.99968146048923,26,0
9,1,10,26,94,-68,0,3.18638630301939,-44,0
9,1,10,21,68,-47,0,3.65445280849963,-18,0
9,1,10,64,1,63,0,3.56795081954988,49,0
9,1,10,92,34,58,0,3.90066295806901,16,0
9,1,10,41,58,-17,1,3.90019816163476,8,0
9,1,10,93,41,52,0,3.99564308325716,9,0
9,1,10,52,6,46,0,3.8236665694094,44,0
9,1,10,6,77,-71,0,3.48245210177629,-27,0
9,1,10,100,46,54,0,3.61126449556468,4,0
9,1,10,94,29,65,0,3.44667487269544,21,0
9,1,1.5,89,30,59,0,0.633550165024644,20,0
9,1,1.5,100,48,52,0,0.491577580683952,2,0
9,1,1.5,59,2,57,0,0.491669953476958,48,0
9,1,1.5,93,25,68,0,0.491695246026211,25,0
9,1,1.5,6,68,-62,0,0.491722004811891,-18,0
9,1,1.5,10,79,-69,0,0.467813213414047,-29,0
9,1,1.5,32,52,-20,0,0.492456221894827,-2,0
9,1,1.5,33,84,-51,0,0.420602285274072,-34,0
9,1,1.5,39,72,-33,0,0.455173169662885,-22,0
9,1,1.5,8,89,-81,0,0.448647691635415,-39,0
9,1,1.5,99,30,69,0,0.43407881598614,20,0
9,1,1.5,8,59,-51,0,0.371395078436763,-9,0
9,1,1.5,97,25,72,0,0.328060875137453,25,0
9,1,1.5,62,22,40,0,0.302802781156061,28,0
9,1,1.5,83,29,54,0,0.317542106597102,21,0
9,1,1.5,14,63,-49,0,0.291565557556169,-13,0
9,1,1.5,29,98,-69,0,0.170943917983095,-48,0
9,1,1.5,65,13,52,0,0.35899366439844,37,0
9,1,1.5,96,38,58,0,0.420364755231276,12,0
9,1,1.5,98,22,76,0,0.374393162066553,28,0
10,1,10,48,60,-12,1,2.33693983963531,10,0
10,1,10,30,100,-70,0,1.39201979381323,-50,0
10,1,10,100,15,85,0,2.83662515463948,35,0
10,1,10,98,38,60,1,2.0552401374589,-12,0
10,1,10,3,100,-97,0,1.10525397479796,-50,0
10,1,10,53,40,13,1,2.8958046277221,-10,0
10,1,10,5,83,-78,0,3.56827967926438,-33,0
10,1,10,48,80,-32,0,3.05357305841972,-30,0
10,1,10,53,40,13,1,3.20748389461733,-10,0
10,1,10,50,100,-50,0,4.29117617411248,-50,0
10,1,10,53,23,30,1,3.99604050401103,-27,0
10,1,10,30,100,-70,0,4.4806913172979,-50,0
10,1,10,48,100,-52,0,2.58603656357081,-50,0
10,1,10,50,43,7,1,2.18259390607273,-7,0
10,1,10,100,0,100,0,1.75526744559102,50,0
10,1,10,50,100,-50,0,2.31180939289698,-50,0
10,1,10,53,0,53,0,3.37582991981981,50,0
10,1,10,0,68,-68,0,3.40501333333305,-18,0
10,1,10,100,0,100,0,3.77685699885478,50,0
10,1,10,80,45,35,1,2.99024934707631,-5,0
10,1,1.5,48,60,-12,1,1.25618437571393,10,0
10,1,1.5,75,0,75,0,1.26614432989663,50,0
10,1,1.5,28,85,-57,0,1.43543166093878,-35,0
10,1,1.5,0,68,-68,0,1.26213864834062,-18,0
10,1,1.5,50,43,7,1,0.808074776632566,-7,0
10,1,1.5,25,55,-30,1,1.42799138602277,5,0
10,1,1.5,85,15,70,NaN,NaN,0,0
10,1,1.5,3,100,-97,0,0.934650721650542,-50,0
10,1,1.5,100,15,85,0,0.829285681556939,35,0
10,1,1.5,48,100,-52,0,0.904623138601892,-50,0
10,1,1.5,25,55,-30,1,0.720564856816054,5,0
10,1,1.5,53,0,53,1,0.879868041236477,-50,0
10,1,1.5,75,0,75,0,1.00920339060394,50,0
10,1,1.5,53,23,30,1,0.99709397479819,-27,0
10,1,1.5,98,38,60,1,0.921750652920309,-12,0
10,1,1.5,80,45,35,1,0.969005819013546,-5,0
10,1,1.5,85,15,70,0,1.03821892325141,35,0
10,1,1.5,5,83,-78,0,1.14486359679358,-33,0
10,1,1.5,48,80,-32,1,1.25564077892341,30,0
10,1,1.5,28,85,-57,0,1.49749040091774,-35,0
10,1,10,28,63,-35,0,1.85277580756156,-13,0
10,1,10,87,30,57,1,1.28671193585251,-20,0
10,1,10,95,12,83,0,3.24580398625403,38,0
10,1,10,45,98,-53,0,2.66450950744547,-48,0
10,1,10,64,23,41,0,3.61038295532853,27,0
10,1,10,79,38,41,1,1.79831276059485,-12,0
10,1,10,100,5,95,0,2.94469424971248,45,0
10,1,10,97,23,74,0,3.75137979381543,27,0
10,1,10,3,73,-70,0,3.7014341351678,-23,0
10,1,10,51,25,26,1,3.2453674226781,-25,0
10,1,10,49,72,-23,1,2.36609612829125,22,0
10,1,10,67,21,46,1,2.40322126002138,-29,0
10,1,10,50,6,44,0,2.75919175257877,44,0
10,1,10,44,66,-22,1,3.17326808705548,16,0
10,1,10,36,62,-26,0,3.5064368384883,-12,0
10,1,10,6,65,-59,0,3.91442510881825,-15,0
10,1,10,45,69,-24,0,3.72962235968225,-19,0
10,1,10,58,50,8,1,2.26509562428328,0,0
10,1,10,79,27,52,1,3.21816632302216,-23,0
10,1,10,48,69,-21,1,3.15746785796,19,0
10,1,1.5,13,88,-75,0,0.754072485680808,-38,0
10,1,1.5,12,68,-56,0,0.960108132876485,-18,0
10,1,1.5,49,67,-18,1,1.03809539518625,17,0
10,1,1.5,11,59,-48,0,0.808764627719938,-9,0
10,1,1.5,37,91,-54,0,1.38873182130556,-41,0
10,1,1.5,5,80,-75,0,0.833383367698843,-30,0
10,1,1.5,78,4,74,0,1.13999321878873,46,0
10,1,1.5,100,18,82,0,1.27470845360949,32,0
10,1,1.5,100,6,94,0,0.835882153496641,44,0
10,1,1.5,48,64,-16,1,1.11058474226593,14,0
10,1,1.5,13,65,-52,0,0.741242794960272,-15,0
10,1,1.5,98,17,81,0,1.13987335624188,33,0
10,1,1.5,17,71,-54,0,1.40249878579561,-21,0
10,1,1.5,49,52,-3,1,1.00643005727397,2,0
10,1,1.5,28,64,-36,0,1.21038002291243,-14,0
10,1,1.5,98,0,98,0,0.854374341353832,50,0
10,1,1.5,43,61,-18,1,0.984383046965377,11,0
10,1,1.5,61,33,28,1,1.07701260022804,-17,0
10,1,1.5,86,9,77,0,0.990264742267755,41,0
10,1,1.5,50,81,-31,NaN,NaN,0,0
10,1,10,47,56,-9,0,1.19741434134994,-6,0
10,1,10,13,65,-52,0,3.06442483390492,-15,0
10,1,10,25,55,-30,1,2.69047129438695,5,0
10,1,10,21,99,-78,0,2.23514648339187,-49,0
10,1,10,26,54,-28,0,2.35712476517801,-4,0
10,1,10,12,83,-71,0,1.97112925543843,-33,0
10,1,10,82,40,42,1,1.7123573883182,-10,0
10,1,10,65,41,24,1,1.5523320962202,-9,0
10,1,10,41,61,-20,1,1.87032998854556,11,0
10,1,10,41,82,-41,0,1.79957919816661,-32,0
10,1,10,97,18,79,0,2.53748050400827,32,0
10,1,10,7,81,-74,0,3.89603885452379,-31,0
10,1,10,48,64,-16,1,2.90463120274944,14,0
10,1,10,18,50,-32,0,3.28857182130378,0,0
10,1,10,97,10,87,0,3.30457512027351,40,0
10,1,10,7,87,-80,0,2.64047248568386,-37,0
10,1,10,83,36,47,1,2.3784357388322,-14,0
10,1,10,63,34,29,1,2.27105246277279,-16,0
10,1,10,73,1,72,0,2.11169722794875,49,0
10,1,10,40,61,-21,1,2.67963088201577,11,0
10,1,1.5,96,21,75,0,0.710913906070346,29,0
10,1,1.5,72,37,35,1,0.76690620847512,-13,0
10,1,1.5,44,58,-14,1,0.843588545245439,8,0
10,1,1.5,64,47,17,1,0.965545567010849,-3,0
10,1,1.5,13,82,-69,0,0.778191615117976,-32,0
10,1,1.5,41,61,-20,1,0.831478762884217,11,0
10,1,1.5,72,47,25,1,1.073394364259,-3,0
10,1,1.5,91,13,78,0,0.922055990835361,37,0
10,1,1.5,82,46,36,0,1.28075619702213,4,0
10,1,1.5,51,1,50,0,1.00939253150136,49,0
10,1,1.5,97,24,73,0,1.35599138602629,26,0
10,1,1.5,81,33,48,0,0.945268270334054,17,0
10,1,1.5,47,89,-42,1,0.815146300115885,39,0
10,1,1.5,10,93,-83,0,0.641836426115333,-43,0
10,1,1.5,78,11,67,0,0.803908911799226,39,0
10,1,1.5,90,12,78,0,0.823184788088838,38,0
10,1,1.5,37,65,-28,0,1.01778327606007,-15,0
10,1,1.5,50,66,-16,1,0.996476701027859,16,0
10,1,1.5,45,58,-13,1,0.776371683848993,8,0
10,1,1.5,82,46,36,0,0.797036426116392,4,0
10,1,10,33,100,-67,0,0.968217731959157,-50,0
10,1,10,97,5,92,0,2.59530630011432,45,0
10,1,10,57,49,8,1,2.87133580756199,-1,0
10,1,10,41,61,-20,0,2.95195344788226,-11,0
10,1,10,56,30,26,0,3.38924352806498,20,0
10,1,10,54,14,40,0,2.20908756013887,36,0
10,1,10,54,3,51,0,3.22843161511992,47,0
10,1,10,32,89,-57,0,1.84710378007003,-39,0
10,1,10,51,22,29,0,2.16904027491546,28,0
10,1,10,92,18,74,0,1.65363830469869,32,0
10,1,10,95,8,87,0,2.01288394043513,42,0
10,1,10,89,16,73,0,3.22259940435106,34,0
10,1,10,65,8,57,0,2.86528659793839,42,0
10,1,10,23,65,-42,0,2.70585255441256,-15,0
10,1,10,13,69,-56,0,3.01715757159036,-19,0
10,1,10,72,24,48,0,2.6118290034392,26,0
10,1,10,100,21,79,0,1.80711990836062,29,0
10,1,10,12,93,-81,0,2.39435693012638,-43,0
10,1,10,64,23,41,0,2.83035821305748,27,0
10,1,10,81,15,66,0,2.42495010309358,35,0
10,1,1.5,64,43,21,1,1.16558295532377,-7,0
10,1,1.5,44,55,-11,1,1.12224733104449,5,0
10,1,1.5,94,12,82,0,0.976865429554891,38,0
10,1,1.5,74,24,50,0,0.837506712487084,26,0
10,1,1.5,95,16,79,0,0.839448705613904,34,0
10,1,1.5,2,90,-88,0,0.689451912945515,-40,0
10,1,1.5,19,70,-51,0,0.921404994274781,-20,0
10,1,1.5,99,21,78,0,0.735993402060558,29,0
10,1,1.5,66,41,25,1,0.813991294387961,-9,0
10,1,1.5,14,96,-82,0,0.673384833906312,-46,0
10,1,1.5,100,25,75,0,0.552605177548685,25,0
10,1,1.5,44,100,-56,0,0.829950240549806,-50,0
10,1,1.5,97,17,80,0,0.832557159221324,33,0
10,1,1.5,40,71,-31,0,0.938520045820042,-21,0
10,1,1.5,68,9,59,0,0.896445360824146,41,0
10,1,1.5,99,11,88,0,0.680482016035967,39,0
10,1,1.5,64,15,49,0,0.85715573883499,35,0
10,1,1.5,31,65,-34,NaN,NaN,0,0
10,1,1.5,9,75,-66,0,0.865796471935028,-25,0
10,1,1.5,82,14,68,0,0.738363161512098,36,0
10,1,10,69,25,44,0,3.31747189003727,25,0
10,1,10,88,13,75,0,2.51608925544133,37,0
10,1,10,78,40,38,1,1.89076123711493,-10,0
10,1,10,97,23,74,0,2.70522794959834,27,0
10,1,10,18,81,-63,0,2.71247541809862,-31,0
10,1,10,47,61,-14,1,2.40776577319775,11,0
10,1,10,22,80,-58,0,3.12165315005768,-30,0
10,1,10,9,52,-43,0,2.82427491408816,-2,0
10,1,10,18,69,-51,0,3.86690272622945,-19,0
10,1,10,25,70,-45,0,3.09155775486579,-20,0
10,1,10,97,21,76,0,2.95416962199306,29,0
10,1,10,91,10,81,0,2.64738052691609,40,0
10,1,10,31,74,-43,1,2.86535660939262,24,0
10,1,10,86,5,81,0,2.39398781214186,45,0
10,1,10,63,42,21,1,2.09386520045882,-8,0
10,1,10,98,0,98,0,2.45318671248606,50,0
10,1,10,49,90,-41,0,2.87055505154785,-40,0
10,1,10,0,77,-77,0,2.77513090492357,-27,0
10,1,10,57,31,26,1,2.53970107674832,-19,0
10,1,10,96,2,94,0,2.90575615120542,48,0
10,1,1.5,69,9,60,0,1.16236756014041,41,0
10,1,1.5,12,100,-88,0,0.743687331043475,-50,0
10,1,1.5,50,41,9,1,0.813628041240008,-9,0
10,1,1.5,46,58,-12,1,0.800199404351588,8,0
10,1,1.5,97,10,87,0,0.579495441008476,40,0
10,1,1.5,68,20,48,0,0.856125360827718,30,0
10,1,1.5,47,89,-42,0,0.913511660939548,-39,0
10,1,1.5,50,84,-34,1,0.688774891179492,34,0
10,1,1.5,27,81,-54,0,0.640763894614793,-31,0
10,1,1.5,96,24,72,0,0.690672531502059,26,0
10,1,1.5,97,15,82,0,0.769411958761339,35,0
10,1,1.5,63,16,47,0,0.853305475371599,34,0
10,1,1.5,47,61,-14,1,0.78270313860412,11,0
10,1,1.5,16,71,-55,0,0.55460178694193,-21,0
10,1,1.5,36,85,-49,1,0.647277892327111,35,0
10,1,1.5,95,10,85,0,0.713234180984728,40,0
10,1,1.5,93,18,75,0,0.824546529209329,32,0
10,1,1.5,98,14,84,0,0.531113127144636,36,0
10,1,1.5,88,18,70,0,0.777065933561971,32,0
10,1,1.5,67,39,28,1,0.613159587628616,-11,0
11,1,10,5,83,-78,0,3.46424325953922,-33,0
11,1,10,28,85,-57,0,3.51334126310576,-35,0
11,1,10,98,38,60,1,3.82522107755722,-12,0
11,1,10,3,100,-97,0,3.47656678695785,-50,0
11,1,10,48,80,-32,1,3.63785984095193,30,0
11,1,10,48,60,-12,0,3.61644725387305,-10,0
11,1,10,0,68,-68,0,4.53972321548099,-18,0
11,1,10,48,100,-52,1,4.2983089055997,50,0
11,1,10,53,40,13,1,3.81819791320959,-10,0
11,1,10,48,80,-32,1,4.4854989617379,30,0
11,1,10,53,40,13,1,4.67808615105969,-10,0
11,1,10,85,15,70,1,5.71939269422364,-35,0
11,1,10,53,23,30,1,4.87869866189612,-27,0
11,1,10,0,68,-68,0,4.80788639774983,-18,0
11,1,10,98,38,60,1,4.43587642016428,-12,0
11,1,10,53,0,53,0,4.30250191066079,50,0
11,1,10,50,43,7,0,4.34234150686461,7,0
11,1,10,50,43,7,0,4.4209444983062,7,0
11,1,10,75,0,75,1,4.59231484010161,-50,0
11,1,10,5,83,-78,0,4.46090029195875,-33,0
11,1,1.5,100,0,100,1,0.737621031372328,-50,0
11,1,1.5,48,100,-52,1,1.00814848347727,50,0
11,1,1.5,30,100,-70,0,0.900056265954845,-50,0
11,1,1.5,50,100,-50,1,0.892099123388107,50,0
11,1,1.5,25,55,-30,0,0.996705050922174,-5,0
11,1,1.5,53,23,30,1,1.15333701108648,-27,0
11,1,1.5,75,0,75,NaN,NaN,0,0
11,1,1.5,80,45,35,1,0.702705347830488,-5,0
11,1,1.5,50,100,-50,1,0.630552231119509,50,0
11,1,1.5,53,0,53,1,0.913867633878908,-50,0
11,1,1.5,80,45,35,1,0.641881665545952,-5,0
11,1,1.5,3,100,-97,0,0.700502728073843,-50,0
11,1,1.5,100,15,85,1,0.68454115753957,-35,0
11,1,1.5,48,60,-12,1,0.997152979254679,10,0
11,1,1.5,30,100,-70,0,0.801726466808759,-50,0
11,1,1.5,100,15,85,1,0.893762909554425,-35,0
11,1,1.5,85,15,70,1,0.646332357689971,-35,0
11,1,1.5,28,85,-57,0,0.776917028792013,-35,0
11,1,1.5,100,0,100,1,0.638239590338344,-50,0
11,1,1.5,25,55,-30,0,0.864957672238233,-5,0
11,1,10,31,91,-60,0,3.36340256917356,-41,0
11,1,10,2,59,-57,0,2.52156892213134,-9,0
11,1,10,48,97,-49,1,3.36873152341286,47,0
11,1,10,78,4,74,1,3.14198411723737,-46,0
11,1,10,95,36,59,1,2.30046827204751,-14,0
11,1,10,26,81,-55,0,3.77089455539863,-31,0
11,1,10,49,85,-36,1,3.61629256831111,35,0
11,1,10,51,8,43,0,3.98751665527379,42,0
11,1,10,47,77,-30,1,4.64021641316322,27,0
11,1,10,96,48,48,1,4.6028371238026,-2,0
11,1,10,47,87,-40,1,3.74814441473427,37,0
11,1,10,25,53,-28,0,3.87465667686229,-3,0
11,1,10,27,84,-57,0,4.07600669326712,-34,0
11,1,10,12,75,-63,0,4.18135745743893,-25,0
11,1,10,41,54,-13,0,3.76254886615789,-4,0
11,1,10,1,93,-92,0,3.79250911343661,-43,0
11,1,10,77,29,48,1,3.98912765774185,-21,0
11,1,10,44,99,-55,1,3.80171656986568,49,0
11,1,10,44,73,-29,0,3.74167364645473,-23,0
11,1,10,55,12,43,1,3.86822842878792,-38,0
11,1,1.5,71,2,69,1,0.858281634022205,-48,0
11,1,1.5,50,72,-22,1,0.668105999930049,22,0
11,1,1.5,49,77,-28,1,0.821485531218059,27,0
11,1,1.5,6,65,-59,0,0.656808822208404,-15,0
11,1,1.5,72,24,48,1,0.626821083422328,-26,0
11,1,1.5,63,13,50,1,0.902135357197039,-37,0
11,1,1.5,28,82,-54,0,1.02211600317423,-32,0
11,1,1.5,46,73,-27,0,0.833386422493277,-23,0
11,1,1.5,80,37,43,1,0.564019845203802,-13,0
11,1,1.5,49,91,-42,1,0.769968274797066,41,0
11,1,1.5,84,11,73,1,0.701294483553283,-39,0
11,1,1.5,69,34,35,1,0.685302122526991,-16,0
11,1,1.5,11,97,-86,0,0.565995568367725,-47,0
11,1,1.5,48,76,-28,1,0.723305285884635,26,0
11,1,1.5,20,76,-56,0,0.602564041471851,-26,0
11,1,1.5,49,70,-21,1,0.942482263393686,20,0
11,1,1.5,47,94,-47,1,1.02112520916489,44,0
11,1,1.5,87,49,38,1,0.88851386396891,-1,0
11,1,1.5,52,32,20,1,0.585089704796701,-18,0
11,1,1.5,46,97,-51,0,0.837748775253203,-47,0
11,1,10,100,31,69,1,0.885047367870357,-19,0
11,1,10,42,63,-21,0,2.8121230226734,-13,0
11,1,10,48,77,-29,1,2.94409473207816,27,0
11,1,10,87,44,43,1,3.31872263449441,-6,0
11,1,10,48,82,-34,1,3.66201974623436,32,0
11,1,10,50,100,-50,1,3.35192981234286,50,0
11,1,10,41,55,-14,0,3.42192759469435,-5,0
11,1,10,99,33,66,1,3.54511704968536,-17,0
11,1,10,73,45,28,1,3.77505420409398,-5,0
11,1,10,44,51,-7,0,3.59629707691965,-1,0
11,1,10,73,8,65,1,3.91167601072448,-42,0
11,1,10,59,28,31,1,3.75164060166026,-22,0
11,1,10,59,14,45,1,3.7889392492616,-36,0
11,1,10,48,86,-38,1,3.75276152214974,36,0
11,1,10,93,18,75,1,3.63811899425127,-32,0
11,1,10,49,98,-49,1,3.48863775903737,48,0
11,1,10,58,25,33,1,3.70467190715863,-25,0
11,1,10,49,67,-18,1,3.79263264195288,17,0
11,1,10,15,78,-63,0,3.99651957487004,-28,0
11,1,10,50,40,10,0,3.83249239859833,10,0
11,1,1.5,4,55,-51,0,0.6538151800778,-5,0
11,1,1.5,3,59,-56,0,0.631058074897737,-9,0
11,1,1.5,4,78,-74,0,0.505769368226538,-28,0
11,1,1.5,41,72,-31,0,0.857046348852236,-22,0
11,1,1.5,19,70,-51,0,0.698355091335543,-20,0
11,1,1.5,48,96,-48,1,0.850335854609511,46,0
11,1,1.5,66,29,37,1,0.899555920479543,-21,0
11,1,1.5,49,78,-29,1,0.794932764931218,28,0
11,1,1.5,48,85,-37,1,0.774854432454958,35,0
11,1,1.5,100,6,94,1,0.883776893568211,-44,0
11,1,1.5,74,37,37,1,0.626830613811762,-13,0
11,1,1.5,49,92,-43,1,0.718091429431297,42,0
11,1,1.5,86,20,66,1,0.852766470621646,-30,0
11,1,1.5,49,68,-19,1,0.686066753050909,18,0
11,1,1.5,46,58,-12,1,0.926035742628301,8,0
11,1,1.5,77,23,54,1,0.612693013308672,-27,0
11,1,1.5,48,77,-29,1,0.823971130250357,27,0
11,1,1.5,54,17,37,1,0.818614317944593,-33,0
11,1,1.5,76,49,27,1,0.637292782746954,-1,0
11,1,1.5,27,69,-42,0,0.639203625945811,-19,0
11,1,10,33,84,-51,0,3.17982159843086,-34,0
11,1,10,93,15,78,1,3.15244628617256,-35,0
11,1,10,30,89,-59,0,3.02967140314831,-39,0
11,1,10,49,98,-49,1,3.32025519452145,48,0
11,1,10,74,9,65,1,3.37484820104692,-41,0
11,1,10,93,42,51,1,3.36357448274612,-8,0
11,1,10,47,89,-42,1,3.32880212161217,39,0
11,1,10,93,34,59,1,3.60738385295372,-16,0
11,1,10,12,77,-65,0,3.59465601706688,-27,0
11,1,10,48,95,-47,1,3.65467291518144,45,0
11,1,10,16,60,-44,0,3.60653638134681,-10,0
11,1,10,24,74,-50,0,3.3218991868016,-24,0
11,1,10,91,19,72,1,3.50448899698131,-31,0
11,1,10,31,89,-58,0,3.59976503923099,-39,0
11,1,10,50,100,-50,1,3.57106610242045,50,0
11,1,10,73,12,61,1,3.67167696376418,-38,0
11,1,10,49,56,-7,1,3.75218346734073,6,0
11,1,10,59,46,13,1,3.66152306629374,-4,0
11,1,10,49,71,-22,1,3.57483133958704,21,0
11,1,10,52,11,41,0,3.8833256662565,39,0
11,1,1.5,93,22,71,1,0.743421006811332,-28,0
11,1,1.5,19,70,-51,0,0.581392280017099,-20,0
11,1,1.5,49,91,-42,1,0.713372786703985,41,0
11,1,1.5,15,82,-67,0,0.6005842862196,-32,0
11,1,1.5,74,7,67,1,0.563922708537575,-43,0
11,1,1.5,37,93,-56,0,0.608540695682677,-43,0
11,1,1.5,89,31,58,1,0.627904982011387,-19,0
11,1,1.5,91,4,87,1,0.758372356003747,-46,0
11,1,1.5,50,72,-22,1,0.699809942028878,22,0
11,1,1.5,49,84,-35,1,1.05899751293509,34,0
11,1,1.5,6,91,-85,0,0.546393388840443,-41,0
11,1,1.5,39,93,-54,0,0.840484730299067,-43,0
11,1,1.5,48,90,-42,1,0.70637271522537,40,0
11,1,1.5,52,11,41,0,1.10570338860271,39,0
11,1,1.5,2,50,-48,0,0.777034692451707,0,0
11,1,1.5,99,5,94,1,0.765667869573008,-45,0
11,1,1.5,57,42,15,1,0.802279595984146,-8,0
11,1,1.5,29,92,-63,0,0.845579456878113,-42,0
11,1,1.5,81,45,36,1,0.911529022787363,-5,0
11,1,1.5,47,77,-30,0,1.13481249873985,-27,0
11,1,10,36,60,-24,0,3.30588959776287,-10,0
11,1,10,76,39,37,1,3.15323584233192,-11,0
11,1,10,56,9,47,0,3.2225313082472,41,0
11,1,10,63,2,61,0,3.41711511428184,48,0
11,1,10,48,80,-32,1,3.44368400892199,30,0
11,1,10,31,85,-54,0,3.73365858843863,-35,0
11,1,10,47,92,-45,1,3.6588135030961,42,0
11,1,10,90,21,69,1,3.52422350230881,-29,0
11,1,10,48,74,-26,1,3.27483592150566,24,0
11,1,10,14,78,-64,0,3.56338204218082,-28,0
11,1,10,29,76,-47,0,3.59140871993986,-26,0
11,1,10,26,80,-54,0,3.53937095760193,-30,0
11,1,10,40,79,-39,0,3.94526550383671,-29,0
11,1,10,48,53,-5,1,3.74324506115045,3,0
11,1,10,8,74,-66,0,3.70913872765777,-24,0
11,1,10,49,78,-29,1,3.94033352699626,28,0
11,1,10,74,30,44,1,3.32966938710342,-20,0
11,1,10,19,78,-59,0,3.48830932713645,-28,0
11,1,10,48,86,-38,1,3.59161252366539,36,0
11,1,10,49,82,-33,1,3.69950386988967,32,0
11,1,1.5,49,60,-11,1,0.810054928037061,10,0
11,1,1.5,46,67,-21,0,1.11748918209196,-17,0
11,1,1.5,81,15,66,1,0.652134532452692,-35,0
11,1,1.5,96,12,84,1,0.476767291702345,-38,0
11,1,1.5,47,100,-53,1,0.749374201601313,50,0
11,1,1.5,10,98,-88,0,0.66597082601038,-48,0
11,1,1.5,94,35,59,1,0.594667746778214,-15,0
11,1,1.5,56,37,19,1,0.870655379263553,-13,0
11,1,1.5,56,33,23,1,0.679333165940989,-17,0
11,1,1.5,49,71,-22,1,0.855224578142952,21,0
11,1,1.5,0,75,-75,0,0.679129728769112,-25,0
11,1,1.5,48,83,-35,1,0.887828408991481,33,0
11,1,1.5,49,71,-22,1,0.751812515234633,21,0
11,1,1.5,99,0,99,1,0.820456982200994,-50,0
11,1,1.5,89,46,43,1,0.766391079556342,-4,0
11,1,1.5,42,77,-35,0,0.691088535490053,-27,0
11,1,1.5,49,72,-23,1,0.819048683797519,22,0
11,1,1.5,40,61,-21,0,0.95758756504074,-11,0
11,1,1.5,50,95,-45,1,0.626343830812402,45,0
11,1,1.5,24,73,-49,0,0.620244747746256,-23,0
12,1,10,53,23,30,1,2.80948331352556,-27,0
12,1,10,80,45,35,1,2.30935281861457,-5,0
12,1,10,5,83,-78,0,1.91747920511989,-33,0
12,1,10,85,15,70,1,2.66700451160432,-35,0
12,1,10,48,80,-32,1,2.6285440728243,30,0
12,1,10,30,100,-70,0,2.20795021837694,-50,0
12,1,10,53,0,53,0,2.06797024715343,50,0
12,1,10,48,100,-52,0,2.77343189850217,-50,0
12,1,10,75,0,75,0,1.9867983883305,50,0
12,1,10,0,68,-68,0,2.71036474057473,-18,0
12,1,10,48,80,-32,1,2.09444494947093,30,0
12,1,10,28,85,-57,0,2.86325380965718,-35,0
12,1,10,48,100,-52,0,2.8332850697625,-50,0
12,1,10,98,38,60,1,2.11604332138086,-12,0
12,1,10,50,100,-50,1,2.90758285325137,50,0
12,1,10,3,100,-97,0,2.65959122838103,-50,0
12,1,10,100,0,100,0,3.15767742542084,50,0
12,1,10,53,40,13,1,2.37976251394139,-10,0
12,1,10,3,100,-97,0,3.20938822819153,-50,0
12,1,10,48,60,-12,1,2.46217773991521,10,0
12,1,1.5,98,38,60,1,0.701671800925396,-12,0
12,1,1.5,28,85,-57,0,0.973769792355597,-35,0
12,1,1.5,53,40,13,1,0.787068615405587,-10,0
12,1,1.5,100,15,85,1,0.759782718669157,-35,0
12,1,1.5,85,15,70,0,0.765874924312811,35,0
12,1,1.5,53,23,30,1,0.547184169350658,-27,0
12,1,1.5,80,45,35,1,0.977917404059554,-5,0
12,1,1.5,25,55,-30,1,1.29530885501299,5,0
12,1,1.5,100,0,100,0,0.792069942341186,50,0
12,1,1.5,75,0,75,1,0.532718296715757,-50,0
12,1,1.5,50,43,7,0,0.603461193910334,7,0
12,1,1.5,30,100,-70,0,1.2075382064213,-50,0
12,1,1.5,25,55,-30,0,1.09962002525572,-5,0
12,1,1.5,50,100,-50,1,0.86758250137791,50,0
12,1,1.5,50,43,7,1,0.868975424411474,-7,0
12,1,1.5,5,83,-78,0,1.27837237672065,-33,0
12,1,1.5,48,60,-12,0,1.05572645337088,-10,0
12,1,1.5,0,68,-68,0,1.02574708330212,-18,0
12,1,1.5,100,15,85,1,1.04513107406092,-35,0
12,1,1.5,53,0,53,0,0.951880006265128,50,0
12,1,10,43,72,-29,0,1.46971052125446,-22,0
12,1,10,7,59,-52,0,2.46313519123942,-9,0
12,1,10,97,17,80,1,1.86513095675036,-33,0
12,1,10,48,80,-32,1,3.00327190296957,30,0
12,1,10,53,0,53,0,2.92729051536298,50,0
12,1,10,58,29,29,1,3.18275590564008,-21,0
12,1,10,65,41,24,1,3.26749034851673,-9,0
12,1,10,16,59,-43,0,3.63693570121541,-9,0
12,1,10,90,45,45,1,2.91968405572698,-5,0
12,1,10,50,43,7,1,2.65515843400499,-7,0
12,1,10,85,5,80,0,3.43986237919307,45,0
12,1,10,11,81,-70,0,2.61855278225266,-31,0
12,1,10,72,29,43,0,3.58212381179328,21,0
12,1,10,94,40,54,0,2.69089240915491,10,0
12,1,10,71,33,38,1,3.06764291023137,-17,0
12,1,10,48,60,-12,1,2.79704707639758,10,0
12,1,10,84,27,57,0,2.64181569722132,23,0
12,1,10,100,0,100,0,1.8686030007957,50,0
12,1,10,4,77,-73,0,3.74188035816769,-27,0
12,1,10,85,15,70,0,3.62075799939339,35,0
12,1,1.5,94,40,54,0,1.01891222971608,10,0
12,1,1.5,50,100,-50,0,1.3982891238993,-50,0
12,1,1.5,55,29,26,1,1.46699762030039,-21,0
12,1,1.5,71,48,23,1,1.47636356172734,-2,0
12,1,1.5,67,43,24,1,0.837784944393206,-7,0
12,1,1.5,92,30,62,0,0.992482980684144,20,0
12,1,1.5,24,75,-51,0,1.40530102534103,-25,0
12,1,1.5,84,30,54,NaN,NaN,0,0
12,1,1.5,28,53,-25,1,1.13677404882037,3,0
12,1,1.5,49,53,-4,0,0.591447598970262,-3,0
12,1,1.5,94,40,54,1,0.826832536928123,-10,0
12,1,1.5,55,44,11,1,0.566247421258595,-6,0
12,1,1.5,80,46,34,0,0.483665411098627,4,0
12,1,1.5,85,15,70,1,0.172337207593955,-35,0
12,1,1.5,4,77,-73,0,0.96964050855604,-27,0
12,1,1.5,79,6,73,1,0.69509903684957,-44,0
12,1,1.5,81,37,44,1,1.11189277717494,-13,0
12,1,1.5,100,0,100,0,1.0318594496639,50,0
12,1,1.5,67,2,65,0,0.890649307431886,48,0
12,1,1.5,30,95,-65,0,1.49135911167832,-45,0
12,1,10,94,40,54,0,2.44359321368393,10,0
12,1,10,48,80,-32,0,1.72641268061125,-30,0
12,1,10,47,99,-52,1,1.77368445746833,49,0
12,1,10,71,19,52,1,2.16242985898862,-31,0
12,1,10,75,45,30,1,1.62389244287624,-5,0
12,1,10,100,0,100,0,1.44142575204023,50,0
12,1,10,21,71,-50,1,2.67498706048355,21,0
12,1,10,57,26,31,1,1.51574736187467,-24,0
12,1,10,18,100,-82,0,2.91392065325635,-50,0
12,1,10,25,98,-73,0,2.84202896108036,-48,0
12,1,10,45,95,-50,0,2.35548569762614,-45,0
12,1,10,23,96,-73,0,2.9295272565796,-46,0
12,1,10,90,8,82,1,2.7290273438266,-42,0
12,1,10,20,97,-77,0,2.55900568753714,-47,0
12,1,10,50,43,7,1,2.9091916794132,-7,0
12,1,10,38,60,-22,0,3.42062024664483,-10,0
12,1,10,53,0,53,0,2.37536527574412,50,0
12,1,10,10,92,-82,0,3.38807753156289,-42,0
12,1,10,85,15,70,1,3.68092237901874,-35,0
12,1,10,83,23,60,0,2.58563287826837,27,0
12,1,1.5,50,43,7,0,0.689852848678129,7,0
12,1,1.5,68,50,18,1,1.20980903756572,0,0
12,1,1.5,70,47,23,1,1.02187622338533,-3,0
12,1,1.5,67,2,65,0,0.752604033012176,48,0
12,1,1.5,2,92,-90,NaN,NaN,0,0
12,1,1.5,32,78,-46,0,1.41338657721644,-28,0
12,1,1.5,100,48,52,1,1.02472914976534,-2,0
12,1,1.5,24,67,-43,1,0.891554707399337,17,0
12,1,1.5,75,0,75,0,1.13165102439234,50,0
12,1,1.5,10,97,-87,1,1.25838429722353,47,0
12,1,1.5,22,78,-56,0,1.17905806144699,-28,0
12,1,1.5,13,73,-60,0,1.19976972782752,-23,0
12,1,1.5,67,2,65,1,1.42718714580406,-48,0
12,1,1.5,51,35,16,NaN,NaN,0,0
12,1,1.5,2,93,-91,0,1.32466434221715,-43,0
12,1,1.5,40,80,-40,0,1.08343792473897,-30,0
12,1,1.5,51,20,31,1,1.02742298968951,-30,0
12,1,1.5,14,74,-60,0,1.46211799085722,-24,0
12,1,1.5,85,15,70,1,0.951573929778533,-35,0
12,1,1.5,47,99,-52,0,1.0849261530675,-49,0
12,1,10,20,94,-74,0,1.35701204804354,-44,0
12,1,10,11,55,-44,0,2.85721512159216,-5,0
12,1,10,71,4,67,1,3.10665208741557,-46,0
12,1,10,94,40,54,1,2.93008002708666,-10,0
12,1,10,48,87,-39,1,2.36890614483855,37,0
12,1,10,53,0,53,1,2.7096466520743,-50,0
12,1,10,72,33,39,1,2.34097583789844,-17,0
12,1,10,24,67,-43,1,2.91505441931076,17,0
12,1,10,29,95,-66,0,3.80182040383806,-45,0
12,1,10,91,40,51,1,2.7653342502017,-10,0
12,1,10,84,27,57,1,2.80203777313,-23,0
12,1,10,73,31,42,1,2.74946409117547,-19,0
12,1,10,19,91,-72,0,2.32290486042621,-41,0
12,1,10,53,11,42,1,2.85631741929683,-39,0
12,1,10,37,58,-21,0,2.42566922621336,-8,0
12,1,10,35,77,-42,0,2.59644306098926,-27,0
12,1,10,6,78,-72,0,2.15249575156486,-28,0
12,1,10,32,87,-55,0,3.02879795138142,-37,0
12,1,10,67,2,65,0,3.12761374682304,48,0
12,1,10,21,71,-50,0,2.55830702662934,-21,0
12,1,1.5,79,9,70,0,1.21130386396544,41,0
12,1,1.5,53,0,53,0,0.998636401636759,50,0
12,1,1.5,21,71,-50,0,1.17871532903519,-21,0
12,1,1.5,50,32,18,1,1.27937894692877,-18,0
12,1,1.5,11,87,-76,0,0.912121949688299,-37,0
12,1,1.5,41,63,-22,0,1.15952634750283,-13,0
12,1,1.5,0,60,-60,0,1.03685894381488,-10,0
12,1,1.5,50,43,7,1,1.02296380305779,-7,0
12,1,1.5,43,85,-42,0,1.03372120132553,-35,0
12,1,1.5,18,85,-67,0,0.915658508049091,-35,0
12,1,1.5,38,84,-46,0,0.977713230880909,-34,0
12,1,1.5,85,15,70,1,1.36650005349657,-35,0
12,1,1.5,67,2,65,1,1.05128156254068,-48,0
12,1,1.5,45,60,-15,0,1.38854965919745,-10,0
12,1,1.5,85,28,57,1,1.29669371381169,-22,0
12,1,1.5,40,54,-14,0,1.1767025552108,-4,0
12,1,1.5,16,82,-66,0,1.34942758191028,-32,0
12,1,1.5,66,34,32,1,0.994892737595364,-16,0
12,1,1.5,22,98,-76,0,1.19091916794423,-48,0
12,1,1.5,83,23,60,1,1.12300903641153,-27,0
12,1,10,80,42,38,1,3.09060304771992,-8,0
12,1,10,83,23,60,1,2.68267196370289,-27,0
12,1,10,53,0,53,0,3.47477306349901,50,0
12,1,10,25,70,-45,0,3.4356139638403,-20,0
12,1,10,12,74,-62,0,3.73368630491314,-24,0
12,1,10,66,32,34,1,3.25177634347347,-18,0
12,1,10,62,16,46,0,3.41317727218848,34,0
12,1,10,67,0,67,0,3.54467067631776,50,0
12,1,10,93,34,59,0,3.43065295834094,16,0
12,1,10,80,46,34,1,3.44950397277717,-4,0
12,1,10,89,2,87,1,3.4263066718122,-48,0
12,1,10,67,2,65,0,2.94100787513889,48,0
12,1,10,8,90,-82,1,3.32305771540268,40,0
12,1,10,4,90,-86,0,2.96190465369727,-40,0
12,1,10,28,53,-25,0,2.91938641003799,-3,0
12,1,10,24,67,-43,0,2.20605474332115,-17,0
12,1,10,87,47,40,0,3.43232739847736,3,0
12,1,10,42,71,-29,1,3.39432699090685,21,0
12,1,10,78,2,76,1,2.65455251248204,-48,0
12,1,10,67,11,56,0,3.15197633788921,39,0
12,1,1.5,12,74,-62,0,1.13711898055044,-24,0
12,1,1.5,94,40,54,1,0.854399217612809,-10,0
12,1,1.5,12,88,-76,0,1.10387723802705,-38,0
12,1,1.5,77,44,33,1,0.935229077207623,-6,0
12,1,1.5,16,66,-50,0,1.05330533313099,-16,0
12,1,1.5,85,5,80,1,1.12607346716686,-45,0
12,1,1.5,48,51,-3,0,1.39675141015323,-1,0
12,1,1.5,79,9,70,0,1.2968011155026,41,0
12,1,1.5,17,87,-70,0,1.32093900610926,-37,0
12,1,1.5,45,92,-47,0,0.894924848136725,-42,0
12,1,1.5,64,4,60,1,0.773710116598522,-46,0
12,1,1.5,24,66,-42,0,1.20238732351572,-16,0
12,1,1.5,87,47,40,1,0.821079764660681,-3,0
12,1,1.5,99,27,72,1,0.655110414809315,-23,0
12,1,1.5,9,97,-88,0,0.968578587984666,-47,0
12,1,1.5,85,15,70,1,0.701308907824568,-35,0
12,1,1.5,90,20,70,1,0.699334256059956,-30,0
12,1,1.5,28,53,-25,0,0.786070842616027,-3,0
12,1,1.5,58,2,56,1,0.550110774027416,-48,0
12,1,1.5,40,50,-10,0,0.555464730452513,0,0
13,1,10,85,15,70,0,3.18550380393754,35,0
13,1,10,98,38,60,0,1.48588263971578,12,0
13,1,10,75,0,75,0,0.990512060614492,50,0
13,1,10,3,100,-97,0,4.2896911581156,-50,0
13,1,10,100,0,100,0,3.5384918780328,50,0
13,1,10,80,45,35,0,4.1450579983466,5,0
13,1,10,25,55,-30,1,2.95166480639273,5,0
13,1,10,48,100,-52,0,3.64565750093061,-50,0
13,1,10,53,23,30,0,3.14425304104043,27,0
13,1,10,50,43,7,1,3.07085603690393,-7,0
13,1,10,100,0,100,0,2.56813380765743,50,0
13,1,10,3,100,-97,0,2.94947023472378,-50,0
13,1,10,0,68,-68,0,3.16347157998462,-18,0
13,1,10,48,80,-32,0,3.68938471717411,-30,0
13,1,10,53,23,30,0,3.76194157461578,27,0
13,1,10,50,100,-50,1,4.22391595600675,50,0
13,1,10,53,0,53,0,3.65120349547942,50,0
13,1,10,53,40,13,1,4.08501536786571,-10,0
13,1,10,48,60,-12,1,4.40577142658185,10,0
13,1,10,80,45,35,0,3.56973345869483,5,0
13,1,1.5,30,100,-70,0,0.305726156897435,-50,0
13,1,1.5,50,43,7,0,0.273717740767097,7,0
13,1,1.5,25,55,-30,0,0.547019806861499,-5,0
13,1,1.5,48,100,-52,0,0.401630441754605,-50,0
13,1,1.5,98,38,60,0,0.373684567435703,12,0
13,1,1.5,53,0,53,0,0.426795987676087,50,0
13,1,1.5,30,100,-70,0,0.366213419987616,-50,0
13,1,1.5,28,85,-57,0,0.34755901095923,-35,0
13,1,1.5,100,15,85,0,0.322203588950288,35,0
13,1,1.5,5,83,-78,0,0.401554931188002,-33,0
13,1,1.5,100,15,85,0,0.221567797309035,35,0
13,1,1.5,75,0,75,0,0.27284607024194,50,0
13,1,1.5,85,15,70,0,0.266152754944414,35,0
13,1,1.5,48,80,-32,0,0.31547691704327,-30,0
13,1,1.5,0,68,-68,0,0.26677333450607,-18,0
13,1,1.5,28,85,-57,0,0.260004508641941,-35,0
13,1,1.5,5,83,-78,0,0.25402744405983,-33,0
13,1,1.5,50,100,-50,0,0.256040936990757,-50,0
13,1,1.5,48,60,-12,0,0.226021454531292,-10,0
13,1,1.5,53,40,13,0,0.30932830418169,10,0
13,1,10,17,92,-75,0,2.37213880015042,-42,0
13,1,10,1,70,-69,0,2.68134284179905,-20,0
13,1,10,19,55,-36,0,2.38664965846147,-5,0
13,1,10,15,67,-52,0,2.31058925734033,-17,0
13,1,10,91,8,83,0,2.16660196950579,42,0
13,1,10,90,11,79,0,2.52390954127441,39,0
13,1,10,91,32,59,0,2.19517465484205,18,0
13,1,10,26,88,-62,0,2.07984252747883,-38,0
13,1,10,94,21,73,0,5.83958659797463,29,0
13,1,10,0,79,-79,0,6.72219845716609,-29,0
13,1,10,72,49,23,NaN,NaN,0,0
13,1,10,13,76,-63,0,1.19541254978321,-26,0
13,1,10,82,44,38,0,0.982672524232839,6,0
13,1,10,32,58,-26,1,1.54576178615389,8,0
13,1,10,9,86,-77,0,3.66446806287968,-36,0
13,1,10,55,46,9,1,3.00255159735934,-4,0
13,1,10,61,33,28,0,3.45445668130924,17,0
13,1,10,50,46,4,1,3.42438038264845,-4,0
13,1,10,68,39,29,0,3.61973428344754,11,0
13,1,10,97,31,66,0,4.32692923083596,19,0
13,1,1.5,80,36,44,0,0.506119838202721,14,0
13,1,1.5,91,2,89,0,0.442198310542153,48,0
13,1,1.5,19,81,-62,0,0.364886486724572,-31,0
13,1,1.5,3,52,-49,0,0.306911232930361,-2,0
13,1,1.5,61,22,39,0,0.346855223151579,28,0
13,1,1.5,16,50,-34,0,0.273526031902293,0,0
13,1,1.5,93,37,56,0,0.314836910005397,13,0
13,1,1.5,82,30,52,0,0.32282673440568,20,0
13,1,1.5,38,64,-26,0,0.266015296389014,-14,0
13,1,1.5,72,4,68,0,0.315390409792599,46,0
13,1,1.5,50,39,11,0,0.178060514754179,11,0
13,1,1.5,98,25,73,0,0.0874284070014255,25,0
13,1,1.5,68,43,25,0,0.104074088329071,7,0
13,1,1.5,28,86,-58,0,0.232060833659489,-36,0
13,1,1.5,53,45,8,0,0.659272496008271,5,0
13,1,1.5,9,72,-63,0,0.3172847719743,-22,0
13,1,1.5,80,47,33,0,0.340564753061699,3,0
13,1,1.5,22,53,-31,0,0.347275663054461,-3,0
13,1,1.5,93,23,70,0,0.289910358693305,27,0
13,1,1.5,94,21,73,0,0.314583619705445,29,0
13,1,10,15,91,-76,0,1.00866355460494,-41,0
13,1,10,35,61,-26,0,1.37917227955768,-11,0
13,1,10,97,26,71,0,2.73511992800923,24,0
13,1,10,19,77,-58,0,2.4457495065235,-27,0
13,1,10,92,46,46,0,3.37625852472047,4,0
13,1,10,96,46,50,0,3.66966069729824,4,0
13,1,10,25,85,-60,0,3.07895289570115,-35,0
13,1,10,10,59,-49,0,3.76015314715914,-9,0
13,1,10,78,34,44,0,2.67752809194826,16,0
13,1,10,7,79,-72,0,3.2867971973119,-29,0
13,1,10,76,28,48,0,3.08677373771752,22,0
13,1,10,50,71,-21,1,2.40732305876554,21,0
13,1,10,92,33,59,0,3.33140378175995,17,0
13,1,10,81,42,39,0,3.37060329643828,8,0
13,1,10,96,20,76,0,3.35919277004541,30,0
13,1,10,19,73,-54,0,2.55721739895307,-23,0
13,1,10,66,43,23,0,2.52244881501611,7,0
13,1,10,53,15,38,0,2.76175756342855,35,0
13,1,10,49,94,-45,0,2.69567775315772,-44,0
13,1,10,73,1,72,0,2.67239813862761,49,0
13,1,1.5,99,42,57,0,0.487022995899679,8,0
13,1,1.5,69,0,69,0,0.270994228572818,50,0
13,1,1.5,59,42,17,0,0.255597770605164,8,0
13,1,1.5,29,99,-70,0,0.121009715570835,-49,0
13,1,1.5,18,85,-67,0,0.199573328642145,-35,0
13,1,1.5,10,93,-83,0,0.706883008106161,-43,0
13,1,1.5,50,58,-8,0,0.378290345459391,-8,0
13,1,1.5,88,1,87,0,0.343580410506547,49,0
13,1,1.5,93,34,59,0,0.285510585224984,16,0
13,1,1.5,86,16,70,0,0.293468885798575,34,0
13,1,1.5,42,72,-30,0,0.436828629502998,-22,0
13,1,1.5,30,75,-45,0,0.295461485029591,-25,0
13,1,1.5,38,97,-59,0,0.24745802473808,-47,0
13,1,1.5,100,12,88,0,0.345463776004181,38,0
13,1,1.5,89,16,73,0,0.311440767276508,34,0
13,1,1.5,88,37,51,0,0.310713886430676,13,0
13,1,1.5,27,82,-55,0,0.230037810266367,-32,0
13,1,1.5,42,95,-53,0,0.272715942810464,-45,0
13,1,1.5,71,39,32,0,0.313330364228023,11,0
13,1,1.5,97,42,55,0,0.313305804966149,8,0
13,1,10,15,72,-57,0,2.04096851465874,-22,0
13,1,10,4,54,-50,0,2.75504445409751,-4,0
13,1,10,85,27,58,0,2.65642985306658,23,0
13,1,10,99,17,82,0,2.63375652240939,33,0
13,1,10,85,0,85,0,3.26760944908528,50,0
13,1,10,20,58,-38,0,3.30027436727869,-8,0
13,1,10,99,12,87,0,4.04352817625477,38,0
13,1,10,78,4,74,0,4.11747868017846,46,0
13,1,10,74,45,29,0,2.84408350882222,5,0
13,1,10,66,18,48,0,3.83811670781324,32,0
13,1,10,39,89,-50,0,3.79940031413753,-39,0
13,1,10,45,87,-42,0,3.23459446976813,-37,0
13,1,10,36,92,-56,0,3.74062816727564,-42,0
13,1,10,84,38,46,0,3.41053189130071,12,0
13,1,10,29,62,-33,0,3.37387151107396,-12,0
13,1,10,38,72,-34,0,3.68246816917963,-22,0
13,1,10,61,40,21,1,1.65843894732461,-10,0
13,1,10,96,28,68,0,2.77032361409692,22,0
13,1,10,65,10,55,0,4.44676560017251,40,0
13,1,10,77,47,30,0,2.91291615577939,3,0
13,1,1.5,87,26,61,0,0.431573313979243,24,0
13,1,1.5,76,32,44,0,0.330195612690659,18,0
13,1,1.5,73,31,42,0,0.320824604714289,19,0
13,1,1.5,46,61,-15,0,0.271495310829778,-11,0
13,1,1.5,50,82,-32,0,0.280072724741331,-32,0
13,1,1.5,26,82,-56,0,0.312769899876002,-32,0
13,1,1.5,25,86,-61,0,0.192020805727225,-36,0
13,1,1.5,4,100,-96,0,0.260065723517982,-50,0
13,1,1.5,58,50,8,0,0.221317439458289,0,0
13,1,1.5,89,48,41,0,0.272043678831324,2,0
13,1,1.5,75,28,47,0,0.128033297960428,22,0
13,1,1.5,57,44,13,0,0.174615253501543,6,0
13,1,1.5,80,44,36,0,0.0672230989039235,6,0
13,1,1.5,86,40,46,0,0.251904350838231,10,0
13,1,1.5,95,43,52,0,0.317173705459936,7,0
13,1,1.5,25,76,-51,0,0.307863912365065,-26,0
13,1,1.5,72,42,30,0,0.299277701105893,8,0
13,1,1.5,1,72,-71,0,0.226565057300832,-22,0
13,1,1.5,9,80,-71,0,0.285148061193468,-30,0
13,1,1.5,89,28,61,0,0.26044254324006,22,0
13,1,10,65,11,54,0,2.14176449133993,39,0
13,1,10,78,44,34,0,3.03570806735115,6,0
13,1,10,89,24,65,0,3.46958372050722,26,0
13,1,10,28,50,-22,0,3.35025869700257,0,0
13,1,10,92,22,70,0,3.62758041783854,28,0
13,1,10,21,68,-47,0,3.51810805708737,-18,0
13,1,10,20,67,-47,0,3.94876827969711,-17,0
13,1,10,8,84,-76,0,3.41006086664856,-34,0
13,1,10,49,67,-18,1,3.98131076813661,17,0
13,1,10,36,55,-19,1,4.1139157544003,5,0
13,1,10,12,53,-41,0,4.7926102280162,-3,0
13,1,10,80,2,78,0,4.11643289548192,48,0
13,1,10,83,20,63,0,4.44310187145311,30,0
13,1,10,3,99,-96,0,3.89313422003397,-49,0
13,1,10,80,21,59,0,3.9890102800673,29,0
13,1,10,40,72,-32,0,4.4969148801647,-22,0
13,1,10,30,75,-45,0,4.46488117165973,-25,0
13,1,10,56,45,11,1,4.18627357185142,-5,0
13,1,10,98,8,90,0,3.59809244179633,42,0
13,1,10,100,43,57,0,4.08211957428102,7,0
13,1,1.5,15,59,-44,0,0.606785320893323,-9,0
13,1,1.5,45,87,-42,0,0.514034518593689,-37,0
13,1,1.5,79,37,42,0,0.29733532006685,13,0
13,1,1.5,5,78,-73,0,0.289321669517449,-28,0
13,1,1.5,65,37,28,0,0.265328370162024,13,0
13,1,1.5,97,29,68,0,0.273954902597325,21,0
13,1,1.5,88,19,69,0,0.185985825273747,31,0
13,1,1.5,86,38,48,0,0.16598285616783,12,0
13,1,1.5,81,31,50,0,0.153850214161139,19,0
13,1,1.5,28,97,-69,0,0.207219689929843,-47,0
13,1,1.5,90,17,73,0,0.305247801121368,33,0
13,1,1.5,9,96,-87,0,0.240536711515233,-46,0
13,1,1.5,89,2,87,0,0.25857127409472,48,0
13,1,1.5,99,33,66,0,0.26667363123488,17,0
13,1,1.5,85,23,62,0,0.251180402441605,27,0
13,1,1.5,80,25,55,0,0.115842373523265,25,0
13,1,1.5,47,83,-36,0,0.218455369038566,-33,0
13,1,1.5,29,85,-56,0,0.24508567333578,-35,0
13,1,1.5,54,44,10,0,0.271100529856994,6,0
13,1,1.5,96,34,62,0,0.263015034301134,16,0
14,1,10,5,83,-78,0,3.85478878118192,-33,0
14,1,10,50,43,7,1,3.39246580489453,-7,0
14,1,10,0,68,-68,0,3.61310291613881,-18,0
14,1,10,85,15,70,0,3.04915481315766,35,0
14,1,10,48,60,-12,1,3.3390677377447,10,0
14,1,10,25,55,-30,0,3.64172142099051,-5,0
14,1,10,53,23,30,0,3.37235030305055,27,0
14,1,10,53,40,13,1,3.35365593940151,-10,0
14,1,10,50,100,-50,0,3.65557284478746,-50,0
14,1,10,98,38,60,0,3.69745115181104,12,0
14,1,10,80,45,35,0,3.54604989928885,5,0
14,1,10,75,0,75,0,3.6806694781535,50,0
14,1,10,0,68,-68,0,4.55405365282422,-18,0
14,1,10,100,0,100,0,4.02401785861548,50,0
14,1,10,100,15,85,0,3.70719128182827,35,0
14,1,10,75,0,75,0,3.65120496170312,50,0
14,1,10,80,45,35,0,3.81322168032966,5,0
14,1,10,28,85,-57,0,3.63316233488877,-35,0
14,1,10,48,100,-52,0,3.90776200975415,-50,0
14,1,10,50,100,-50,1,3.38779441331644,50,0
14,1,1.5,48,80,-32,0,0.977132761137909,-30,0
14,1,1.5,48,60,-12,1,0.990371303050779,10,0
14,1,1.5,85,15,70,0,1.42691291908886,35,0
14,1,1.5,30,100,-70,NaN,NaN,0,0
14,1,1.5,25,55,-30,0,0.773687866441833,-5,0
14,1,1.5,53,23,30,1,0.802902758150594,-27,0
14,1,1.5,53,0,53,0,0.718792417419536,50,0
14,1,1.5,50,43,7,1,0.846208068267515,-7,0
14,1,1.5,100,0,100,0,0.664875673317511,50,0
14,1,1.5,3,100,-97,0,0.570774111605715,-50,0
14,1,1.5,48,100,-52,0,0.704026802584849,-50,0
14,1,1.5,98,38,60,1,0.848142751627165,-12,0
14,1,1.5,100,15,85,0,0.578024592252405,35,0
14,1,1.5,28,85,-57,0,0.831379405775806,-35,0
14,1,1.5,30,100,-70,0,0.634735960440594,-50,0
14,1,1.5,53,40,13,1,0.845332732182214,-10,0
14,1,1.5,53,0,53,0,0.671959370916738,50,0
14,1,1.5,3,100,-97,0,0.625222728680455,-50,0
14,1,1.5,48,80,-32,0,0.580505077719863,-30,0
14,1,1.5,5,83,-78,0,0.49786132814188,-33,0
14,1,10,15,66,-51,0,2.90627269211654,-16,0
14,1,10,97,15,82,0,2.7941827538998,35,0
14,1,10,39,83,-44,0,3.32683319312491,-33,0
14,1,10,99,28,71,0,4.15015972684341,22,0
14,1,10,80,38,42,1,4.2360222059724,-12,0
14,1,10,48,91,-43,0,3.90260493127971,-41,0
14,1,10,93,1,92,0,3.83059240972216,49,0
14,1,10,25,95,-70,0,3.31391795373747,-45,0
14,1,10,48,58,-10,1,3.06581149116755,8,0
14,1,10,2,61,-59,0,3.33118934641243,-11,0
14,1,10,54,14,40,0,3.25701964191103,36,0
14,1,10,59,46,13,1,3.26705448307257,-4,0
14,1,10,40,55,-15,1,3.18828046677299,5,0
14,1,10,98,22,76,0,3.2970050529766,28,0
14,1,10,81,48,33,0,3.18561743634382,2,0
14,1,10,47,54,-7,1,3.33425118993364,4,0
14,1,10,98,7,91,0,3.46819557236813,43,0
14,1,10,62,31,31,0,3.24551637681179,19,0
14,1,10,47,92,-45,0,3.51209470344656,-42,0
14,1,10,14,89,-75,0,3.46400876802363,-39,0
14,1,1.5,55,37,18,0,1.00536564892354,13,0
14,1,1.5,91,14,77,0,0.673306464766938,36,0
14,1,1.5,51,5,46,0,0.66666666666606,45,0
14,1,1.5,100,35,65,0,0.579918587878637,15,0
14,1,1.5,24,89,-65,0,0.729228271009561,-39,0
14,1,1.5,94,6,88,0,0.559595981811071,44,0
14,1,1.5,10,62,-52,0,0.494572219809925,-12,0
14,1,1.5,54,28,26,0,0.735204602478916,22,0
14,1,1.5,87,19,68,0,0.541840735018923,31,0
14,1,1.5,20,84,-64,0,0.580502878381594,-34,0
14,1,1.5,97,25,72,0,0.832483839456472,25,0
14,1,1.5,48,53,-5,1,0.859016639817128,3,0
14,1,1.5,15,90,-75,0,0.525067858707189,-40,0
14,1,1.5,78,27,51,0,0.684396621085398,23,0
14,1,1.5,4,56,-52,0,0.597034194190201,-6,0
14,1,1.5,100,27,73,0,0.601683592396512,23,0
14,1,1.5,82,44,38,0,0.685659407023195,6,0
14,1,1.5,85,33,52,0,0.734278315087067,17,0
14,1,1.5,90,3,87,0,0.516187669418287,47,0
14,1,1.5,84,17,67,0,0.843621648073167,33,0
14,1,10,42,64,-22,0,4.56593043863904,-14,0
14,1,10,48,62,-14,1,2.6511342163667,12,0
14,1,10,18,90,-72,0,0.805148647683382,-40,0
14,1,10,80,3,77,0,3.87967427820513,47,0
14,1,10,11,60,-49,0,3.47292341359025,-10,0
14,1,10,34,60,-26,0,5.00225871899602,-10,0
14,1,10,0,70,-70,0,3.29419356730614,-20,0
14,1,10,96,28,68,0,4.37485131566064,22,0
14,1,10,86,23,63,0,3.90008888986631,27,0
14,1,10,32,97,-65,0,4.85135305038784,-47,0
14,1,10,72,24,48,0,4.81271143416961,26,0
14,1,10,29,97,-68,0,3.15995227438907,-47,0
14,1,10,97,40,57,0,3.27789354842935,10,0
14,1,10,88,15,73,1,2.75055304159105,-35,0
14,1,10,43,93,-50,0,2.46048652997888,-43,0
14,1,10,57,28,29,1,2.59781385912174,-22,0
14,1,10,54,4,50,0,2.47436177992313,46,0
14,1,10,39,58,-19,1,2.37171726057932,8,0
14,1,10,96,28,68,0,3.62501452478682,22,0
14,1,10,25,53,-28,1,2.8515986430084,3,0
14,1,1.5,40,92,-52,0,0.959653897682074,-42,0
14,1,1.5,93,21,72,0,0.812910474158343,29,0
14,1,1.5,60,35,25,1,0.792284359598852,-15,0
14,1,1.5,87,29,58,0,0.780207067569791,21,0
14,1,1.5,9,67,-58,0,0.56153506384544,-17,0
14,1,1.5,88,23,65,0,0.67084687300121,27,0
14,1,1.5,44,60,-16,1,0.76746557579645,10,0
14,1,1.5,14,75,-61,0,0.564137612509512,-25,0
14,1,1.5,66,13,53,0,0.929432076229205,37,0
14,1,1.5,18,97,-79,0,0.640037828596178,-47,0
14,1,1.5,19,51,-32,0,0.57743773585571,-1,0
14,1,1.5,99,4,95,0,0.766035640253904,46,0
14,1,1.5,98,36,62,0,0.730629981726452,14,0
14,1,1.5,59,15,44,0,0.865254692376766,35,0
14,1,1.5,75,7,68,0,0.569940929477525,43,0
14,1,1.5,31,78,-47,0,0.742388369906621,-28,0
14,1,1.5,85,26,59,0,0.70925352672748,24,0
14,1,1.5,17,98,-81,0,0.612565544821337,-48,0
14,1,1.5,61,46,15,1,0.775830753693299,-4,0
14,1,1.5,12,86,-74,0,0.540483011040124,-36,0
14,1,10,12,73,-61,0,3.5677199657639,-23,0
14,1,10,49,90,-41,0,3.34015237739186,-40,0
14,1,10,72,36,36,0,3.33019891169533,14,0
14,1,10,88,32,56,0,3.92883898837863,18,0
14,1,10,26,61,-35,0,3.80747407989838,-11,0
14,1,10,33,55,-22,1,2.99473332123671,5,0
14,1,10,75,0,75,0,3.15059226309859,50,0
14,1,10,100,4,96,0,3.61995641647445,46,0
14,1,10,10,86,-76,0,3.23858626624133,-36,0
14,1,10,98,23,75,0,3.72835660048622,27,0
14,1,10,47,81,-34,0,4.04646355790464,-31,0
14,1,10,81,20,61,0,3.55246536502636,30,0
14,1,10,41,55,-14,1,3.50967616596972,5,0
14,1,10,95,6,89,0,3.95696484176733,44,0
14,1,10,98,36,62,0,3.45028343954436,14,0
14,1,10,34,56,-22,0,2.86755409910438,-6,0
14,1,10,89,16,73,0,2.83620695027093,34,0
14,1,10,45,87,-42,0,3.31818026865039,-37,0
14,1,10,57,1,56,0,3.04483641515435,49,0
14,1,10,28,60,-32,0,3.06278483703682,-10,0
14,1,1.5,84,20,64,0,0.908057820566682,30,0
14,1,1.5,34,85,-51,0,0.795310647174119,-35,0
14,1,1.5,36,57,-21,1,0.863395519583719,7,0
14,1,1.5,30,99,-69,0,0.664694961134956,-49,0
14,1,1.5,99,24,75,0,0.61795025466381,26,0
14,1,1.5,88,28,60,0,0.636589268335229,22,0
14,1,1.5,25,80,-55,0,0.742609036708018,-30,0
14,1,1.5,93,29,64,0,0.73252910914016,21,0
14,1,1.5,44,99,-55,0,0.866543870355599,-49,0
14,1,1.5,49,51,-2,1,0.819192146900605,1,0
14,1,1.5,92,25,67,0,0.757221431073049,25,0
14,1,1.5,83,0,83,0,0.690416206180089,50,0
14,1,1.5,74,20,54,0,0.770405722674695,30,0
14,1,1.5,34,84,-50,0,0.791068859405641,-34,0
14,1,1.5,24,69,-45,0,0.827074570350305,-19,0
14,1,1.5,90,22,68,0,0.757697587510847,28,0
14,1,1.5,97,30,67,0,0.675032944232953,20,0
14,1,1.5,10,69,-59,0,0.787629463051417,-19,0
14,1,1.5,57,18,39,0,0.751601025624041,32,0
14,1,1.5,55,43,12,1,0.756959709980947,-7,0
14,1,10,83,34,49,0,0.921307725720908,16,0
14,1,10,85,18,67,0,4.23849939243337,32,0
14,1,10,37,82,-45,0,3.51246199270827,-32,0
14,1,10,18,55,-37,0,4.47903500427856,-5,0
14,1,10,11,87,-76,0,5.42366083292654,-37,0
14,1,10,33,55,-22,1,5.3222867971981,5,0
14,1,10,18,80,-62,0,5.44888502783033,-30,0
14,1,10,88,34,54,0,5.18612438349919,16,0
14,1,10,97,20,77,0,4.77411050568298,30,0
14,1,10,29,81,-52,0,5.10674261710119,-31,0
14,1,10,72,22,50,0,3.8172930194869,28,0
14,1,10,91,30,61,0,4.70784521800124,20,0
14,1,10,90,20,70,0,3.92319072466307,30,0
14,1,10,88,13,75,0,3.12182713578659,37,0
14,1,10,86,34,52,0,4.59243428106493,16,0
14,1,10,9,70,-61,0,3.8204230424526,-20,0
14,1,10,77,48,29,0,4.19098235215461,2,0
14,1,10,83,17,66,0,5.40293538164951,33,0
14,1,10,48,88,-40,1,4.07021676297882,38,0
14,1,10,12,75,-63,0,4.99085039194142,-25,0
14,1,1.5,64,42,22,1,1.17821740078762,-8,0
14,1,1.5,95,46,49,0,0.662162058139074,4,0
14,1,1.5,60,6,54,0,0.711430137147545,44,0
14,1,1.5,88,32,56,0,0.734795159260102,18,0
14,1,1.5,90,19,71,0,0.740728603659591,31,0
14,1,1.5,46,74,-28,0,0.946041101940864,-24,0
14,1,1.5,44,84,-40,0,0.775963813577619,-34,0
14,1,1.5,82,27,55,0,0.827994992843742,23,0
14,1,1.5,24,72,-48,0,0.77455733763054,-22,0
14,1,1.5,61,1,60,0,0.603263082848571,49,0
14,1,1.5,66,14,52,0,0.636621891833784,36,0
14,1,1.5,18,61,-43,0,0.67055289496966,-11,0
14,1,1.5,71,48,23,0,0.543204690451603,2,0
14,1,1.5,56,14,42,0,1.18118467282147,36,0
14,1,1.5,47,58,-11,1,0.713782694518159,8,0
14,1,1.5,91,29,62,0,1.23305603360677,21,0
14,1,1.5,91,34,57,0,0.627078969024296,16,0
14,1,1.5,48,51,-3,1,0.773088913691026,1,0
14,1,1.5,89,50,39,1,1.10512573792403,0,0
14,1,1.5,79,36,43,0,0.943737663093998,14,0
15,1,10,53,23,30,1,1.48517016328151,-27,0
15,1,10,25,55,-30,0,3.17147407642187,-5,0
15,1,10,28,85,-57,0,2.34481317686368,-35,0
15,1,10,50,100,-50,1,1.64753172062046,50,0
15,1,10,75,0,75,0,4.52938640783213,50,0
15,1,10,100,15,85,1,2.97672568788221,-35,0
15,1,10,48,60,-12,1,5.00591543978226,10,0
15,1,10,80,45,35,1,2.97790745624661,-5,0
15,1,10,98,38,60,1,2.92719258535544,-12,0
15,1,10,85,15,70,0,1.42240301453603,35,0
15,1,10,75,0,75,1,1.72830654132849,-50,0
15,1,10,50,100,-50,0,1.48758098540566,-50,0
15,1,10,0,68,-68,0,3.55082758607932,-18,0
15,1,10,30,100,-70,0,3.75674449207509,-50,0
15,1,10,5,83,-78,1,2.85074419516786,33,0
15,1,10,50,43,7,1,3.1886163156596,-7,0
15,1,10,100,0,100,0,3.60921112196593,50,0
15,1,10,100,15,85,0,3.5572342075011,35,0
15,1,10,28,85,-57,1,6.82704541414205,35,0
15,1,10,53,0,53,1,3.19035927737605,-50,0
15,1,1.5,53,40,13,1,0.326443716632639,-10,0
15,1,1.5,30,100,-70,0,0.349713996662103,-50,0
15,1,1.5,25,55,-30,0,0.763563486143539,-5,0
15,1,1.5,3,100,-97,0,0.673657818677384,-50,0
15,1,1.5,0,68,-68,0,0.994864219434021,-18,0
15,1,1.5,80,45,35,1,0.479504346407339,-5,0
15,1,1.5,48,100,-52,0,0.824877983517581,-50,0
15,1,1.5,53,40,13,0,0.75617450144091,10,0
15,1,1.5,85,15,70,0,0.394141009450323,35,0
15,1,1.5,53,23,30,0,0.566755800251485,27,0
15,1,1.5,5,83,-78,0,0.748041046657818,-33,0
15,1,1.5,98,38,60,1,0.746711923800831,-12,0
15,1,1.5,48,60,-12,0,0.769344400803675,-10,0
15,1,1.5,50,43,7,1,0.870627887752562,-7,0
15,1,1.5,48,100,-52,0,0.735893464901892,-50,0
15,1,1.5,3,100,-97,0,1.10262433951721,-50,0
15,1,1.5,48,80,-32,NaN,NaN,0,0
15,1,1.5,100,0,100,1,1.30987476701011,-50,0
15,1,1.5,48,80,-32,0,0.925812511568438,-30,0
15,1,1.5,53,0,53,1,0.821152700675157,-50,0
15,1,10,61,3,58,0,3.47901646374885,47,0
15,1,10,53,23,30,0,1.96029089682816,27,0
15,1,10,75,0,75,0,7.35669500735821,50,0
15,1,10,62,18,44,0,3.97066839191211,32,0
15,1,10,65,45,20,1,4.7038625571131,-5,0
15,1,10,53,40,13,1,5.30382296933931,-10,0
15,1,10,23,77,-54,1,6.63166325466409,27,0
15,1,10,77,13,64,0,2.73822914356606,37,0
15,1,10,0,98,-98,0,2.59224702770916,-48,0
15,1,10,7,92,-85,1,4.8848824188135,42,0
15,1,10,83,14,69,0,3.43686171587251,36,0
15,1,10,53,7,46,1,3.46339688759508,-43,0
15,1,10,61,3,58,0,4.26543529140145,47,0
15,1,10,48,60,-12,1,1.43463343737312,10,0
15,1,10,36,83,-47,0,2.06937134248255,-33,0
15,1,10,53,41,12,1,2.71865152312239,-9,0
15,1,10,98,49,49,1,4.069875720048,-1,0
15,1,10,45,81,-36,1,4.49513785159252,31,0
15,1,10,48,99,-51,0,2.23176332375988,-49,0
15,1,10,85,15,70,0,2.28888884815933,35,0
15,1,1.5,7,92,-85,0,0.62302468920825,-42,0
15,1,1.5,85,15,70,1,0.658278335042269,-35,0
15,1,1.5,66,37,29,0,0.964191025672335,13,0
15,1,1.5,96,24,72,0,0.706131156495758,26,0
15,1,1.5,29,100,-71,0,1.03411329800838,-50,0
15,1,1.5,5,83,-78,0,1.08484759623389,-33,0
15,1,1.5,66,2,64,NaN,NaN,0,0
15,1,1.5,100,4,96,0,0.564773845677337,46,0
15,1,1.5,54,46,8,0,0.290731878971201,4,0
15,1,1.5,53,49,4,1,0.723345973317919,-1,0
15,1,1.5,2,94,-92,0,0.70602045734995,-44,0
15,1,1.5,62,10,52,0,0.60198635321467,40,0
15,1,1.5,26,88,-62,0,0.733893915761655,-38,0
15,1,1.5,28,85,-57,0,1.26862650584735,-35,0
15,1,1.5,65,20,45,0,0.781883828210994,30,0
15,1,1.5,77,13,64,0,0.930571108621734,37,0
15,1,1.5,48,60,-12,1,1.03376837120049,10,0
15,1,1.5,50,13,37,1,1.44448492823904,-37,0
15,1,1.5,56,8,48,0,0.695083601680381,42,0
15,1,1.5,0,99,-99,NaN,NaN,0,0
15,1,10,94,30,64,0,2.85301132833592,20,0
15,1,10,5,83,-78,0,1.55088660118781,-33,0
15,1,10,58,46,12,1,2.82671258359733,-4,0
15,1,10,11,86,-75,0,4.53400571456768,-36,0
15,1,10,60,31,29,1,3.16398612228659,-19,0
15,1,10,62,18,44,0,3.9059409152469,32,0
15,1,10,56,8,48,0,3.85785203336309,42,0
15,1,10,93,4,89,0,3.87580472230911,46,0
15,1,10,6,67,-61,0,4.30105365792951,-17,0
15,1,10,0,96,-96,0,4.98902758864642,-46,0
15,1,10,58,0,58,0,2.60098492915495,50,0
15,1,10,91,49,42,1,2.62084956096078,-1,0
15,1,10,61,3,58,0,3.26351345159674,47,0
15,1,10,28,85,-57,0,2.34549350009002,-35,0
15,1,10,87,21,66,0,2.95145292628695,29,0
15,1,10,13,74,-61,1,2.36535666568307,24,0
15,1,10,96,47,49,1,3.69801602938242,-3,0
15,1,10,56,3,53,0,2.09734120445864,47,0
15,1,10,1,100,-99,1,1.44933516365745,50,0
15,1,10,53,23,30,0,4.31296811168249,27,0
15,1,1.5,97,32,65,0,0.416472546063233,18,0
15,1,1.5,0,99,-99,1,0.490968672507734,49,0
15,1,1.5,45,81,-36,0,0.907050839132353,-31,0
15,1,1.5,28,85,-57,0,0.451004448126696,-35,0
15,1,1.5,62,10,52,1,0.572306519336053,-40,0
15,1,1.5,87,10,77,0,1.17688770451423,40,0
15,1,1.5,99,13,86,1,0.973554267324289,-37,0
15,1,1.5,54,11,43,0,0.714201197530201,39,0
15,1,1.5,99,28,71,1,0.65747155086865,-22,0
15,1,1.5,97,26,71,0,0.498723844119013,24,0
15,1,1.5,99,38,61,1,0.633505552368661,-12,0
15,1,1.5,52,18,34,1,0.499462449348357,-32,0
15,1,1.5,66,7,59,0,0.330757684336277,43,0
15,1,1.5,2,100,-98,1,0.729351218697047,50,0
15,1,1.5,4,69,-65,0,0.743974502540368,-19,0
15,1,1.5,75,0,75,1,0.606047765581025,-50,0
15,1,1.5,54,46,8,0,0.401265342552506,4,0
15,1,1.5,39,52,-13,1,0.476535629913997,2,0
15,1,1.5,61,8,53,1,0.389258150775277,-42,0
15,1,1.5,97,26,71,0,0.513116565833116,24,0
15,1,10,35,90,-55,0,0.373133463946942,-40,0
15,1,10,94,30,64,1,3.42406350172314,-20,0
15,1,10,23,77,-54,0,3.29081691937608,-27,0
15,1,10,48,60,-12,0,2.4348746295509,-10,0
15,1,10,79,14,65,0,0.940805647855086,36,0
15,1,10,12,94,-82,0,4.82528852339419,-44,0
15,1,10,57,37,20,1,3.53180126204279,-13,0
15,1,10,93,6,87,0,6.08974108496113,44,0
15,1,10,75,43,32,1,3.88178834103383,-7,0
15,1,10,2,100,-98,0,3.12972950187213,-50,0
15,1,10,48,64,-16,1,4.03968381098275,14,0
15,1,10,85,15,70,0,3.39355855599933,35,0
15,1,10,35,51,-16,1,5.01347193941729,1,0
15,1,10,23,52,-29,0,7.16075312074463,-2,0
15,1,10,65,20,45,1,3.4860322970253,-30,0
15,1,10,26,67,-41,0,2.24592365057833,-17,0
15,1,10,28,57,-29,1,2.91998321185019,7,0
15,1,10,82,15,67,0,0.838632535653232,35,0
15,1,10,2,100,-98,0,1.50315584203781,-50,0
15,1,10,0,99,-99,0,2.39683481085012,-49,0
15,1,1.5,54,32,22,1,0.625664973800667,-18,0
15,1,1.5,2,100,-98,0,0.61230080110181,-50,0
15,1,1.5,93,4,89,0,0.975605500500023,46,0
15,1,1.5,18,56,-38,0,1.24414696594613,-6,0
15,1,1.5,100,0,100,0,0.790183331715525,50,0
15,1,1.5,75,4,71,0,1.26608665690401,46,0
15,1,1.5,88,4,84,0,0.62681961720773,46,0
15,1,1.5,40,78,-38,0,1.29339159089614,-28,0
15,1,1.5,83,14,69,0,0.789423832939065,36,0
15,1,1.5,66,28,38,1,0.585368285426739,-22,0
15,1,1.5,94,3,91,0,0.731980140133601,47,0
15,1,1.5,13,74,-61,0,0.5699624099434,-24,0
15,1,1.5,50,43,7,1,0.790563447655586,-7,0
15,1,1.5,86,10,76,0,1.17064933113215,40,0
15,1,1.5,5,82,-77,0,0.727241336968291,-32,0
15,1,1.5,53,46,7,1,0.805189663926285,-4,0
15,1,1.5,69,0,69,0,0.536503043309494,50,0
15,1,1.5,45,81,-36,0,0.990434787390768,-31,0
15,1,1.5,0,99,-99,0,0.690410411583798,-49,0
15,1,1.5,100,4,96,0,0.850356381604797,46,0
15,1,10,2,100,-98,0,4.07936102400345,-50,0
15,1,10,34,100,-66,0,3.87999259561911,-50,0
15,1,10,49,59,-10,1,3.36062592669259,9,0
15,1,10,97,25,72,0,6.15785221664009,25,0
15,1,10,54,11,43,0,3.3310806179361,39,0
15,1,10,56,15,41,0,3.04914565551735,35,0
15,1,10,77,13,64,0,4.53028079828073,37,0
15,1,10,79,21,58,0,3.49698858002557,29,0
15,1,10,1,100,-99,0,3.22489851050887,-50,0
15,1,10,34,91,-57,0,2.83544828572121,-41,0
15,1,10,19,55,-36,0,3.51681509027367,-5,0
15,1,10,34,73,-39,0,3.02679432502009,-23,0
15,1,10,47,51,-4,1,2.83737085863322,1,0
15,1,10,96,24,72,0,2.27132287312088,26,0
15,1,10,0,97,-97,0,3.53597227389582,-47,0
15,1,10,8,64,-56,0,4.06981560528038,-14,0
15,1,10,60,27,33,0,5.34174219195302,23,0
15,1,10,0,99,-99,0,3.00380005974876,-49,0
15,1,10,83,14,69,0,4.56634745969313,36,0
15,1,10,0,99,-99,0,3.89895990454897,-49,0
15,1,1.5,88,22,66,0,0.782918242082815,28,0
15,1,1.5,62,10,52,0,0.610842284875616,40,0
15,1,1.5,1,73,-72,0,0.61419075075537,-23,0
15,1,1.5,41,70,-29,1,0.817547647367974,20,0
15,1,1.5,3,99,-96,0,0.628123081321974,-49,0
15,1,1.5,0,99,-99,0,0.558061885220013,-49,0
15,1,1.5,58,31,27,1,1.24335007871741,-19,0
15,1,1.5,80,3,77,0,0.613437483390953,47,0
15,1,1.5,83,14,69,0,0.38472828308295,36,0
15,1,1.5,50,5,45,0,0.77264191575523,45,0
15,1,1.5,100,4,96,1,0.552601338285967,-46,0
15,1,1.5,57,21,36,0,0.901913225799944,29,0
15,1,1.5,5,99,-94,0,0.781224031978127,-49,0
15,1,1.5,1,64,-63,0,0.673226751805487,-14,0
15,1,1.5,17,62,-45,0,0.769880668520273,-12,0
15,1,1.5,28,85,-57,0,0.733851762113773,-35,0
15,1,1.5,87,21,66,0,0.459121774558298,29,0
15,1,1.5,49,91,-42,0,0.596509311373666,-41,0
15,1,1.5,37,90,-53,0,0.848464599182989,-40,0
15,1,1.5,38,79,-41,0,1.17706841537256,-29,0
16,1,10,0,68,-68,0,5.25261649602908,-18,0
16,1,10,28,85,-57,0,4.0627357888734,-35,0
16,1,10,53,40,13,1,5.08084085636074,-10,0
16,1,10,30,100,-70,0,4.84973732402432,-50,0
16,1,10,50,100,-50,1,4.82787173084216,50,0
16,1,10,85,15,70,0,5.87124332314124,35,0
16,1,10,80,45,35,1,4.41685788813629,-5,0
16,1,10,25,55,-30,1,4.82826321554603,5,0
16,1,10,100,0,100,1,4.99963160851621,-50,0
16,1,10,25,55,-30,1,4.24380002610269,5,0
16,1,10,75,0,75,1,4.19861323508667,-50,0
16,1,10,53,0,53,1,5.20274325201171,-50,0
16,1,10,85,15,70,0,3.99089871396427,35,0
16,1,10,5,83,-78,0,3.55554793926422,-33,0
16,1,10,48,80,-32,1,4.38574988377513,30,0
16,1,10,30,100,-70,0,3.93453334877267,-50,0
16,1,10,98,38,60,0,4.47733604194946,12,0
16,1,10,53,0,53,1,4.82278316293377,-50,0
16,1,10,5,83,-78,0,3.1702357265749,-33,0
16,1,10,100,15,85,0,5.29562959389295,35,0
16,1,1.5,0,68,-68,0,1.15332710673101,-18,0
16,1,1.5,100,15,85,0,1.19128499351791,35,0
16,1,1.5,48,100,-52,1,0.900000953057315,50,0
16,1,1.5,53,23,30,0,1.11601253045956,27,0
16,1,1.5,28,85,-57,0,1.41127226658864,-35,0
16,1,1.5,50,43,7,1,0.975558598787757,-7,0
16,1,1.5,100,0,100,1,1.3248835442937,-50,0
16,1,1.5,48,60,-12,1,1.02833278838079,10,0
16,1,1.5,53,23,30,0,1.28765437621041,27,0
16,1,1.5,53,40,13,NaN,NaN,0,0
16,1,1.5,50,43,7,1,0.735859998036176,-7,0
16,1,1.5,98,38,60,0,0.74257535347715,12,0
16,1,1.5,48,100,-52,1,1.26919704582542,50,0
16,1,1.5,48,80,-32,1,1.00657276407583,30,0
16,1,1.5,3,100,-97,0,0.866705692955293,-50,0
16,1,1.5,3,100,-97,0,0.684027864335803,-50,0
16,1,1.5,80,45,35,1,0.772789687674958,-5,0
16,1,1.5,75,0,75,1,0.850011509930482,-50,0
16,1,1.5,50,100,-50,1,0.772168370691361,50,0
16,1,1.5,48,60,-12,1,0.817579862137791,10,0
16,1,10,47,96,-49,1,5.4823626614525,46,0
16,1,10,35,79,-44,0,3.75525865115924,-29,0
16,1,10,71,26,45,0,5.60931806883309,24,0
16,1,10,10,59,-49,0,3.70143683679635,-9,0
16,1,10,85,24,61,0,4.17345117952209,26,0
16,1,10,47,97,-50,1,3.83496720765834,47,0
16,1,10,49,98,-49,1,3.0537287084444,48,0
16,1,10,44,93,-49,0,4.67978568046237,-43,0
16,1,10,68,24,44,0,2.36126669490477,26,0
16,1,10,33,78,-45,0,5.12617023865459,-28,0
16,1,10,15,62,-47,0,4.30825607496081,-12,0
16,1,10,36,78,-42,1,5.58056007238338,28,0
16,1,10,15,84,-69,0,5.36201814026572,-34,0
16,1,10,34,87,-53,0,3.1201425473555,-37,0
16,1,10,47,59,-12,1,4.61553857004037,9,0
16,1,10,20,97,-77,0,4.82704330817796,-47,0
16,1,10,79,23,56,0,4.43852334024268,27,0
16,1,10,40,83,-43,1,4.41726476830081,33,0
16,1,10,29,82,-53,0,4.73264601131086,-32,0
16,1,10,48,95,-47,1,5.31547288270667,45,0
16,1,1.5,77,15,62,0,0.789090186648536,35,0
16,1,1.5,64,15,49,0,0.641646347095957,35,0
16,1,1.5,37,72,-35,0,1.20445764707983,-22,0
16,1,1.5,68,2,66,0,1.21649653455825,48,0
16,1,1.5,58,28,30,0,1.07586078980239,22,0
16,1,1.5,44,70,-26,1,0.756630313815549,20,0
16,1,1.5,11,74,-63,0,0.874697405815823,-24,0
16,1,1.5,15,56,-41,0,0.764063757756958,-6,0
16,1,1.5,34,68,-34,1,0.954108683188679,18,0
16,1,1.5,15,51,-36,0,0.944151849136688,-1,0
16,1,1.5,49,79,-30,1,1.06161448580679,29,0
16,1,1.5,11,52,-41,0,0.967601709038718,-2,0
16,1,1.5,43,60,-17,1,0.900994327152148,10,0
16,1,1.5,47,64,-17,1,0.956998998561176,14,0
16,1,1.5,9,55,-46,0,0.683067480538739,-5,0
16,1,1.5,56,25,31,1,1.37186024143011,-25,0
16,1,1.5,10,81,-71,0,1.21719372921507,-31,0
16,1,1.5,89,22,67,0,0.740627827093704,28,0
16,1,1.5,46,75,-29,0,1.01133252886939,-25,0
16,1,1.5,18,54,-36,0,0.831323614140274,-4,0
16,1,10,44,64,-20,1,6.05888435660745,14,0
16,1,10,25,90,-65,0,5.83634803429595,-40,0
16,1,10,40,89,-49,0,5.21504349584575,-39,0
16,1,10,67,12,55,0,4.77125747231185,38,0
16,1,10,47,78,-31,0,3.8646679931262,-28,0
16,1,10,47,70,-23,0,5.02612977055833,-20,0
16,1,10,41,53,-12,1,3.47761719248956,3,0
16,1,10,55,21,34,0,1.70308048601146,29,0
16,1,10,14,88,-74,0,6.19793400182971,-38,0
16,1,10,9,63,-54,0,4.50603172346018,-13,0
16,1,10,17,72,-55,0,5.77684859221336,-22,0
16,1,10,5,55,-50,0,3.13438811822562,-5,0
16,1,10,88,44,44,1,2.45320914813783,-6,0
16,1,10,45,58,-13,1,5.00660722062457,8,0
16,1,10,89,16,73,0,5.87465891713509,34,0
16,1,10,75,28,47,0,7.99545870421571,22,0
16,1,10,48,70,-22,1,5.18363894554204,20,0
16,1,10,50,100,-50,1,6.25185955231427,50,0
16,1,10,9,96,-87,0,5.62188370118383,-46,0
16,1,10,14,51,-37,0,6.35286846847157,-1,0
16,1,1.5,34,85,-51,0,0.917028704454424,-35,0
16,1,1.5,81,28,53,0,0.835653038986493,22,0
16,1,1.5,49,72,-23,1,1.18973738266504,22,0
16,1,1.5,58,44,14,1,1.19385200412944,-6,0
16,1,1.5,25,77,-52,0,0.709933667531004,-27,0
16,1,1.5,46,66,-20,1,0.869232382072369,16,0
16,1,1.5,2,79,-77,0,1.0779593383777,-29,0
16,1,1.5,45,98,-53,1,1.27864399671671,48,0
16,1,1.5,28,75,-47,0,1.17536534907413,-25,0
16,1,1.5,47,59,-12,1,1.06013945359155,9,0
16,1,1.5,47,54,-7,1,1.07762943554553,4,0
16,1,1.5,70,2,68,0,1.11829619115451,48,0
16,1,1.5,34,76,-42,NaN,NaN,0,0
16,1,1.5,44,63,-19,0,1.14844564447412,-13,0
16,1,1.5,48,57,-9,1,0.730473417905159,7,0
16,1,1.5,19,83,-64,0,0.633258750836831,-33,0
16,1,1.5,2,92,-90,0,0.771221916103968,-42,0
16,1,1.5,5,94,-89,0,0.960660553449998,-44,0
16,1,1.5,1,77,-76,0,0.838084422866814,-27,0
16,1,1.5,77,41,36,0,1.24812981751165,9,0
16,1,10,47,60,-13,1,0.832852897059638,10,0
16,1,10,14,82,-68,0,5.10566237888997,-32,0
16,1,10,62,5,57,0,4.95316039581667,45,0
16,1,10,35,51,-16,1,6.70262925227871,1,0
16,1,10,51,28,23,0,5.55010820811731,22,0
16,1,10,85,24,61,0,5.0995932664664,26,0
16,1,10,89,16,73,0,7.05109021891258,34,0
16,1,10,0,89,-89,0,5.17263082112186,-39,0
16,1,10,39,74,-35,1,4.33737439865945,24,0
16,1,10,14,98,-84,0,4.11956851641298,-48,0
16,1,10,86,11,75,0,4.50964269324322,39,0
16,1,10,86,42,44,0,4.10903435241198,8,0
16,1,10,66,48,18,1,5.62858182837954,-2,0
16,1,10,5,58,-53,0,5.72731734745321,-8,0
16,1,10,44,57,-13,1,5.46210332849296,7,0
16,1,10,61,32,29,1,4.55961747400579,-18,0
16,1,10,26,82,-56,0,5.74112634692574,-32,0
16,1,10,25,92,-67,0,7.72322801858536,-42,0
16,1,10,45,60,-15,1,6.16209519089898,10,0
16,1,10,46,55,-9,1,7.29550569705316,5,0
16,1,1.5,61,9,52,0,0.915118200500729,41,0
16,1,1.5,46,66,-20,1,0.618518692295766,16,0
16,1,1.5,59,12,47,0,0.717230018519331,38,0
16,1,1.5,49,58,-9,1,0.579999970679637,8,0
16,1,1.5,9,86,-77,0,0.664605018333532,-36,0
16,1,1.5,21,69,-48,0,1.242040177749,-19,0
16,1,1.5,98,22,76,0,0.676115694746841,28,0
16,1,1.5,88,12,76,0,0.604722522402881,38,0
16,1,1.5,82,6,76,0,0.608204096963163,44,0
16,1,1.5,48,76,-28,NaN,NaN,0,0
16,1,1.5,49,76,-27,1,0.650382907217136,26,0
16,1,1.5,26,77,-51,0,0.739752851455705,-27,0
16,1,1.5,2,96,-94,0,0.50579382685828,-46,0
16,1,1.5,9,85,-76,0,0.521133208909305,-35,0
16,1,1.5,95,32,63,0,0.751870549080195,18,0
16,1,1.5,43,62,-19,1,0.813257035362767,12,0
16,1,1.5,60,34,26,1,1.0006488088984,-16,0
16,1,1.5,70,48,22,1,0.875995756738121,-2,0
16,1,1.5,24,94,-70,0,0.644755864574108,-44,0
16,1,1.5,48,100,-52,1,0.774698358844034,50,0
16,1,10,36,57,-21,0,1.20507309911773,-7,0
16,1,10,36,84,-48,0,5.26320930942893,-34,0
16,1,10,46,65,-19,1,4.31264121673303,15,0
16,1,10,4,72,-68,0,3.86409579499741,-22,0
16,1,10,100,4,96,0,5.79354094242444,46,0
16,1,10,66,28,38,1,5.06969967111945,-22,0
16,1,10,50,100,-50,1,6.03848866379121,50,0
16,1,10,8,84,-76,0,6.90462839012616,-34,0
16,1,10,12,83,-71,1,1.07213105499977,33,0
16,1,10,89,41,48,1,5.11164644971723,-9,0
16,1,10,47,65,-18,1,4.77452534312033,15,0
16,1,10,47,71,-24,1,4.70733696568641,21,0
16,1,10,48,60,-12,1,6.62677286117105,10,0
16,1,10,20,91,-71,0,6.23758978856495,-41,0
16,1,10,52,28,24,1,7.1916691470542,-22,0
16,1,10,73,3,70,0,4.8359708453645,47,0
16,1,10,58,43,15,1,6.29400940443156,-7,0
16,1,10,59,20,39,0,5.06221674176049,30,0
16,1,10,96,0,96,0,7.36688054143451,50,0
16,1,10,72,1,71,0,7.5390549970034,49,0
16,1,1.5,84,28,56,0,0.771445883467095,22,0
16,1,1.5,44,64,-20,1,0.68812855653232,14,0
16,1,1.5,15,88,-73,0,0.664171012846055,-38,0
16,1,1.5,46,57,-11,1,0.657607046130579,7,0
16,1,1.5,27,94,-67,0,0.763018332334468,-44,0
16,1,1.5,56,32,24,1,1.1437177703192,-18,0
16,1,1.5,100,3,97,0,1.10180361545645,47,0
16,1,1.5,32,71,-39,0,0.988461465138244,-21,0
16,1,1.5,20,97,-77,0,0.791876399336616,-47,0
16,1,1.5,39,88,-49,0,0.747905850148527,-38,0
16,1,1.5,46,67,-21,1,1.12933217402315,17,0
16,1,1.5,92,20,72,0,0.911354009207571,30,0
16,1,1.5,87,42,45,1,1.0381184395228,-8,0
16,1,1.5,97,5,92,0,1.08743158180732,45,0
16,1,1.5,9,88,-79,0,1.07156508837943,-38,0
16,1,1.5,77,29,48,0,0.863618902134476,21,0
16,1,1.5,58,27,31,0,1.04898397257784,23,0
16,1,1.5,53,29,24,0,1.11437181368819,21,0
16,1,1.5,15,51,-36,NaN,NaN,0,0
16,1,1.5,96,11,85,0,1.14518363858224,39,0
17,1,10,48,60,-12,0,5.60368094336536,-10,0
17,1,10,98,38,60,1,6.19155604348066,-12,0
17,1,10,0,68,-68,0,3.71622939732879,-18,0
17,1,10,5,83,-78,0,4.41948495384167,-33,0
17,1,10,48,60,-12,0,3.97475830292456,-10,0
17,1,10,0,68,-68,0,4.05207937377781,-18,0
17,1,10,3,100,-97,0,5.86992142897725,-50,0
17,1,10,25,55,-30,0,4.31925347448123,-5,0
17,1,10,50,100,-50,0,5.38246768361182,-50,0
17,1,10,50,100,-50,0,5.17106672946989,-50,0
17,1,10,53,23,30,1,4.79229355175107,-27,0
17,1,10,100,15,85,1,6.43695312313866,-35,0
17,1,10,100,15,85,1,5.15962105564108,-35,0
17,1,10,100,0,100,1,4.2855388630569,-50,0
17,1,10,100,0,100,1,4.48616054000854,-50,0
17,1,10,85,15,70,1,6.65470867140357,-35,0
17,1,10,30,100,-70,0,5.39273158474475,-50,0
17,1,10,85,15,70,1,5.30129558796307,-35,0
17,1,10,50,43,7,1,6.39719292329301,-7,0
17,1,10,28,85,-57,0,7.67369584381845,-35,0
17,1,1.5,53,40,13,1,0.789852663295733,-10,0
17,1,1.5,25,55,-30,0,0.610424818692763,-5,0
17,1,1.5,53,40,13,1,0.638385985876539,-10,0
17,1,1.5,80,45,35,1,0.57705770122493,-5,0
17,1,1.5,75,0,75,1,0.526392129335363,-50,0
17,1,1.5,75,0,75,1,0.533678505775924,-50,0
17,1,1.5,50,43,7,1,0.852213532836913,-7,0
17,1,1.5,53,23,30,1,0.590244143828841,-27,0
17,1,1.5,98,38,60,1,0.602961029725748,-12,0
17,1,1.5,53,0,53,1,0.518936771128665,-50,0
17,1,1.5,53,0,53,1,0.494240874159686,-50,0
17,1,1.5,48,100,-52,0,0.718874823366377,-50,0
17,1,1.5,28,85,-57,0,0.646198001909625,-35,0
17,1,1.5,30,100,-70,0,0.640829073661052,-50,0
17,1,1.5,80,45,35,1,0.539469705161764,-5,0
17,1,1.5,48,100,-52,0,0.530089201112105,-50,0
17,1,1.5,3,100,-97,0,0.609407995659922,-50,0
17,1,1.5,48,80,-32,0,0.733354471327175,-30,0
17,1,1.5,48,80,-32,0,0.508009039241415,-30,0
17,1,1.5,5,83,-78,0,0.57199741212321,-33,0
17,1,10,21,82,-61,0,1.18128334503263,-32,0
17,1,10,49,100,-51,0,6.04103361124294,-50,0
17,1,10,15,79,-64,0,3.83569987225565,-29,0
17,1,10,51,15,36,1,5.42228103390448,-35,0
17,1,10,49,99,-50,0,4.64148887231249,-49,0
17,1,10,23,51,-28,0,5.2200479820242,-1,0
17,1,10,49,98,-49,0,5.44730756330864,-48,0
17,1,10,59,15,44,1,4.88197741655836,-35,0
17,1,10,51,3,48,1,3.88260532494155,-47,0
17,1,10,72,30,42,1,6.04326079824637,-20,0
17,1,10,36,93,-57,0,4.57322317139551,-43,0
17,1,10,25,86,-61,0,3.65038772334651,-36,0
17,1,10,24,71,-47,0,2.78843446274982,-21,0
17,1,10,49,97,-48,0,4.33705264276841,-47,0
17,1,10,79,29,50,1,3.76761928151609,-21,0
17,1,10,51,0,51,1,4.2209603369372,-50,0
17,1,10,72,21,51,1,3.86433146818035,-29,0
17,1,10,87,48,39,1,3.0101817928562,-2,0
17,1,10,49,99,-50,0,2.78217004110911,-49,0
17,1,10,49,96,-47,0,4.98676480560675,-46,0
17,1,1.5,50,87,-37,0,0.756080502766508,-37,0
17,1,1.5,49,100,-51,0,0.618056123206543,-50,0
17,1,1.5,35,76,-41,0,0.653410700834456,-26,0
17,1,1.5,37,56,-19,0,0.543403204788774,-6,0
17,1,1.5,51,3,48,1,0.582005091446263,-47,0
17,1,1.5,51,4,47,1,0.523303171981979,-46,0
17,1,1.5,38,71,-33,0,0.658634106825048,-21,0
17,1,1.5,60,23,37,1,1.02862976315055,-27,0
17,1,1.5,98,36,62,1,0.557933070757826,-14,0
17,1,1.5,51,1,50,1,0.523912386070378,-49,0
17,1,1.5,51,0,51,1,0.466609239746958,-50,0
17,1,1.5,49,96,-47,0,0.691854968925327,-46,0
17,1,1.5,15,70,-55,1,0.548503448364272,20,0
17,1,1.5,49,97,-48,0,0.635164335683612,-47,0
17,1,1.5,97,42,55,1,0.797113014345086,-8,0
17,1,1.5,88,5,83,1,0.905826571924308,-45,0
17,1,1.5,26,86,-60,0,0.841676181818457,-36,0
17,1,1.5,87,49,38,1,1.06040823208787,-1,0
17,1,1.5,20,81,-61,0,0.653713841659282,-31,0
17,1,1.5,51,2,49,1,0.543672622571421,-48,0
17,1,10,57,0,57,1,5.21559617390085,-50,0
17,1,10,51,4,47,1,6.32341497119796,-46,0
17,1,10,4,83,-79,0,6.29074504097184,-33,0
17,1,10,9,98,-89,0,5.33931098693051,-48,0
17,1,10,49,99,-50,0,7.68924583181342,-49,0
17,1,10,49,97,-48,0,4.97783736329757,-47,0
17,1,10,9,58,-49,0,4.88646221461431,-8,0
17,1,10,51,3,48,1,4.84707663378094,-47,0
17,1,10,90,16,74,1,5.24964288397996,-34,0
17,1,10,87,20,67,1,7.42754072882099,-30,0
17,1,10,49,100,-51,0,7.3101629152834,-50,0
17,1,10,27,55,-28,0,4.27013952908737,-5,0
17,1,10,94,3,91,1,4.11875386027987,-47,0
17,1,10,11,79,-68,0,5.02859017523133,-29,0
17,1,10,49,96,-47,0,6.47927370830666,-46,0
17,1,10,43,56,-13,0,4.71247111089906,-6,0
17,1,10,90,46,44,1,4.3998207546997,-4,0
17,1,10,51,2,49,1,4.45180885633044,-48,0
17,1,10,51,4,47,1,2.63708105076603,-46,0
17,1,10,10,78,-68,0,4.72766590728725,-28,0
17,1,1.5,51,4,47,1,0.536404207316082,-46,0
17,1,1.5,62,49,13,0,0.535028160573347,1,0
17,1,1.5,51,3,48,1,0.557001288440006,-47,0
17,1,1.5,49,97,-48,0,0.70623601364332,-47,0
17,1,1.5,17,98,-81,0,0.633577886481817,-48,0
17,1,1.5,13,82,-69,0,0.59556761928161,-32,0
17,1,1.5,49,100,-51,0,0.59955793490326,-50,0
17,1,1.5,3,74,-71,0,0.618857412013313,-24,0
17,1,1.5,23,83,-60,0,0.645472223392972,-33,0
17,1,1.5,67,44,23,1,0.847528962411616,-6,0
17,1,1.5,10,77,-67,0,0.905417863315506,-27,0
17,1,1.5,24,72,-48,0,0.784729326766865,-22,0
17,1,1.5,31,72,-41,0,0.748732911673414,-22,0
17,1,1.5,80,36,44,1,0.69802005421343,-14,0
17,1,1.5,51,2,49,1,0.898048645487961,-48,0
17,1,1.5,27,53,-26,0,0.7379712291131,-3,0
17,1,1.5,49,96,-47,0,0.647993020796548,-46,0
17,1,1.5,52,18,34,1,0.553910864867703,-32,0
17,1,1.5,51,1,50,1,0.527222009416619,-49,0
17,1,1.5,51,4,47,1,0.533935094140361,-46,0
17,1,10,37,86,-49,0,6.09575841105789,-36,0
17,1,10,51,2,49,1,4.93574660799368,-48,0
17,1,10,79,11,68,1,2.19764048671141,-39,0
17,1,10,51,3,48,1,5.80809096424082,-47,0
17,1,10,23,85,-62,0,6.39539533852258,-35,0
17,1,10,78,14,64,1,6.07939210550921,-36,0
17,1,10,49,97,-48,0,8.47995989890433,-47,0
17,1,10,90,19,71,1,5.13655559445124,-31,0
17,1,10,49,98,-49,0,6.44645129128094,-48,0
17,1,10,99,30,69,1,8.80832702553607,-20,0
17,1,10,49,97,-48,0,4.53089892067965,-47,0
17,1,10,52,50,2,0,8.72159392691992,0,0
17,1,10,60,39,21,1,7.12011781071442,-11,0
17,1,10,51,4,47,1,6.03872065041469,-46,0
17,1,10,63,38,25,1,5.71267381570715,-12,0
17,1,10,49,96,-47,0,4.36728718286122,-46,0
17,1,10,26,91,-65,0,5.25993647605219,-41,0
17,1,10,64,31,33,1,9.46104750366976,-19,0
17,1,10,94,4,90,1,8.11041400532622,-46,0
17,1,10,49,98,-49,NaN,NaN,0,0
17,1,1.5,51,4,47,1,0.614299302996187,-46,0
17,1,1.5,51,0,51,1,0.409589806843996,-50,0
17,1,1.5,51,1,50,1,0.484931481742933,-49,0
17,1,1.5,66,3,63,1,0.572924429228351,-47,0
17,1,1.5,21,90,-69,0,0.609483505950266,-40,0
17,1,1.5,49,97,-48,0,0.708851382186822,-47,0
17,1,1.5,76,10,66,1,0.516134826189045,-40,0
17,1,1.5,49,52,-3,0,0.594814349154603,-2,0
17,1,1.5,36,91,-55,0,0.830744784383569,-41,0
17,1,1.5,53,49,4,1,0.673427892254949,-1,0
17,1,1.5,94,2,92,1,0.59339541549889,-48,0
17,1,1.5,49,97,-48,0,0.573355497680495,-47,0
17,1,1.5,57,0,57,1,0.537988090634371,-50,0
17,1,1.5,23,53,-30,0,0.60804477833517,-3,0
17,1,1.5,9,59,-50,0,0.507301588464998,-9,0
17,1,1.5,100,47,53,1,0.536635136844325,-3,0
17,1,1.5,83,5,78,1,0.590577342147753,-45,0
17,1,1.5,49,98,-49,0,0.570557951398769,-48,0
17,1,1.5,49,99,-50,0,0.655199121734768,-49,0
17,1,1.5,49,96,-47,0,0.664596853860075,-46,0
17,1,10,4,70,-66,0,3.7017702764374,-20,0
17,1,10,51,2,49,1,4.92505310462775,-48,0
17,1,10,51,3,48,NaN,NaN,0,0
17,1,10,58,40,18,1,3.11887628958539,-10,0
17,1,10,74,32,42,1,3.03747802962107,-18,0
17,1,10,49,99,-50,0,2.407499711338,-49,0
17,1,10,14,93,-79,0,3.69074540752626,-43,0
17,1,10,0,95,-95,0,3.05069086417143,-45,0
17,1,10,7,91,-84,0,3.52401648763544,-41,0
17,1,10,51,1,50,1,4.33059321397104,-49,0
17,1,10,51,4,47,1,3.41595686383016,-46,0
17,1,10,98,41,57,1,2.66653776155954,-9,0
17,1,10,49,97,-48,0,2.63507123076261,-47,0
17,1,10,87,8,79,1,2.45986499786477,-42,0
17,1,10,15,61,-46,0,2.90102543707053,-11,0
17,1,10,51,3,48,1,2.59634324925219,-47,0
17,1,10,91,27,64,1,2.46427135319209,-23,0
17,1,10,51,0,51,1,4.60965908570233,-50,0
17,1,10,67,21,46,1,5.2608118089297,-29,0
17,1,10,35,80,-45,0,3.61417174192366,-30,0
17,1,1.5,51,2,49,1,0.562799452367017,-48,0
17,1,1.5,84,40,44,1,0.50409789945752,-10,0
17,1,1.5,49,96,-47,0,0.655366637281077,-46,0
17,1,1.5,51,1,50,1,0.632654168369754,-49,0
17,1,1.5,2,60,-58,0,0.5546824627354,-10,0
17,1,1.5,49,99,-50,0,0.631950383141429,-49,0
17,1,1.5,26,97,-71,0,0.618695028234015,-47,0
17,1,1.5,67,36,31,1,0.909284283412944,-14,0
17,1,1.5,89,5,84,1,0.95653209828788,-45,0
17,1,1.5,92,46,46,1,0.897172212946316,-4,0
17,1,1.5,99,6,93,1,0.567888699298692,-44,0
17,1,1.5,56,22,34,1,1.04456829924084,-28,0
17,1,1.5,95,47,48,1,1.02987458327289,-3,0
17,1,1.5,42,81,-39,0,0.928453267011264,-31,0
17,1,1.5,51,0,51,1,1.08641896114705,-50,0
17,1,1.5,51,1,50,1,1.19048497033691,-49,0
17,1,1.5,51,2,49,1,0.913782643996456,-48,0
17,1,1.5,74,17,57,1,0.824362332095006,-33,0
17,1,1.5,49,96,-47,0,1.34634993887676,-46,0
17,1,1.5,58,15,43,1,0.568306938332626,-35,0
18,1,10,53,40,13,0,3.61234034364247,10,0
18,1,10,100,0,100,1,2.56735376861411,-50,0
18,1,10,25,55,-30,0,4.10869626575027,-5,0
18,1,10,75,0,75,0,1.67667647193571,50,0
18,1,10,53,23,30,1,2.72453644902635,-27,0
18,1,10,85,15,70,0,4.03579894616269,35,0
18,1,10,98,38,60,1,3.80634904925546,-12,0
18,1,10,28,85,-57,0,4.0743228407789,-35,0
18,1,10,100,15,85,0,2.45957351660945,35,0
18,1,10,85,15,70,0,5.55744549828182,35,0
18,1,10,53,0,53,1,5.44339390607115,-50,0
18,1,10,48,100,-52,1,4.69408219931279,50,0
18,1,10,25,55,-30,0,6.69459610538365,-5,0
18,1,10,3,100,-97,0,3.32726432989693,-50,0
18,1,10,50,100,-50,1,7.36641832760597,50,0
18,1,10,53,23,30,1,2.93178648339062,-27,0
18,1,10,80,45,35,1,5.85033090492561,-5,0
18,1,10,30,100,-70,1,5.15627069873995,50,0
18,1,10,5,83,-78,0,4.75423780068718,-33,0
18,1,10,53,40,13,0,5.48010043528075,10,0
18,1,1.5,28,85,-57,0,0.608887422680482,-35,0
18,1,1.5,50,43,7,1,0.500788270332123,-7,0
18,1,1.5,0,68,-68,0,0.388759679266968,-18,0
18,1,1.5,48,60,-12,1,0.345420756013937,10,0
18,1,1.5,3,100,-97,0,0.488045452462757,-50,0
18,1,1.5,98,38,60,1,0.728647697594624,-12,0
18,1,1.5,48,60,-12,0,0.67998130584192,-10,0
18,1,1.5,100,15,85,1,0.67326973654076,-35,0
18,1,1.5,100,0,100,1,0.714603253150017,-50,0
18,1,1.5,48,100,-52,0,0.658520412371217,-50,0
18,1,1.5,0,68,-68,0,0.996565406643867,-18,0
18,1,1.5,48,80,-32,1,0.393194959908215,30,0
18,1,1.5,48,80,-32,0,0.381886460481155,-30,0
18,1,1.5,50,100,-50,1,0.53842364261186,50,0
18,1,1.5,5,83,-78,0,0.521152073310304,-33,0
18,1,1.5,75,0,75,1,0.568449392898174,-50,0
18,1,1.5,50,43,7,1,0.861728109965725,-7,0
18,1,1.5,53,0,53,0,0.919598625429671,50,0
18,1,1.5,30,100,-70,1,0.406943596792644,50,0
18,1,1.5,80,45,35,0,0.658941214203878,5,0
18,1,10,75,0,75,1,3.2710979152348,-50,0
18,1,10,71,40,31,1,2.06434382588759,-10,0
18,1,10,48,100,-52,1,5.28957580756014,50,0
18,1,10,13,75,-62,0,3.05025172966771,-25,0
18,1,10,31,93,-62,0,4.32407679266908,-43,0
18,1,10,25,63,-38,0,4.93137777777793,-13,0
18,1,10,22,57,-35,0,3.91466849942708,-7,0
18,1,10,2,91,-89,0,2.27397498281789,-41,0
18,1,10,32,97,-65,0,4.85776458190139,-47,0
18,1,10,85,15,70,1,5.13170914089324,-35,0
18,1,10,28,52,-24,0,4.08905896907208,-2,0
18,1,10,29,61,-32,0,2.91360036655215,-11,0
18,1,10,35,81,-46,0,4.02557104238258,-31,0
18,1,10,7,92,-85,0,1.38886927835074,-42,0
18,1,10,84,5,79,0,4.08804252004575,45,0
18,1,10,0,97,-97,0,4.05667298969047,-47,0
18,1,10,75,0,75,0,4.39459372279498,50,0
18,1,10,48,80,-32,1,3.28724343642625,30,0
18,1,10,64,16,48,1,6.51171555555538,-34,0
18,1,10,30,100,-70,0,4.40773534936989,-50,0
18,1,1.5,84,5,79,0,0.924414020618769,45,0
18,1,1.5,20,57,-37,0,0.755651592210597,-7,0
18,1,1.5,27,57,-30,0,0.729615395189285,-7,0
18,1,1.5,9,73,-64,0,0.64895010309283,-23,0
18,1,1.5,93,44,49,1,1.2269184879724,-6,0
18,1,1.5,55,27,28,0,0.814270973653947,23,0
18,1,1.5,14,92,-78,0,0.713546483390928,-42,0
18,1,1.5,100,15,85,0,1.48147867124862,35,0
18,1,1.5,15,67,-52,0,0.706155326460703,-17,0
18,1,1.5,48,100,-52,1,0.802098510881933,50,0
18,1,1.5,60,4,56,NaN,NaN,0,0
18,1,1.5,74,30,44,0,0.788077525773133,20,0
18,1,1.5,40,95,-55,0,1.000710744559,-45,0
18,1,1.5,16,64,-48,0,0.820696998854601,-14,0
18,1,1.5,75,0,75,0,0.455972142039172,50,0
18,1,1.5,49,100,-51,1,0.657955922107703,50,0
18,1,1.5,54,11,43,0,0.339911477663463,39,0
18,1,1.5,53,0,53,1,0.674591523482377,-50,0
18,1,1.5,49,81,-32,1,0.795827903779809,31,0
18,1,1.5,90,42,48,0,0.384537731958972,8,0
18,1,10,94,5,89,0,2.74517369988553,45,0
18,1,10,11,54,-43,0,3.11104439862538,-4,0
18,1,10,30,99,-69,1,3.67095642611685,49,0
18,1,10,66,41,25,1,3.72025585337906,-9,0
18,1,10,75,0,75,0,2.29560265750297,50,0
18,1,10,50,100,-50,1,2.91881750286348,50,0
18,1,10,14,57,-43,0,1.51746162657491,-7,0
18,1,10,8,56,-48,0,3.84261828178705,-6,0
18,1,10,51,30,21,1,5.34121237113413,-20,0
18,1,10,100,15,85,0,3.8512384879723,35,0
18,1,10,30,100,-70,0,3.84376632302383,-50,0
18,1,10,50,11,39,0,1.99778382588784,39,0
18,1,10,39,87,-48,0,4.92168027491425,-37,0
18,1,10,84,5,79,0,3.77633466208454,45,0
18,1,10,99,25,74,0,2.60556022909532,25,0
18,1,10,36,84,-48,0,2.02488668957631,-34,0
18,1,10,80,18,62,1,4.64413910652911,-32,0
18,1,10,7,89,-82,0,1.43009429553285,-39,0
18,1,10,2,59,-57,0,4.46393731958779,-9,0
18,1,10,90,42,48,0,5.65716453608275,8,0
18,1,1.5,44,96,-52,0,0.540581901489077,-46,0
18,1,1.5,49,100,-51,0,0.314505750286571,-50,0
18,1,1.5,98,24,74,0,0.521780710194889,26,0
18,1,1.5,81,47,34,1,0.592468820160775,-3,0
18,1,1.5,26,53,-27,0,0.805007835051128,-3,0
18,1,1.5,75,35,40,0,0.608439129438921,15,0
18,1,1.5,37,83,-46,0,0.747761191294558,-33,0
18,1,1.5,30,99,-69,0,0.665027812141943,-49,0
18,1,1.5,19,70,-51,0,0.746343734249422,-20,0
18,1,1.5,55,27,28,1,0.792285910652936,-23,0
18,1,1.5,39,82,-43,0,0.660256769759599,-32,0
18,1,1.5,54,6,48,1,0.653525040091608,-44,0
18,1,1.5,49,100,-51,0,0.566853424971214,-50,0
18,1,1.5,100,25,75,0,0.323550057273678,25,0
18,1,1.5,93,31,62,1,0.992146620847507,-19,0
18,1,1.5,95,42,53,0,0.308127743413479,8,0
18,1,1.5,54,11,43,0,0.539395005727329,39,0
18,1,1.5,81,33,48,0,0.505465841924433,17,0
18,1,1.5,9,64,-55,0,0.384699381443625,-14,0
18,1,1.5,84,5,79,0,0.340721924398622,45,0
18,1,10,58,40,18,1,3.32929979381424,-10,0
18,1,10,8,74,-66,0,2.91194208476509,-24,0
18,1,10,41,58,-17,1,2.69526249713635,8,0
18,1,10,21,51,-30,0,1.74321081328753,-1,0
18,1,10,35,87,-52,0,2.41963693012622,-37,0
18,1,10,24,99,-75,0,1.93434941580745,-49,0
18,1,10,90,42,48,0,6.06817796105361,8,0
18,1,10,95,42,53,0,4.08479376861396,8,0
18,1,10,55,27,28,0,4.26874758304712,23,0
18,1,10,16,92,-76,0,5.22937951890026,-42,0
18,1,10,21,55,-34,0,5.76733434135167,-5,0
18,1,10,23,74,-51,0,4.79584366552081,-24,0
18,1,10,94,5,89,0,4.82377310423863,45,0
18,1,10,64,12,52,0,4.44970300114574,38,0
18,1,10,94,28,66,0,4.95492142038938,22,0
18,1,10,82,26,56,0,5.42425621993152,24,0
18,1,10,15,65,-50,0,6.7788136540662,-15,0
18,1,10,37,90,-53,0,4.92743184421533,-40,0
18,1,10,50,100,-50,1,5.85393814433019,50,0
18,1,10,75,35,40,0,6.33520714776614,15,0
18,1,1.5,100,39,61,0,0.926000458190174,11,0
18,1,1.5,98,24,74,0,0.724603528064108,26,0
18,1,1.5,83,43,40,NaN,NaN,0,0
18,1,1.5,88,34,54,0,0.690572462772252,16,0
18,1,1.5,75,35,40,0,0.562487789232364,15,0
18,1,1.5,82,26,56,0,0.423828453608166,24,0
18,1,1.5,52,22,30,0,0.570417044673377,28,0
18,1,1.5,13,53,-40,0,0.367111477663457,-3,0
18,1,1.5,5,92,-87,0,0.499654524627658,-42,0
18,1,1.5,84,1,83,0,0.322963940435329,49,0
18,1,1.5,55,10,45,0,0.401001053837263,40,0
18,1,1.5,86,9,77,0,0.532303688430602,41,0
18,1,1.5,2,93,-91,0,0.402268957617252,-43,0
18,1,1.5,48,80,-32,0,0.437592119129476,-30,0
18,1,1.5,52,47,5,0,0.327535945017189,3,0
18,1,1.5,82,26,56,0,0.502193997709128,24,0
18,1,1.5,74,33,41,0,0.357474089347306,17,0
18,1,1.5,100,39,61,0,0.29083234822474,11,0
18,1,1.5,100,50,50,0,0.474831615120365,0,0
18,1,1.5,16,58,-42,0,0.352837571592318,-8,0
18,1,10,95,42,53,0,3.19940838487992,8,0
18,1,10,46,100,-54,0,5.25065750286376,-50,0
18,1,10,2,55,-53,0,2.81991697594503,-5,0
18,1,10,73,48,25,0,1.510600137457,2,0
18,1,10,84,1,83,0,2.66042318442169,49,0
18,1,10,91,23,68,0,4.93367532646062,27,0
18,1,10,0,58,-58,0,3.5716471935857,-8,0
18,1,10,82,26,56,0,4.14421150057296,24,0
18,1,10,61,14,47,0,5.45409686139737,36,0
18,1,10,59,27,32,0,4.70342414662082,23,0
18,1,10,39,70,-31,1,2.98944843069876,20,0
18,1,10,74,30,44,0,1.06529539518897,20,0
18,1,10,7,53,-46,0,0.34395931271456,-3,0
18,1,10,8,90,-82,0,1.33382121420391,-40,0
18,1,10,6,85,-79,0,4.49768064146656,-35,0
18,1,10,48,98,-50,0,3.7455582130583,-48,0
18,1,10,90,16,74,0,5.11153081328757,34,0
18,1,10,32,70,-38,0,7.33473502863671,-20,0
18,1,10,61,14,47,0,5.59604490263473,36,0
18,1,10,98,24,74,0,6.79185961053827,26,0
18,1,1.5,87,39,48,0,0.371887285223693,11,0
18,1,1.5,62,25,37,0,0.296464421534893,25,0
18,1,1.5,13,50,-37,0,0.287822955326646,0,0
18,1,1.5,82,15,67,0,0.287800595647241,35,0
18,1,1.5,90,42,48,0,0.311788865978997,8,0
18,1,1.5,17,54,-37,0,0.327104879725084,-4,0
18,1,1.5,53,40,13,0,0.2617548682706,10,0
18,1,1.5,100,25,75,0,0.287057961053961,25,0
18,1,1.5,10,63,-53,0,0.247002245131625,-13,0
18,1,1.5,59,18,41,0,0.648928109965709,32,0
18,1,1.5,57,17,40,0,0.345631523482098,33,0
18,1,1.5,4,90,-86,0,0.142952027491447,-40,0
18,1,1.5,48,100,-52,0,0.428884306987584,-50,0
18,1,1.5,83,39,44,0,0.335578465063008,11,0
18,1,1.5,44,78,-34,0,0.317560595647137,-28,0
18,1,1.5,72,4,68,0,0.0762237800690855,46,0
18,1,1.5,99,25,74,0,0.332837754868251,25,0
18,1,1.5,38,93,-55,0,0.322833081328554,-43,0
18,1,1.5,72,16,56,0,0.561446048110156,34,0
18,1,1.5,75,35,40,0,0.686767285223596,15,0
19,1,10,100,15,85,1,2.03755903823367,-35,0
19,1,10,80,45,35,1,3.63025726649084,-5,0
19,1,10,0,68,-68,0,1.98573515315593,-18,0
19,1,10,100,15,85,0,3.38128701058076,35,0
19,1,10,50,43,7,1,2.77869803398335,-7,0
19,1,10,5,83,-78,0,2.60815474477704,-33,0
19,1,10,98,38,60,0,3.26019892929344,12,0
19,1,10,85,15,70,0,3.17435655885674,35,0
19,1,10,53,23,30,0,2.65175387311001,27,0
19,1,10,98,38,60,0,2.5977687808936,12,0
19,1,10,50,100,-50,0,2.08256133836494,-50,0
19,1,10,75,0,75,1,2.77937066205277,-50,0
19,1,10,100,0,100,1,2.32074095388543,-50,0
19,1,10,25,55,-30,0,1.83104865831774,-5,0
19,1,10,100,0,100,0,3.19447565251357,50,0
19,1,10,0,68,-68,0,3.10316941613337,-18,0
19,1,10,30,100,-70,0,2.08733168261506,-50,0
19,1,10,75,0,75,0,2.20002089362379,50,0
19,1,10,30,100,-70,0,2.11608827372856,-50,0
19,1,10,85,15,70,0,4.21947688963564,35,0
19,1,1.5,53,40,13,0,1.1764598503355,10,0
19,1,1.5,48,60,-12,0,1.23785741384609,-10,0
19,1,1.5,53,0,53,1,1.32046713744512,-50,0
19,1,1.5,53,23,30,1,1.04789331788879,-27,0
19,1,1.5,80,45,35,1,1.21863711257447,-5,0
19,1,1.5,48,100,-52,0,1.32598965215811,-50,0
19,1,1.5,3,100,-97,0,0.741413545299565,-50,0
19,1,1.5,5,83,-78,0,0.652138389101765,-33,0
19,1,1.5,3,100,-97,0,0.766146830858361,-50,0
19,1,1.5,28,85,-57,0,1.13152682906275,-35,0
19,1,1.5,48,60,-12,0,0.826996761488317,-10,0
19,1,1.5,53,40,13,1,1.42234554755032,-10,0
19,1,1.5,48,100,-52,0,0.897729376251846,-50,0
19,1,1.5,50,43,7,1,1.1944514598963,-7,0
19,1,1.5,48,80,-32,0,0.951137877757901,-30,0
19,1,1.5,25,55,-30,0,1.24512509599163,-5,0
19,1,1.5,53,0,53,NaN,NaN,0,0
19,1,1.5,48,80,-32,1,0.943455622126294,30,0
19,1,1.5,50,100,-50,0,1.03004136570962,-50,0
19,1,1.5,28,85,-57,0,0.737423962787034,-35,0
19,1,10,98,38,60,1,1.70294655081125,-12,0
19,1,10,85,15,70,1,1.6389691745735,-35,0
19,1,10,5,75,-70,0,1.33647641861307,-25,0
19,1,10,52,42,10,1,8.83797581104864,-8,0
19,1,10,75,22,53,0,9.66477939815377,28,0
19,1,10,48,80,-32,0,3.05909156722328,-30,0
19,1,10,43,80,-37,0,3.98119720465274,-30,0
19,1,10,69,15,54,0,3.13865008861467,35,0
19,1,10,8,64,-56,0,3.51341792196445,-14,0
19,1,10,23,60,-37,0,2.81757556985531,-10,0
19,1,10,36,63,-27,0,4.08422586374081,-13,0
19,1,10,49,97,-48,0,2.74100703601925,-47,0
19,1,10,6,89,-83,0,4.52388086235669,-39,0
19,1,10,34,56,-22,0,3.81127559239849,-6,0
19,1,10,49,98,-49,0,2.76742684024293,-48,0
19,1,10,58,19,39,0,2.29284979866952,31,0
19,1,10,41,75,-34,0,2.16560542940988,-25,0
19,1,10,51,0,51,0,3.907656413518,50,0
19,1,10,51,4,47,0,5.3395987324534,46,0
19,1,10,33,64,-31,0,1.89054710137589,-14,0
19,1,1.5,3,77,-74,1,0.936079439757577,27,0
19,1,1.5,75,22,53,1,1.19088268230144,-28,0
19,1,1.5,25,88,-63,0,1.17963531462283,-38,0
19,1,1.5,1,96,-95,1,0.801045414307737,46,0
19,1,1.5,16,63,-47,0,1.35698625969326,-13,0
19,1,1.5,65,40,25,1,1.13916436500813,-10,0
19,1,1.5,73,2,71,1,1.44180997432295,-48,0
19,1,1.5,58,19,39,1,1.06860403100336,-31,0
19,1,1.5,57,1,56,NaN,NaN,0,0
19,1,1.5,85,15,70,0,0.980836148169146,35,0
19,1,1.5,18,83,-65,0,0.848865054681028,-33,0
19,1,1.5,45,86,-41,0,0.931488340807846,-36,0
19,1,1.5,1,96,-95,0,0.706879683883017,-46,0
19,1,1.5,90,28,62,1,1.03497482684861,-22,0
19,1,1.5,67,10,57,1,0.821704443193994,-40,0
19,1,1.5,58,19,39,1,0.665002996585372,-31,0
19,1,1.5,53,29,24,1,0.627129087773483,-21,0
19,1,1.5,47,72,-25,1,0.550502638277976,22,0
19,1,1.5,86,7,79,1,0.716508712091127,-43,0
19,1,1.5,51,4,47,1,0.987909922821927,-46,0
19,1,10,17,72,-55,0,2.50634194798204,-22,0
19,1,10,51,4,47,0,3.0903172715125,46,0
19,1,10,50,96,-46,0,1.779171622793,-46,0
19,1,10,51,2,49,1,3.60845385349876,-48,0
19,1,10,49,100,-51,0,1.03597222247663,-50,0
19,1,10,67,39,28,0,3.91744709239583,11,0
19,1,10,58,23,35,0,7.68482884639707,27,0
19,1,10,69,16,53,0,3.75774209570363,34,0
19,1,10,51,3,48,0,2.35591445343925,47,0
19,1,10,31,95,-64,0,3.37793926553422,-45,0
19,1,10,69,17,52,0,7.67860584544951,33,0
19,1,10,58,23,35,0,3.8081873681549,27,0
19,1,10,58,0,58,0,3.10767034260016,50,0
19,1,10,30,80,-50,0,1.43582560055393,-30,0
19,1,10,29,87,-58,0,7.56517985927985,-37,0
19,1,10,66,18,48,1,8.73077319238064,-32,0
19,1,10,14,83,-69,0,9.72165000980522,-33,0
19,1,10,53,40,13,1,2.97667171901367,-10,0
19,1,10,51,4,47,0,6.32529466424467,46,0
19,1,10,72,23,49,1,6.22080821669215,-27,0
19,1,1.5,53,23,30,1,0.899807742004214,-27,0
19,1,1.5,18,61,-43,0,0.771841626330115,-11,0
19,1,1.5,38,53,-15,0,1.08051376321646,-3,0
19,1,1.5,16,79,-63,0,0.881934163091046,-29,0
19,1,1.5,1,96,-95,0,0.762012459198104,-46,0
19,1,1.5,87,8,79,1,0.799397017343381,-42,0
19,1,1.5,69,16,53,1,0.802794980398176,-34,0
19,1,1.5,69,29,40,1,0.85423581570376,-21,0
19,1,1.5,76,7,69,1,0.807584385498558,-43,0
19,1,1.5,94,43,51,1,0.866931807976471,-7,0
19,1,1.5,44,99,-55,0,0.979020602213041,-49,0
19,1,1.5,51,3,48,1,0.975656728754984,-47,0
19,1,1.5,75,22,53,1,1.44445576691533,-28,0
19,1,1.5,13,98,-85,0,0.71048621662294,-48,0
19,1,1.5,58,19,39,1,0.869902368127441,-31,0
19,1,1.5,30,96,-66,0,0.830563339754008,-46,0
19,1,1.5,73,10,63,1,0.705384506828068,-40,0
19,1,1.5,79,42,37,1,0.904615108289363,-8,0
19,1,1.5,46,50,-4,1,1.27211965815104,0,0
19,1,1.5,3,70,-67,0,0.568828545821816,-20,0
19,1,10,71,34,37,1,1.85111936674002,-16,0
19,1,10,51,2,49,0,1.81070450001016,48,0
19,1,10,51,4,47,0,3.31811752113663,46,0
19,1,10,51,3,48,0,1.74897190540696,47,0
19,1,10,50,66,-16,0,1.61037973245175,-16,0
19,1,10,4,100,-96,0,3.00445987232888,-50,0
19,1,10,11,56,-45,0,3.64862459472806,-6,0
19,1,10,59,15,44,0,2.85079973094844,35,0
19,1,10,9,60,-51,0,1.25214718641655,-10,0
19,1,10,49,98,-49,0,1.58153040297202,-48,0
19,1,10,9,64,-55,0,5.44964948196639,-14,0
19,1,10,72,32,40,1,1.77116899826069,-18,0
19,1,10,35,69,-34,0,3.51070614950686,-19,0
19,1,10,10,75,-65,NaN,NaN,0,0
19,1,10,52,43,9,1,1.92976993187585,-7,0
19,1,10,53,40,13,1,1.6153029300558,-10,0
19,1,10,25,95,-70,0,1.86483548103888,-45,0
19,1,10,2,95,-93,0,4.76899716103298,-45,0
19,1,10,69,15,54,1,3.90985940790415,-35,0
19,1,10,1,96,-95,0,4.49329699553346,-46,0
19,1,1.5,51,2,49,1,1.09016221882939,-48,0
19,1,1.5,51,3,48,1,0.650239268649784,-47,0
19,1,1.5,83,25,58,1,0.635688875611322,-25,0
19,1,1.5,40,70,-30,0,1.00570322623207,-20,0
19,1,1.5,49,98,-49,0,1.02504522369918,-48,0
19,1,1.5,0,86,-86,0,0.851796393467339,-36,0
19,1,1.5,68,27,41,NaN,NaN,0,0
19,1,1.5,19,71,-52,1,1.06860659688709,21,0
19,1,1.5,45,87,-42,0,0.997225546670506,-37,0
19,1,1.5,51,1,50,1,0.953364698206315,-49,0
19,1,1.5,49,98,-49,1,0.886142212268169,48,0
19,1,1.5,86,9,77,1,1.21414388375797,-41,0
19,1,1.5,51,2,49,1,0.985528416244961,-48,0
19,1,1.5,76,47,29,1,0.741586925723368,-3,0
19,1,1.5,44,57,-13,0,0.931624699196163,-7,0
19,1,1.5,52,20,32,1,0.906360642277377,-30,0
19,1,1.5,95,29,66,1,0.793718350283598,-21,0
19,1,1.5,35,88,-53,0,0.853820142553559,-38,0
19,1,1.5,49,100,-51,0,0.671187509278298,-50,0
19,1,1.5,49,97,-48,0,0.727939723728014,-47,0
19,1,10,51,1,50,0,5.86803550449849,49,0
19,1,10,51,2,49,0,5.97272905551699,48,0
19,1,10,49,53,-4,1,6.56958841393589,3,0
19,1,10,49,98,-49,0,5.95040073604241,-48,0
19,1,10,67,43,24,1,6.94792869042794,-7,0
19,1,10,70,49,21,1,5.16205681232941,-1,0
19,1,10,64,4,60,0,4.56757492838415,46,0
19,1,10,99,36,63,1,6.06830418917161,-14,0
19,1,10,49,96,-47,0,4.05311709043463,-46,0
19,1,10,29,87,-58,0,4.56595072403752,-37,0
19,1,10,36,60,-24,0,4.43410939095111,-10,0
19,1,10,51,47,4,0,4.85223442646065,3,0
19,1,10,51,1,50,0,4.62971916403512,49,0
19,1,10,66,32,34,1,4.34442552614382,-18,0
19,1,10,51,3,48,0,2.97458638872013,47,0
19,1,10,70,24,46,1,4.49936164480459,-26,0
19,1,10,49,99,-50,0,3.69077693123972,-49,0
19,1,10,35,54,-19,0,5.01888600328812,-4,0
19,1,10,20,95,-75,0,4.18171404693021,-45,0
19,1,10,49,98,-49,0,2.25855713031615,-48,0
19,1,1.5,49,99,-50,0,1.26666129052956,-49,0
19,1,1.5,49,98,-49,0,1.08343520502331,-48,0
19,1,1.5,37,59,-22,0,0.891515905729648,-9,0
19,1,1.5,85,19,66,1,0.939528353930655,-31,0
19,1,1.5,49,97,-48,0,0.7289345534723,-47,0
19,1,1.5,51,1,50,0,1.03957875521655,49,0
19,1,1.5,49,53,-4,0,1.22498400904669,-3,0
19,1,1.5,40,93,-53,0,1.0270785032103,-43,0
19,1,1.5,20,62,-42,0,0.765793838580521,-12,0
19,1,1.5,97,6,91,1,0.946551910575636,-44,0
19,1,1.5,51,3,48,0,0.919940398188373,47,0
19,1,1.5,49,97,-48,0,0.95858370553924,-47,0
19,1,1.5,44,98,-54,0,0.931320825261537,-48,0
19,1,1.5,71,19,52,NaN,NaN,0,0
19,1,1.5,49,96,-47,0,0.832886930671975,-46,0
19,1,1.5,80,33,47,1,0.818945385166899,-17,0
19,1,1.5,16,97,-81,0,0.589576647526428,-47,0
19,1,1.5,49,99,-50,0,0.73760174186873,-49,0
19,1,1.5,37,84,-47,0,0.671025858608573,-34,0
19,1,1.5,13,95,-82,0,0.455724761327019,-45,0
20,1,10,80,45,35,1,1.83158089589597,-5,0
20,1,10,25,55,-30,1,1.41007145985895,5,0
20,1,10,3,100,-97,0,4.24456243436362,-50,0
20,1,10,50,43,7,1,3.04727897203429,-7,0
20,1,10,53,23,30,1,3.32184245107874,-27,0
20,1,10,75,0,75,0,2.57718123019458,50,0
20,1,10,48,80,-32,1,3.92647863626917,30,0
20,1,10,98,38,60,1,3.71770074832148,-12,0
20,1,10,80,45,35,1,3.58099669917374,-5,0
20,1,10,48,80,-32,1,3.37031162656876,30,0
20,1,10,48,100,-52,0,3.79944650224297,-50,0
20,1,10,53,40,13,1,3.31553990773864,-10,0
20,1,10,85,15,70,0,4.25086754358745,35,0
20,1,10,48,60,-12,1,4.05274210486823,10,0
20,1,10,50,43,7,1,3.78271034289446,-7,0
20,1,10,25,55,-30,0,4.51539621825395,-5,0
20,1,10,100,15,85,0,3.41929141290348,35,0
20,1,10,98,38,60,0,3.34256086184359,12,0
20,1,10,53,23,30,0,4.91721359698386,27,0
20,1,10,3,100,-97,0,3.60447966628817,-50,0
20,1,1.5,100,0,100,1,0.783759789303986,-50,0
20,1,1.5,75,0,75,NaN,NaN,0,0
20,1,1.5,50,100,-50,0,0.835720765880069,-50,0
20,1,1.5,53,0,53,0,0.870257559735364,50,0
20,1,1.5,100,0,100,0,1.26355510510075,50,0
20,1,1.5,53,0,53,1,0.977602768221914,-50,0
20,1,1.5,48,60,-12,0,1.01485390041853,-10,0
20,1,1.5,50,100,-50,0,1.19481874781195,-50,0
20,1,1.5,28,85,-57,0,1.19142774929878,-35,0
20,1,1.5,0,68,-68,0,1.06009592739247,-18,0
20,1,1.5,5,83,-78,0,0.982147314711256,-33,0
20,1,1.5,85,15,70,1,0.954790596402745,-35,0
20,1,1.5,28,85,-57,1,1.41677941281523,35,0
20,1,1.5,100,15,85,NaN,NaN,0,0
20,1,1.5,48,100,-52,1,1.11539291926056,50,0
20,1,1.5,30,100,-70,0,0.754588258149852,-50,0
20,1,1.5,5,83,-78,0,0.904572954486866,-33,0
20,1,1.5,0,68,-68,0,0.664563130817442,-18,0
20,1,1.5,30,100,-70,0,1.13860133682556,-50,0
20,1,1.5,53,40,13,1,0.593242562144951,-10,0
20,1,10,48,55,-7,1,3.95782823608351,5,0
20,1,10,97,0,97,0,1.40368021025643,50,0
20,1,10,9,70,-61,0,4.68618839817373,-20,0
20,1,10,48,100,-52,1,1.72689907463246,50,0
20,1,10,51,6,45,0,2.16555961005906,44,0
20,1,10,98,38,60,0,6.41864737610831,12,0
20,1,10,48,80,-32,1,2.63000434367495,30,0
20,1,10,6,86,-80,0,2.073390503665,-36,0
20,1,10,46,78,-32,1,2.8107055996752,28,0
20,1,10,93,17,76,0,2.68661433485886,33,0
20,1,10,48,57,-9,1,2.45391654646664,7,0
20,1,10,53,0,53,0,2.1598332908743,50,0
20,1,10,4,100,-96,1,2.33385261930835,50,0
20,1,10,28,78,-50,0,2.4924766458771,-28,0
20,1,10,51,6,45,0,2.10908817659129,44,0
20,1,10,12,73,-61,0,2.86102587693676,-23,0
20,1,10,96,27,69,1,2.84696300179075,-23,0
20,1,10,8,90,-82,0,3.48171606298183,-40,0
20,1,10,63,32,31,0,3.04287115048737,18,0
20,1,10,15,95,-80,0,2.32556151614426,-45,0
20,1,1.5,93,17,76,0,1.17624358299963,33,0
20,1,1.5,1,93,-92,0,0.981387446597182,-43,0
20,1,1.5,7,73,-66,0,0.994755333830653,-23,0
20,1,1.5,69,39,30,1,0.871508244734287,-11,0
20,1,1.5,48,100,-52,0,1.1688388093562,-50,0
20,1,1.5,63,26,37,1,1.45415370742649,-24,0
20,1,1.5,55,11,44,0,1.04802161207135,39,0
20,1,1.5,96,49,47,NaN,NaN,0,0
20,1,1.5,48,80,-32,0,1.0107459207029,-30,0
20,1,1.5,6,80,-74,1,0.774669230107065,30,0
20,1,1.5,48,60,-12,1,1.10659083869632,10,0
20,1,1.5,36,66,-30,0,1.3385771442081,-16,0
20,1,1.5,58,25,33,1,1.08927002443124,-25,0
20,1,1.5,6,94,-88,0,0.737850999136754,-44,0
20,1,1.5,93,17,76,1,1.18449619791045,-33,0
20,1,1.5,46,78,-32,0,0.813190474706971,-28,0
20,1,1.5,38,74,-36,0,1.23316587887894,-24,0
20,1,1.5,50,28,22,1,0.979855980616776,-22,0
20,1,1.5,72,2,70,0,0.985065090970238,48,0
20,1,1.5,49,96,-47,0,0.949776859762096,-46,0
20,1,10,8,95,-87,0,1.62495761710034,-45,0
20,1,10,19,56,-37,0,3.0340492759633,-6,0
20,1,10,72,2,70,0,2.12472247219193,48,0
20,1,10,1,60,-59,0,3.76251353961834,-10,0
20,1,10,94,24,70,0,4.23262411087489,26,0
20,1,10,81,40,41,0,2.91522577026899,10,0
20,1,10,100,0,100,0,1.98649392160496,50,0
20,1,10,36,82,-46,0,2.72710727776303,-32,0
20,1,10,55,11,44,0,2.42983719468248,39,0
20,1,10,98,22,76,1,2.65709127764512,-28,0
20,1,10,48,80,-32,0,2.2330848702677,-30,0
20,1,10,25,80,-55,0,2.32363197164341,-30,0
20,1,10,45,74,-29,0,2.45813925783659,-24,0
20,1,10,13,92,-79,0,1.8043235139412,-42,0
20,1,10,57,44,13,0,4.5340985775847,6,0
20,1,10,13,93,-80,0,3.76471873333321,-43,0
20,1,10,97,0,97,0,1.93809329186388,50,0
20,1,10,41,62,-21,1,2.32866660190939,12,0
20,1,10,5,91,-86,0,1.27132313455695,-41,0
20,1,10,55,11,44,0,3.95107373066639,39,0
20,1,1.5,10,91,-81,0,0.80517722008517,-41,0
20,1,1.5,37,91,-54,0,0.849170028279332,-41,0
20,1,1.5,41,62,-21,1,1.1931718170672,12,0
20,1,1.5,72,2,70,0,1.22906779614459,48,0
20,1,1.5,22,74,-52,0,0.967698823908904,-24,0
20,1,1.5,89,6,83,0,0.78041241081246,44,0
20,1,1.5,13,51,-38,0,1.07299792346657,-1,0
20,1,1.5,81,40,41,0,1.02468856587257,10,0
20,1,1.5,69,14,55,0,1.14028052439335,36,0
20,1,1.5,83,3,80,0,0.754268255804163,47,0
20,1,1.5,15,87,-72,0,1.00754406446958,-37,0
20,1,1.5,30,80,-50,0,1.25888922897047,-30,0
20,1,1.5,11,54,-43,0,0.796244279453276,-4,0
20,1,1.5,97,0,97,0,0.792182119090285,50,0
20,1,1.5,17,59,-42,0,0.623494330313406,-9,0
20,1,1.5,85,15,70,0,0.8027784854321,35,0
20,1,1.5,99,26,73,0,0.870000604815687,24,0
20,1,1.5,48,80,-32,0,1.20674460843748,-30,0
20,1,1.5,41,73,-32,0,1.20206333700571,-23,0
20,1,1.5,65,36,29,0,1.12538447017232,14,0
20,1,10,100,0,100,0,1.53261256439873,50,0
20,1,10,48,55,-7,1,5.28907171828087,5,0
20,1,10,49,77,-28,1,3.40908982608744,27,0
20,1,10,46,65,-19,1,3.02040280707661,15,0
20,1,10,53,23,30,0,3.50303122497098,27,0
20,1,10,96,46,50,1,2.86226886428449,-4,0
20,1,10,63,18,45,0,2.74365832693366,32,0
20,1,10,67,14,53,1,6.05351553550918,-36,0
20,1,10,71,15,56,0,5.11881654115223,35,0
20,1,10,5,75,-70,0,4.35744335353684,-25,0
20,1,10,70,39,31,1,5.87403307424029,-11,0
20,1,10,46,65,-19,1,3.99465856336155,15,0
20,1,10,48,55,-7,1,2.42265052114908,5,0
20,1,10,28,59,-31,1,3.51321081849892,9,0
20,1,10,7,87,-80,0,3.16854116685317,-37,0
20,1,10,55,41,14,0,4.19716176613383,9,0
20,1,10,2,78,-76,0,2.78492873258165,-28,0
20,1,10,50,40,10,1,2.82101641982263,-10,0
20,1,10,55,11,44,0,2.16768159583262,39,0
20,1,10,42,93,-51,1,3.89920769178661,43,0
20,1,1.5,0,58,-58,0,0.946971249273702,-8,0
20,1,1.5,78,47,31,1,1.08894745620091,-3,0
20,1,1.5,1,69,-68,0,1.06491099132927,-19,0
20,1,1.5,55,11,44,1,0.882210178860078,-39,0
20,1,1.5,84,20,64,0,1.33876628648886,30,0
20,1,1.5,54,6,48,0,1.3127797500465,44,0
20,1,1.5,49,77,-28,0,1.24810115446417,-27,0
20,1,1.5,77,38,39,1,0.930059143617655,-12,0
20,1,1.5,93,17,76,NaN,NaN,0,0
20,1,1.5,70,10,60,0,0.808009222519104,40,0
20,1,1.5,92,13,79,0,0.986712021714993,37,0
20,1,1.5,6,98,-92,0,0.918487741490935,-48,0
20,1,1.5,97,0,97,0,0.917217262532176,50,0
20,1,1.5,83,3,80,1,0.859922180414287,-47,0
20,1,1.5,9,82,-73,0,0.96525317024134,-32,0
20,1,1.5,86,0,86,0,0.850557804776145,50,0
20,1,1.5,63,18,45,1,1.10790787011501,-32,0
20,1,1.5,91,23,68,0,0.68320904070697,27,0
20,1,1.5,37,67,-30,1,1.09910249055611,17,0
20,1,1.5,59,31,28,1,0.986457266124489,-19,0
20,1,10,26,68,-42,1,4.20767419142521,18,0
20,1,10,53,23,30,0,2.45831080548578,27,0
20,1,10,8,92,-84,0,2.53163606239559,-42,0
20,1,10,78,33,45,1,4.86616974053413,-17,0
20,1,10,87,26,61,0,2.80282393822745,24,0
20,1,10,48,100,-52,1,2.23015683047379,50,0
20,1,10,41,97,-56,1,3.04079095196175,47,0
20,1,10,69,10,59,0,3.64264718550021,40,0
20,1,10,66,8,58,0,1.98066460051905,42,0
20,1,10,37,67,-30,0,6.26521633148332,-17,0
20,1,10,100,1,99,0,3.20190461877428,49,0
20,1,10,14,67,-53,0,3.02915137063974,-17,0
20,1,10,41,62,-21,1,3.6158278365383,12,0
20,1,10,23,53,-30,0,2.88247153243719,-3,0
20,1,10,6,57,-51,0,3.06634348751231,-7,0
20,1,10,99,33,66,1,4.13895616187801,-17,0
20,1,10,23,74,-51,0,2.8169879825,-24,0
20,1,10,12,96,-84,0,4.55554386652966,-46,0
20,1,10,7,82,-75,0,2.02481905938384,-32,0
20,1,10,42,93,-51,1,1.83489271857252,43,0
20,1,1.5,13,71,-58,0,1.37352154700784,-21,0
20,1,1.5,63,38,25,1,0.994074641555017,-12,0
20,1,1.5,86,2,84,0,0.966100644952348,48,0
20,1,1.5,55,41,14,1,0.841425824885846,-9,0
20,1,1.5,42,68,-26,1,1.12333103014771,18,0
20,1,1.5,9,94,-85,0,1.00204867481261,-44,0
20,1,1.5,48,55,-7,1,0.853362315599952,5,0
20,1,1.5,10,62,-52,0,0.78353545776281,-12,0
20,1,1.5,87,2,85,0,1.13088755748049,48,0
20,1,1.5,93,17,76,0,1.08892143080993,33,0
20,1,1.5,13,63,-50,0,0.920379164291262,-13,0
20,1,1.5,48,80,-32,1,0.975043849118265,30,0
20,1,1.5,64,32,32,1,1.42760194347284,-18,0
20,1,1.5,98,4,94,0,0.822288731556,46,0
20,1,1.5,27,76,-49,NaN,NaN,0,0
20,1,1.5,8,82,-74,0,0.848889613852407,-32,0
20,1,1.5,20,55,-35,0,0.912858559329834,-5,0
20,1,1.5,77,45,32,0,1.08880303360729,5,0
20,1,1.5,84,48,36,0,1.29678183207761,2,0
20,1,1.5,92,13,79,0,1.01531319359037,37,0
21,1,10,75,0,75,0,2.81004206185571,50,0
21,1,10,75,0,75,0,2.77303092783495,50,0
21,1,10,30,100,-70,0,3.06646029782314,-50,0
21,1,10,80,45,35,1,2.97172893470815,-5,0
21,1,10,53,0,53,0,3.6411099198167,50,0
21,1,10,25,55,-30,0,2.26767395189017,-5,0
21,1,10,28,85,-57,0,2.08498987399707,-35,0
21,1,10,100,0,100,0,2.1016144788091,50,0
21,1,10,3,100,-97,0,1.94153053837272,-50,0
21,1,10,50,43,7,1,2.36411491408853,-7,0
21,1,10,30,100,-70,0,2.65005928980463,-50,0
21,1,10,48,100,-52,0,2.43598515463873,-50,0
21,1,10,100,0,100,0,2.25473466208496,50,0
21,1,10,48,60,-12,1,2.67263560137417,10,0
21,1,10,53,0,53,0,2.88996435280569,50,0
21,1,10,48,80,-32,0,3.40257796105379,-30,0
21,1,10,80,45,35,1,2.78252939289814,-5,0
21,1,10,0,68,-68,0,2.67508563573938,-18,0
21,1,10,3,100,-97,0,2.69244371134027,-50,0
21,1,10,50,100,-50,0,2.7250573195879,-50,0
21,1,1.5,25,55,-30,0,0.72895230240556,-5,0
21,1,1.5,5,83,-78,0,0.472149186713068,-33,0
21,1,1.5,5,83,-78,0,0.505463642612085,-33,0
21,1,1.5,53,23,30,1,0.657516792669412,-27,0
21,1,1.5,53,40,13,0,0.507437525773639,10,0
21,1,1.5,85,15,70,0,0.899364215350033,35,0
21,1,1.5,100,15,85,0,0.891383276059969,35,0
21,1,1.5,53,23,30,1,0.436047835051795,-27,0
21,1,1.5,98,38,60,0,0.830667216494476,12,0
21,1,1.5,28,85,-57,0,0.769913035510399,-35,0
21,1,1.5,50,100,-50,1,0.879273127147826,50,0
21,1,1.5,85,15,70,0,0.592574020618486,35,0
21,1,1.5,100,15,85,1,0.837182680412297,-35,0
21,1,1.5,48,80,-32,0,0.855826620847438,-30,0
21,1,1.5,98,38,60,0,0.809797571592753,12,0
21,1,1.5,48,100,-52,1,1.09376623138633,50,0
21,1,1.5,0,68,-68,0,0.870389369988516,-18,0
21,1,1.5,48,60,-12,0,0.655678533791615,-10,0
21,1,1.5,50,43,7,1,0.705650217640141,-7,0
21,1,1.5,53,40,13,1,1.137620526918,-10,0
21,1,10,91,35,56,0,1.92766130584187,15,0
21,1,10,69,3,66,0,7.87739381443316,47,0
21,1,10,98,15,83,0,8.67857411225668,35,0
21,1,10,96,13,83,0,7.66391019473031,37,0
21,1,10,38,69,-31,0,8.40969017182124,-19,0
21,1,10,46,98,-52,NaN,NaN,0,0
21,1,10,4,94,-90,0,2.87295266895762,-44,0
21,1,10,94,12,82,0,4.77018758304621,38,0
21,1,10,20,90,-70,0,4.64747546391754,-40,0
21,1,10,28,94,-66,0,5.43402520045765,-44,0
21,1,10,96,20,76,0,5.09996059564764,30,0
21,1,10,87,28,59,0,5.3238931500573,22,0
21,1,10,68,3,65,0,5.59514904925527,47,0
21,1,10,93,10,83,0,5.23975257731945,40,0
21,1,10,64,39,25,0,5.16237085910598,11,0
21,1,10,91,16,75,0,5.45628884307007,34,0
21,1,10,43,99,-56,0,5.61013773195918,-49,0
21,1,10,61,20,41,0,5.78216797250843,30,0
21,1,10,30,63,-33,0,5.12265127147748,-13,0
21,1,10,39,91,-52,0,5.39397205040132,-41,0
21,1,1.5,2,93,-91,0,0.559324444444428,-43,0
21,1,1.5,96,12,84,0,0.813201741122612,38,0
21,1,1.5,61,23,38,0,0.593231248567463,27,0
21,1,1.5,87,18,69,0,0.772563573883417,32,0
21,1,1.5,93,16,77,0,0.585862451316643,34,0
21,1,1.5,22,84,-62,0,0.830483940435442,-34,0
21,1,1.5,5,95,-90,0,0.601835326460787,-45,0
21,1,1.5,99,0,99,0,0.541735074456483,50,0
21,1,1.5,29,57,-28,0,0.580363069873783,-7,0
21,1,1.5,50,30,20,0,0.937731225658354,20,0
21,1,1.5,3,91,-88,0,0.615765040091901,-41,0
21,1,1.5,90,19,71,0,0.931005360824201,31,0
21,1,1.5,75,2,73,0,0.578331271478419,48,0
21,1,1.5,10,91,-81,0,0.727603024055497,-41,0
21,1,1.5,98,26,72,0,0.678899610538792,24,0
21,1,1.5,53,7,46,0,0.584144054982062,43,0
21,1,1.5,18,75,-57,0,0.844871844215049,-25,0
21,1,1.5,85,45,40,1,0.895555372279887,-5,0
21,1,1.5,87,28,59,0,0.864164948454345,22,0
21,1,1.5,34,69,-35,1,1.20211647193537,19,0
21,1,10,86,22,64,0,3.97076856815511,28,0
21,1,10,47,68,-21,1,5.30320201603536,18,0
21,1,10,81,12,69,0,4.72717305841979,38,0
21,1,10,97,11,86,0,4.52649273768657,39,0
21,1,10,51,39,12,1,4.84576183276113,-11,0
21,1,10,9,64,-55,0,3.88835665521219,-14,0
21,1,10,47,56,-9,1,5.3209662313875,6,0
21,1,10,94,20,74,0,5.13557479954034,30,0
21,1,10,13,95,-82,0,4.34215037800823,-45,0
21,1,10,98,7,91,0,4.96470689576199,43,0
21,1,10,70,30,40,0,4.43275106529109,20,0
21,1,10,15,58,-43,0,4.67463917525674,-8,0
21,1,10,62,6,56,0,4.97182240549955,44,0
21,1,10,99,24,75,0,4.88051683848789,26,0
21,1,10,34,72,-38,0,4.83372646048156,-22,0
21,1,10,39,86,-47,0,4.4516383963346,-36,0
21,1,10,22,98,-76,0,4.74092316151291,-48,0
21,1,10,83,19,64,0,4.88351303551099,31,0
21,1,10,93,3,90,0,4.88413250859048,47,0
21,1,10,82,19,63,0,5.18807239404305,31,0
21,1,1.5,36,60,-24,0,0.74068343642648,-10,0
21,1,1.5,92,12,80,0,0.586536907216214,38,0
21,1,1.5,7,95,-88,0,0.607275693013435,-45,0
21,1,1.5,2,80,-78,0,0.659207331043945,-30,0
21,1,1.5,96,14,82,0,0.797175349369354,36,0
21,1,1.5,95,24,71,0,1.10376430698852,26,0
21,1,1.5,76,45,31,1,1.05577860252015,-5,0
21,1,1.5,100,32,68,0,0.705108087056942,18,0
21,1,1.5,44,92,-48,1,0.937067766322798,42,0
21,1,1.5,96,23,73,1,0.919065658648833,-27,0
21,1,1.5,13,51,-38,1,1.10104375715855,1,0
21,1,1.5,51,47,4,1,0.828369301259954,-3,0
21,1,1.5,69,0,69,0,0.65497182130639,50,0
21,1,1.5,10,72,-62,0,0.856295074454465,-22,0
21,1,1.5,92,19,73,0,0.745553447881321,31,0
21,1,1.5,79,25,54,0,0.79956416953064,25,0
21,1,1.5,83,21,62,0,1.24282281787055,29,0
21,1,1.5,48,70,-22,0,1.20477764032148,-20,0
21,1,1.5,34,72,-38,0,1.15210886597924,-22,0
21,1,1.5,96,15,81,0,1.00538391752707,35,0
21,1,10,5,96,-91,0,4.74134799541753,-46,0
21,1,10,98,17,81,0,3.99523408934874,33,0
21,1,10,19,89,-70,0,5.33520641466203,-39,0
21,1,10,18,81,-63,0,5.17311010309277,-31,0
21,1,10,24,58,-34,0,4.43370520045937,-8,0
21,1,10,100,18,82,0,4.66763069874105,32,0
21,1,10,47,61,-14,0,4.88423111110933,-11,0
21,1,10,42,83,-41,0,4.74013287514208,-33,0
21,1,10,39,55,-16,1,4.81745704467357,5,0
21,1,10,93,3,90,0,4.50805993127142,47,0
21,1,10,4,86,-82,0,5.02668646048005,-36,0
21,1,10,11,90,-79,0,6.15718341351749,-40,0
21,1,10,45,53,-8,0,4.57052224513245,-3,0
21,1,10,85,16,69,0,5.60704073310444,34,0
21,1,10,66,49,17,1,4.57834703321714,-1,0
21,1,10,96,12,84,0,4.75094909507425,38,0
21,1,10,63,19,44,0,4.46818822451314,31,0
21,1,10,40,90,-50,0,4.22082895761741,-40,0
21,1,10,66,22,44,0,4.89542011454796,28,0
21,1,10,99,14,85,0,4.9753354410077,36,0
21,1,1.5,99,6,93,0,0.583984971362952,44,0
21,1,1.5,84,22,62,0,0.555935670103281,28,0
21,1,1.5,39,55,-16,0,1.14517443298973,-5,0
21,1,1.5,33,56,-23,0,0.919221076746908,-6,0
21,1,1.5,49,61,-12,0,0.901869599083511,-11,0
21,1,1.5,82,38,44,0,0.757114501719116,12,0
21,1,1.5,46,68,-22,0,0.850483390608133,-18,0
21,1,1.5,8,59,-51,0,0.699775853378014,-9,0
21,1,1.5,14,89,-75,0,0.627107262314894,-39,0
21,1,1.5,70,4,66,0,0.637685956473433,46,0
21,1,1.5,98,3,95,0,0.583033402062938,47,0
21,1,1.5,61,45,16,1,0.947006460481134,-5,0
21,1,1.5,96,21,75,0,0.704966597939347,29,0
21,1,1.5,27,56,-29,0,1.03230863688441,-6,0
21,1,1.5,70,18,52,0,0.738288018328603,32,0
21,1,1.5,93,22,71,0,0.816166781214633,28,0
21,1,1.5,88,20,68,0,0.802833447880403,30,0
21,1,1.5,55,40,15,1,0.974137182129198,-10,0
21,1,1.5,72,32,40,0,0.954746575029276,18,0
21,1,1.5,28,79,-51,0,0.800149919816249,-29,0
21,1,10,28,62,-34,0,3.82326799541806,-12,0
21,1,10,86,49,37,0,4.59397974799504,1,0
21,1,10,49,100,-51,0,4.30986483390552,-50,0
21,1,10,1,99,-98,0,4.97314089347128,-49,0
21,1,10,100,27,73,0,4.41773122565792,23,0
21,1,10,93,22,71,0,4.70034914089229,28,0
21,1,10,99,27,72,0,3.98762483390601,23,0
21,1,10,19,73,-54,0,4.90355060710317,-23,0
21,1,10,89,27,62,0,4.51082006872821,23,0
21,1,10,53,40,13,1,3.9901170217654,-10,0
21,1,10,50,83,-33,0,4.93665576174135,-33,0
21,1,10,83,41,42,0,4.49462396334457,9,0
21,1,10,83,23,60,0,4.70988059564843,27,0
21,1,10,21,50,-29,0,4.83655624284074,0,0
21,1,10,89,24,65,0,4.95842016036659,26,0
21,1,10,78,37,41,0,3.92370437571662,13,0
21,1,10,35,91,-56,0,4.69028911798341,-41,0
21,1,10,94,28,66,0,5.06624623138669,22,0
21,1,10,75,30,45,0,5.65810364261051,20,0
21,1,10,92,22,70,0,4.93135981672458,28,0
21,1,1.5,47,53,-6,1,0.891172875142729,3,0
21,1,1.5,32,69,-37,0,0.739132187858559,-19,0
21,1,1.5,13,86,-73,0,0.656444627718884,-36,0
21,1,1.5,92,15,77,0,0.625044673539378,35,0
21,1,1.5,94,47,47,1,1.01164902634628,-3,0
21,1,1.5,42,71,-29,NaN,NaN,0,0
21,1,1.5,6,80,-74,0,0.686327422679824,-30,0
21,1,1.5,70,18,52,0,0.693644536082502,32,0
21,1,1.5,44,79,-35,1,1.00482565864877,29,0
21,1,1.5,99,22,77,0,0.559567101947323,28,0
21,1,1.5,89,28,61,0,0.628198487971531,22,0
21,1,1.5,93,25,68,1,0.477483619701161,-25,0
21,1,1.5,45,98,-53,0,0.725424971362372,-48,0
21,1,1.5,81,20,61,0,0.532048201603175,30,0
21,1,1.5,78,8,70,0,0.649415990836133,42,0
21,1,1.5,83,19,64,1,0.746123069873647,-31,0
21,1,1.5,6,80,-74,0,0.567362199311901,-30,0
21,1,1.5,59,20,39,1,1.12396022909525,-30,0
21,1,1.5,85,0,85,0,0.45859262313752,50,0
21,1,1.5,97,3,94,0,0.579907079038094,47,0
22,1,10,48,100,-52,1,2.191706330952,50,0
22,1,10,53,23,30,0,2.22823938228248,27,0
22,1,10,80,45,35,1,3.85441212856495,-5,0
22,1,10,3,100,-97,0,2.66464194010132,-50,0
22,1,10,100,0,100,0,2.8187533104483,50,0
22,1,10,25,55,-30,0,2.95012618649162,-5,0
22,1,10,100,0,100,0,2.82021659723523,50,0
22,1,10,30,100,-70,0,2.63967149358268,-50,0
22,1,10,80,45,35,1,2.03442279531009,-5,0
22,1,10,100,15,85,0,2.28510852771433,35,0
22,1,10,48,80,-32,1,2.32577081893851,30,0
22,1,10,3,100,-97,0,2.41325132280417,-50,0
22,1,10,75,0,75,0,2.48940235071677,50,0
22,1,10,28,85,-57,0,3.2021428793978,-35,0
22,1,10,53,40,13,1,2.86219372054893,-10,0
22,1,10,98,38,60,0,2.66432743607766,12,0
22,1,10,50,43,7,1,2.77844034595455,-7,0
22,1,10,5,83,-78,0,3.74379615154066,-33,0
22,1,10,85,15,70,0,2.47057976140968,35,0
22,1,10,28,85,-57,0,2.80003372304145,-35,0
22,1,1.5,50,100,-50,1,0.761592753944569,50,0
22,1,1.5,48,60,-12,0,0.551568213100836,-10,0
22,1,1.5,53,23,30,1,0.669604725624595,-27,0
22,1,1.5,48,60,-12,0,0.871004964984422,-10,0
22,1,1.5,100,15,85,0,0.744412696725703,35,0
22,1,1.5,53,0,53,0,0.623099917341278,50,0
22,1,1.5,30,100,-70,0,0.53849540248666,-50,0
22,1,1.5,5,83,-78,0,0.521220774126959,-33,0
22,1,1.5,25,55,-30,0,0.536609478007449,-5,0
22,1,1.5,85,15,70,0,0.583293898145712,35,0
22,1,1.5,50,100,-50,1,0.779994171779435,50,0
22,1,1.5,0,68,-68,0,0.513494898473255,-18,0
22,1,1.5,53,40,13,0,0.913452011561276,10,0
22,1,1.5,48,100,-52,0,0.865464122532103,-50,0
22,1,1.5,98,38,60,0,0.731558719330678,12,0
22,1,1.5,53,0,53,0,0.58690409643259,50,0
22,1,1.5,75,0,75,0,0.519591804568336,50,0
22,1,1.5,48,80,-32,0,0.622942298775342,-30,0
22,1,1.5,50,43,7,0,0.721072319430277,7,0
22,1,1.5,0,68,-68,0,0.496464029060007,-18,0
22,1,10,99,27,72,0,2.83802602905689,23,0
22,1,10,53,23,30,0,4.39274881282017,27,0
22,1,10,36,90,-54,0,2.613565460274,-40,0
22,1,10,27,96,-69,0,3.46565289825685,-46,0
22,1,10,84,22,62,0,2.86712461580464,28,0
22,1,10,94,27,67,0,2.54046930011827,23,0
22,1,10,62,10,52,0,2.73121709025145,40,0
22,1,10,24,71,-47,0,3.33069255032387,-21,0
22,1,10,84,24,60,0,2.89012519679363,26,0
22,1,10,46,58,-12,0,2.46681121144502,-8,0
22,1,10,27,92,-65,0,3.08295905032992,-42,0
22,1,10,98,6,92,0,3.43568667628188,44,0
22,1,10,32,73,-41,0,3.07840607308026,-23,0
22,1,10,88,19,69,0,2.5199081413657,31,0
22,1,10,72,46,26,1,2.87933382329538,-4,0
22,1,10,51,15,36,0,2.41681386896744,35,0
22,1,10,10,83,-73,0,2.85220180308261,-33,0
22,1,10,80,45,35,1,2.50229188392677,-5,0
22,1,10,19,86,-67,0,2.8223231877073,-36,0
22,1,10,89,22,67,0,2.09773890667657,28,0
22,1,1.5,80,25,55,1,0.703920486931565,-25,0
22,1,1.5,83,23,60,0,0.97594410772308,27,0
22,1,1.5,14,59,-45,0,0.837344603672136,-9,0
22,1,1.5,52,4,48,0,0.688082386858696,46,0
22,1,1.5,75,40,35,1,0.968783459580663,-10,0
22,1,1.5,98,28,70,0,0.806179380925641,22,0
22,1,1.5,63,12,51,0,0.65826535269025,38,0
22,1,1.5,99,23,76,0,0.668189090962187,27,0
22,1,1.5,44,55,-11,0,0.9096702656243,-5,0
22,1,1.5,50,48,2,0,0.677715850379172,2,0
22,1,1.5,60,19,41,0,0.605751978021544,31,0
22,1,1.5,87,5,82,0,0.593842612363005,45,0
22,1,1.5,49,69,-20,0,0.798539279096076,-19,0
22,1,1.5,73,42,31,0,0.883241297530731,8,0
22,1,1.5,91,30,61,0,1.03596159238714,20,0
22,1,1.5,82,19,63,0,0.646715577296163,31,0
22,1,1.5,1,63,-62,0,0.505435457946078,-13,0
22,1,1.5,50,69,-19,1,0.721450603989979,19,0
22,1,1.5,97,21,76,0,0.640866462251324,29,0
22,1,1.5,6,51,-45,0,0.603569510703892,-1,0
22,1,10,21,77,-56,0,1.44041963194286,-27,0
22,1,10,48,68,-20,1,2.92188057277872,18,0
22,1,10,38,56,-18,0,3.04929832246125,-6,0
22,1,10,99,3,96,0,2.21946552643658,47,0
22,1,10,21,99,-78,0,2.84683727349147,-49,0
22,1,10,1,51,-50,0,3.02555730076347,-1,0
22,1,10,37,85,-48,0,2.90909587424267,-35,0
22,1,10,95,27,68,0,2.82110732541423,23,0
22,1,10,46,61,-15,1,2.7278125292105,11,0
22,1,10,60,19,41,0,2.42255998211203,31,0
22,1,10,62,49,13,1,1.35954701157061,-1,0
22,1,10,9,70,-61,0,2.54040258714394,-20,0
22,1,10,92,26,66,0,2.61918694478481,24,0
22,1,10,96,43,53,1,2.89461402695269,-7,0
22,1,10,96,20,76,0,3.01463140165015,30,0
22,1,10,69,49,20,1,3.24280077196454,-1,0
22,1,10,87,25,62,0,2.63754877469819,25,0
22,1,10,59,4,55,0,2.2483192545742,46,0
22,1,10,93,9,84,0,2.31371849690549,41,0
22,1,10,14,53,-39,0,2.41713863652603,-3,0
22,1,1.5,31,71,-40,0,0.527348104270459,-21,0
22,1,1.5,84,23,61,1,0.630082053293336,-27,0
22,1,1.5,50,85,-35,1,0.94478804884784,35,0
22,1,1.5,80,28,52,0,0.838808623568184,22,0
22,1,1.5,9,96,-87,0,0.864831815490106,-46,0
22,1,1.5,27,80,-53,0,0.706947129967375,-30,0
22,1,1.5,42,77,-35,0,0.570246746367047,-27,0
22,1,1.5,98,7,91,0,0.662966418081851,43,0
22,1,1.5,70,4,66,0,0.576460216889245,46,0
22,1,1.5,96,27,69,0,0.613121562402739,23,0
22,1,1.5,97,13,84,0,0.471858671129667,37,0
22,1,1.5,43,75,-32,0,0.552552412755176,-25,0
22,1,1.5,76,39,37,0,0.91794743970604,11,0
22,1,1.5,15,83,-68,0,0.468681740621832,-33,0
22,1,1.5,34,79,-45,0,0.461325352212953,-29,0
22,1,1.5,87,23,64,0,0.926737790518018,27,0
22,1,1.5,96,24,72,0,0.509486621665928,26,0
22,1,1.5,86,26,60,0,0.516826148554173,24,0
22,1,1.5,87,33,54,0,0.627542195041315,17,0
22,1,1.5,16,56,-40,0,0.43828774918984,-6,0
22,1,10,65,29,36,0,2.97307618291779,21,0
22,1,10,0,96,-96,0,2.76178299588901,-46,0
22,1,10,94,24,70,0,2.18254685945067,26,0
22,1,10,84,22,62,0,2.85742850806673,28,0
22,1,10,97,14,83,0,2.94692359715009,36,0
22,1,10,19,57,-38,0,2.84097093037053,-7,0
22,1,10,93,49,44,1,3.1630516420737,-1,0
22,1,10,91,18,73,0,2.91255248606649,32,0
22,1,10,75,48,27,1,3.16794954739635,-2,0
22,1,10,10,91,-81,0,3.4047252580076,-41,0
22,1,10,88,19,69,0,3.23080783181103,31,0
22,1,10,12,84,-72,0,3.43353096746614,-34,0
22,1,10,94,38,56,0,3.16363116522189,12,0
22,1,10,93,11,82,0,3.3930999723234,39,0
22,1,10,48,87,-39,1,3.22917043149027,37,0
22,1,10,30,84,-54,0,2.919930501208,-34,0
22,1,10,99,5,94,0,3.14275696866389,45,0
22,1,10,77,23,54,0,3.07677747007619,27,0
22,1,10,84,17,67,0,2.20557676482531,33,0
22,1,10,5,87,-82,0,2.76890368955719,-37,0
22,1,1.5,97,27,70,0,0.725306027443366,23,0
22,1,1.5,36,62,-26,0,0.499985154528986,-12,0
22,1,1.5,77,32,45,0,0.611299785015945,18,0
22,1,1.5,19,99,-80,0,0.486684346828042,-49,0
22,1,1.5,93,8,85,0,0.502772803833068,42,0
22,1,1.5,85,40,45,0,0.462229642920647,10,0
22,1,1.5,88,15,73,0,0.455463407750358,35,0
22,1,1.5,3,79,-76,0,0.432899026980522,-29,0
22,1,1.5,33,90,-57,0,0.562923714445787,-40,0
22,1,1.5,12,99,-87,0,0.456319313221684,-49,0
22,1,1.5,4,66,-62,0,0.480254608968607,-16,0
22,1,1.5,72,18,54,0,0.865099400500185,32,0
22,1,1.5,90,21,69,0,0.689798963016074,29,0
22,1,1.5,85,0,85,0,0.513936230459876,50,0
22,1,1.5,95,9,86,0,0.577247210059795,41,0
22,1,1.5,23,81,-58,0,0.469898702580394,-31,0
22,1,1.5,90,47,43,0,0.494611461068416,3,0
22,1,1.5,68,40,28,0,0.966683100541559,10,0
22,1,1.5,46,51,-5,0,0.691467153939811,-1,0
22,1,1.5,91,15,76,0,0.707484132759419,35,0
22,1,10,98,8,90,0,2.10297367586645,42,0
22,1,10,43,90,-47,0,2.52635034208834,-40,0
22,1,10,85,6,79,0,2.31706697506161,44,0
22,1,10,94,22,72,0,1.86657698292402,28,0
22,1,10,98,31,67,0,3.28216729194901,19,0
22,1,10,0,82,-82,0,3.11433247620698,-32,0
22,1,10,95,14,81,0,3.30576169172309,36,0
22,1,10,20,97,-77,0,2.6892355682794,-47,0
22,1,10,15,89,-74,0,2.70390509162826,-39,0
22,1,10,20,57,-37,0,2.91136081639161,-7,0
22,1,10,21,68,-47,0,2.98879002091235,-18,0
22,1,10,36,63,-27,0,3.02487367604954,-13,0
22,1,10,99,17,82,0,3.4995808445783,33,0
22,1,10,30,63,-33,0,3.5150776821265,-13,0
22,1,10,25,93,-68,0,3.13053346553897,-43,0
22,1,10,89,49,40,1,3.45727015639022,-1,0
22,1,10,55,36,19,0,3.29001706312738,14,0
22,1,10,50,43,7,0,3.19416664681194,7,0
22,1,10,69,37,32,0,3.21424358666627,13,0
22,1,10,97,4,93,0,2.81772512421594,46,0
22,1,1.5,32,92,-60,0,0.55579678934555,-42,0
22,1,1.5,41,92,-51,0,0.465207900722817,-42,0
22,1,1.5,64,8,56,0,0.593985202182012,42,0
22,1,1.5,82,29,53,0,0.718004622256558,21,0
22,1,1.5,25,78,-53,0,0.452714979812299,-28,0
22,1,1.5,76,28,48,0,0.797458308972637,22,0
22,1,1.5,37,80,-43,0,0.656814895321077,-30,0
22,1,1.5,15,87,-72,0,0.506206322703292,-37,0
22,1,1.5,32,52,-20,0,0.537583414126857,-2,0
22,1,1.5,91,15,76,0,0.54298496575575,35,0
22,1,1.5,44,63,-19,0,0.563712906945511,-13,0
22,1,1.5,78,1,77,0,0.481003113882252,49,0
22,1,1.5,53,12,41,0,0.449726091921548,38,0
22,1,1.5,34,58,-24,0,0.538474875416796,-8,0
22,1,1.5,96,5,91,0,0.551843129205736,45,0
22,1,1.5,89,28,61,0,0.605235868853924,22,0
22,1,1.5,72,17,55,0,0.488000278581239,33,0
22,1,1.5,94,29,65,0,0.695282256365317,21,0
22,1,1.5,81,49,32,1,0.98266562320714,-1,0
22,1,1.5,84,4,80,0,0.586043792303826,46,0
23,1,10,80,45,35,1,3.31143925911965,-5,0
23,1,10,53,40,13,0,4.02247714072655,10,0
23,1,10,50,100,-50,1,2.87388388643376,50,0
23,1,10,53,40,13,0,9.19512335485524,10,0
23,1,10,30,100,-70,0,3.15969546626729,-50,0
23,1,10,80,45,35,0,5.36568753768552,5,0
23,1,10,85,15,70,0,1.97897331664353,35,0
23,1,10,25,55,-30,0,3.93619820351523,-5,0
23,1,10,25,55,-30,0,5.47880378504487,-5,0
23,1,10,48,80,-32,1,4.33608090597772,30,0
23,1,10,28,85,-57,0,3.79064662100609,-35,0
23,1,10,53,0,53,0,2.91544533659726,50,0
23,1,10,5,83,-78,0,3.45134479794615,-33,0
23,1,10,3,100,-97,0,4.40527142466999,-50,0
23,1,10,100,0,100,0,3.33724581715069,50,0
23,1,10,28,85,-57,0,6.03984047534868,-35,0
23,1,10,53,23,30,0,5.26640653493814,27,0
23,1,10,3,100,-97,0,4.4197576706174,-50,0
23,1,10,5,83,-78,0,3.74297763465984,-33,0
23,1,10,48,80,-32,1,2.36562265748398,30,0
23,1,1.5,98,38,60,0,0.982366514484966,12,0
23,1,1.5,50,43,7,NaN,NaN,0,0
23,1,1.5,53,23,30,0,0.770972891439669,27,0
23,1,1.5,85,15,70,0,0.63224179421195,35,0
23,1,1.5,50,43,7,0,1.01887060798617,7,0
23,1,1.5,75,0,75,0,1.10213683124312,50,0
23,1,1.5,75,0,75,0,0.566121538577136,50,0
23,1,1.5,48,60,-12,1,1.05138181998154,10,0
23,1,1.5,0,68,-68,0,1.10937738833309,-18,0
23,1,1.5,100,15,85,0,0.717404572036685,35,0
23,1,1.5,48,100,-52,1,1.18867675547699,50,0
23,1,1.5,100,0,100,0,0.737389873189386,50,0
23,1,1.5,53,0,53,0,0.84803444148929,50,0
23,1,1.5,30,100,-70,0,1.12253780554602,-50,0
23,1,1.5,48,60,-12,1,1.24987454661823,10,0
23,1,1.5,48,100,-52,1,1.23579847549991,50,0
23,1,1.5,0,68,-68,NaN,NaN,0,0
23,1,1.5,50,100,-50,1,0.925878219497463,50,0
23,1,1.5,98,38,60,0,1.22904616941014,12,0
23,1,1.5,100,15,85,0,1.04840356217937,35,0
23,1,10,87,2,85,0,1.5963703743073,48,0
23,1,10,83,18,65,0,1.72904708579699,32,0
23,1,10,2,55,-53,0,3.53626528304449,-5,0
23,1,10,94,30,64,0,1.51873516598425,20,0
23,1,10,1,71,-70,0,2.062171360707,-21,0
23,1,10,18,69,-51,0,1.61613171047429,-19,0
23,1,10,42,55,-13,1,2.17791947157457,5,0
23,1,10,48,53,-5,1,3.19133134538424,3,0
23,1,10,13,62,-49,0,5.64387441099279,-12,0
23,1,10,99,19,80,0,4.0225207607491,31,0
23,1,10,34,83,-49,0,5.16776003856103,-33,0
23,1,10,96,24,72,0,4.52499812140741,26,0
23,1,10,9,62,-53,0,4.78840440525528,-12,0
23,1,10,39,56,-17,0,4.77703937348451,-6,0
23,1,10,43,90,-47,0,4.52621764924697,-40,0
23,1,10,15,59,-44,0,4.85357125184055,-9,0
23,1,10,54,44,10,0,4.33549881694489,6,0
23,1,10,19,70,-51,0,6.27809413493924,-20,0
23,1,10,47,78,-31,1,3.93535769334449,28,0
23,1,10,42,69,-27,0,5.95793307075655,-19,0
23,1,1.5,77,44,33,0,1.06534315944555,6,0
23,1,1.5,11,73,-62,0,1.25925724999615,-23,0
23,1,1.5,72,2,70,0,0.581256953086267,48,0
23,1,1.5,86,12,74,0,0.962604078655204,38,0
23,1,1.5,74,6,68,0,0.615098759028115,44,0
23,1,1.5,75,41,34,0,0.866556089300502,9,0
23,1,1.5,97,14,83,0,0.635860789816434,36,0
23,1,1.5,83,21,62,0,0.742519441149852,29,0
23,1,1.5,27,50,-23,0,1.13308615320784,0,0
23,1,1.5,30,97,-67,0,1.35575463554414,-47,0
23,1,1.5,61,46,15,1,1.16762001462484,-4,0
23,1,1.5,98,32,66,0,0.764956627401261,18,0
23,1,1.5,64,22,42,0,0.987020660862981,28,0
23,1,1.5,38,83,-45,0,1.10362944241569,-33,0
23,1,1.5,44,83,-39,0,1.40762800552147,-33,0
23,1,1.5,56,46,10,NaN,NaN,0,0
23,1,1.5,3,95,-92,0,0.882936323931062,-45,0
23,1,1.5,46,59,-13,1,0.995583747693672,9,0
23,1,1.5,46,72,-26,NaN,NaN,0,0
23,1,1.5,53,16,37,0,0.727496925521336,34,0
23,1,10,39,70,-31,0,1.13273169471177,-20,0
23,1,10,98,4,94,0,4.72985277326188,46,0
23,1,10,5,99,-94,0,4.52112253743871,-49,0
23,1,10,100,46,54,0,3.58455631289871,4,0
23,1,10,59,10,49,0,3.40446170510404,40,0
23,1,10,10,78,-68,0,1.46446049547194,-28,0
23,1,10,58,2,56,0,3.91230212913433,48,0
23,1,10,48,97,-49,1,4.27223585602405,47,0
23,1,10,94,19,75,0,5.33683270988513,31,0
23,1,10,80,22,58,0,6.35944291000487,28,0
23,1,10,42,55,-13,1,5.92318844032889,5,0
23,1,10,25,73,-48,0,5.78595911814227,-23,0
23,1,10,17,81,-64,0,5.81390672279849,-31,0
23,1,10,64,36,28,0,7.22583514930557,14,0
23,1,10,48,87,-39,0,8.51642477104178,-37,0
23,1,10,66,50,16,0,5.36366525482117,0,0
23,1,10,81,31,50,0,6.81677501415834,19,0
23,1,10,52,21,31,0,6.17150219658106,29,0
23,1,10,65,43,22,0,5.44812901262958,7,0
23,1,10,36,82,-46,0,6.98610134140836,-32,0
23,1,1.5,13,83,-70,0,0.896755806686997,-33,0
23,1,1.5,75,4,71,0,0.880721599791286,46,0
23,1,1.5,91,20,71,0,0.641384037639,30,0
23,1,1.5,34,51,-17,1,0.859388843171473,1,0
23,1,1.5,74,27,47,0,0.900677576559247,23,0
23,1,1.5,77,37,40,0,0.700003115714935,13,0
23,1,1.5,86,19,67,0,0.659234523596751,31,0
23,1,1.5,23,55,-32,0,1.01240421464718,-5,0
23,1,1.5,53,42,11,1,1.09584931665086,-8,0
23,1,1.5,83,47,36,NaN,NaN,0,0
23,1,1.5,18,60,-42,0,1.01454965992889,-10,0
23,1,1.5,81,24,57,0,0.641841864591697,26,0
23,1,1.5,55,29,26,0,0.74845433001974,21,0
23,1,1.5,49,93,-44,0,0.930408103793525,-43,0
23,1,1.5,66,15,51,0,0.657102274288263,35,0
23,1,1.5,80,42,38,0,0.986356096997042,8,0
23,1,1.5,16,61,-45,0,1.10234723370195,-11,0
23,1,1.5,39,54,-15,0,0.989639328397971,-4,0
23,1,1.5,88,39,49,0,0.673545556346653,11,0
23,1,1.5,8,88,-80,0,0.578274296627569,-38,0
23,1,10,74,6,68,0,4.84078985229644,44,0
23,1,10,98,10,88,0,5.5307145436127,40,0
23,1,10,8,62,-54,0,5.18539828928806,-12,0
23,1,10,100,7,93,0,4.39732671579804,43,0
23,1,10,10,63,-53,0,5.23328061053326,-13,0
23,1,10,89,36,53,0,3.18725818837629,14,0
23,1,10,49,59,-10,1,4.75115767171701,9,0
23,1,10,12,64,-52,0,8.41219637807262,-14,0
23,1,10,42,93,-51,1,6.3996096191313,43,0
23,1,10,81,27,54,0,7.28285861431323,23,0
23,1,10,3,91,-88,0,5.49023846222917,-41,0
23,1,10,75,30,45,0,2.72214815778716,20,0
23,1,10,48,98,-50,1,3.44074000084402,48,0
23,1,10,13,94,-81,0,4.75474331083387,-44,0
23,1,10,86,34,52,0,3.78398265462602,16,0
23,1,10,94,14,80,0,4.73191244472036,36,0
23,1,10,33,52,-19,0,3.40250723487588,-2,0
23,1,10,88,26,62,0,4.21385503856982,24,0
23,1,10,48,68,-20,1,3.47311815344256,18,0
23,1,10,85,18,67,0,4.88167977405465,32,0
23,1,1.5,31,53,-22,0,1.10379622485198,-3,0
23,1,1.5,96,10,86,0,0.887067030045728,40,0
23,1,1.5,3,94,-91,0,0.686335386650171,-44,0
23,1,1.5,87,28,59,0,0.64632336365321,22,0
23,1,1.5,35,70,-35,0,0.824290853906859,-20,0
23,1,1.5,94,46,48,0,1.28298397605613,4,0
23,1,1.5,53,47,6,1,0.978880211723663,-3,0
23,1,1.5,96,44,52,0,1.07156726005815,6,0
23,1,1.5,52,3,49,0,1.26421563686199,47,0
23,1,1.5,100,4,96,0,0.537525498468312,46,0
23,1,1.5,89,32,57,0,0.542160583994701,18,0
23,1,1.5,26,69,-43,0,1.01209924104842,-19,0
23,1,1.5,5,70,-65,0,0.591394026256239,-20,0
23,1,1.5,93,7,86,0,0.571419721749407,43,0
23,1,1.5,6,76,-70,0,0.568053648961723,-26,0
23,1,1.5,88,14,74,0,1.29971756952182,36,0
23,1,1.5,78,37,41,0,0.771982016820402,13,0
23,1,1.5,81,7,74,0,0.648678111729168,43,0
23,1,1.5,26,76,-50,0,1.09657216272899,-26,0
23,1,1.5,74,40,34,0,0.752537750564443,10,0
23,1,10,0,94,-94,0,1.25923672292629,-44,0
23,1,10,34,67,-33,0,5.58705255112909,-17,0
23,1,10,79,41,38,0,2.78302924557465,9,0
23,1,10,84,35,49,0,3.01892412498819,15,0
23,1,10,23,97,-74,0,2.53359823027313,-47,0
23,1,10,24,94,-70,0,8.067452682355,-44,0
23,1,10,12,99,-87,0,4.2594137688975,-49,0
23,1,10,88,40,48,0,5.99672153381107,10,0
23,1,10,8,90,-82,0,3.36066317095538,-40,0
23,1,10,6,89,-83,0,5.41389939170222,-39,0
23,1,10,6,79,-73,0,5.23988372881649,-29,0
23,1,10,49,75,-26,1,5.04045812019831,25,0
23,1,10,38,93,-55,0,3.75452154517552,-43,0
23,1,10,43,57,-14,1,2.98376565418039,7,0
23,1,10,72,15,57,0,4.11569862596843,35,0
23,1,10,99,16,83,0,3.4742471422469,34,0
23,1,10,15,90,-75,0,2.34702696560453,-40,0
23,1,10,86,31,55,0,2.35222874486135,19,0
23,1,10,25,74,-49,0,3.07748418774099,-24,0
23,1,10,51,43,8,1,2.85417460105054,-7,0
23,1,1.5,8,53,-45,0,0.668798305050586,-3,0
23,1,1.5,90,34,56,0,0.709477457794492,16,0
23,1,1.5,70,35,35,0,0.620775593315557,15,0
23,1,1.5,48,63,-15,1,1.35073796646248,13,0
23,1,1.5,49,72,-23,1,0.996048172632072,22,0
23,1,1.5,51,12,39,0,0.735946380362293,38,0
23,1,1.5,98,11,87,1,0.606023961689061,-39,0
23,1,1.5,83,3,80,0,0.60866498906762,47,0
23,1,1.5,12,51,-39,0,1.09995253115267,-1,0
23,1,1.5,95,3,92,0,0.570416827798908,47,0
23,1,1.5,0,85,-85,0,0.477788428230269,-35,0
23,1,1.5,84,28,56,0,0.949857501818769,22,0
23,1,1.5,46,56,-10,1,0.8824839953013,6,0
23,1,1.5,42,93,-51,0,1.00988048480576,-43,0
23,1,1.5,69,50,19,1,1.38036585835107,0,0
23,1,1.5,43,59,-16,1,0.992512018416164,9,0
23,1,1.5,29,88,-59,0,1.04377837363427,-38,0
23,1,1.5,52,37,15,0,0.661091123691222,13,0
23,1,1.5,100,11,89,0,0.614355019326467,39,0
23,1,1.5,41,100,-59,0,0.544991120210398,-50,0
24,1,10,50,100,-50,0,6.32362300114619,-50,0
24,1,10,98,38,60,1,1.86708050400921,-12,0
24,1,10,3,100,-97,1,4.01223404352822,50,0
24,1,10,98,38,60,0,2.52030643757098,12,0
24,1,10,48,60,-12,1,3.99156306987425,10,0
24,1,10,53,23,30,1,1.94024613974761,-27,0
24,1,10,5,83,-78,1,7.28126643757241,33,0
24,1,10,100,0,100,1,4.05865713631101,-50,0
24,1,10,53,40,13,0,5.00446570446729,10,0
24,1,10,48,100,-52,1,3.72843583046961,50,0
24,1,10,48,100,-52,0,4.14370895761749,-50,0
24,1,10,100,15,85,1,3.33431605956503,-35,0
24,1,10,30,100,-70,0,6.50094698740031,-50,0
24,1,10,75,0,75,1,4.10090739977204,-50,0
24,1,10,3,100,-97,0,3.53282712485634,-50,0
24,1,10,53,0,53,1,2.90750643757019,-50,0
24,1,10,100,15,85,0,3.29935431844206,35,0
24,1,10,0,68,-68,0,4.58729713631146,-18,0
24,1,10,28,85,-57,0,4.75191459335474,-35,0
24,1,10,30,100,-70,0,2.70190112256569,-50,0
24,1,1.5,53,23,30,1,1.24791386025208,-27,0
24,1,1.5,75,0,75,1,0.921833127147693,-50,0
24,1,1.5,53,40,13,0,1.32915977090488,10,0
24,1,1.5,25,55,-30,NaN,NaN,0,0
24,1,1.5,5,83,-78,NaN,NaN,0,0
24,1,1.5,25,55,-30,1,0.351732416953382,5,0
24,1,1.5,100,0,100,1,0.853640137458569,-50,0
24,1,1.5,48,60,-12,0,0.983626116838423,-10,0
24,1,1.5,85,15,70,1,0.660277663229863,-35,0
24,1,1.5,80,45,35,0,0.830256311570338,5,0
24,1,1.5,48,80,-32,1,0.809554547537118,30,0
24,1,1.5,48,80,-32,0,0.853468224513563,-30,0
24,1,1.5,53,0,53,1,0.799465567009975,-50,0
24,1,1.5,0,68,-68,0,0.795454387171048,-18,0
24,1,1.5,28,85,-57,1,0.672131225657722,35,0
24,1,1.5,85,15,70,1,0.977400595646031,-35,0
24,1,1.5,80,45,35,1,0.998695441008749,-5,0
24,1,1.5,50,100,-50,0,1.12263550973694,-50,0
24,1,1.5,50,43,7,1,0.849898373424367,-7,0
24,1,1.5,50,43,7,0,1.21192394043464,7,0
24,1,10,94,2,92,1,0.985932462772325,-48,0
24,1,10,98,38,60,1,6.60496714776673,-12,0
24,1,10,29,97,-68,0,3.95287789232498,-47,0
24,1,10,7,85,-78,0,3.74279404352819,-35,0
24,1,10,50,43,7,1,2.59745832760564,-7,0
24,1,10,74,50,24,1,3.04210510882149,0,0
24,1,10,84,4,80,1,3.63667097365396,-46,0
24,1,10,100,15,85,0,4.84725296678153,35,0
24,1,10,81,24,57,1,2.32994052691902,-26,0
24,1,10,16,93,-77,0,3.52914364261051,-43,0
24,1,10,53,40,13,1,2.51119065292005,-10,0
24,1,10,66,4,62,1,5.09506932416843,-46,0
24,1,10,25,55,-30,1,4.16761255441088,5,0
24,1,10,55,31,24,1,4.3329781443299,-19,0
24,1,10,29,98,-69,0,2.8676006414662,-48,0
24,1,10,88,48,40,1,4.5487871706755,-2,0
24,1,10,64,38,26,0,4.57875500572663,12,0
24,1,10,98,3,95,1,5.0319886368834,-47,0
24,1,10,61,20,41,0,1.81855853379238,30,0
24,1,10,3,100,-97,0,5.49243784650571,-50,0
24,1,1.5,25,55,-30,0,1.27521539518966,-5,0
24,1,1.5,18,96,-78,NaN,NaN,0,0
24,1,1.5,48,100,-52,NaN,NaN,0,0
24,1,1.5,88,0,88,1,0.813001970218465,-50,0
24,1,1.5,77,8,69,0,0.808968064147848,42,0
24,1,1.5,67,45,22,1,0.892959083619644,-5,0
24,1,1.5,17,58,-41,0,0.981598350515924,-8,0
24,1,1.5,56,6,50,1,0.546910423827285,-44,0
24,1,1.5,80,35,45,1,0.953535120273955,-15,0
24,1,1.5,100,15,85,1,0.887450538373741,-35,0
24,1,1.5,65,14,51,0,1.06286258877481,36,0
24,1,1.5,68,48,20,0,0.904775990837152,2,0
24,1,1.5,3,100,-97,NaN,NaN,0,0
24,1,1.5,31,78,-47,NaN,NaN,0,0
24,1,1.5,53,0,53,1,0.686078167240339,-50,0
24,1,1.5,25,55,-30,0,0.694640091636757,-5,0
24,1,1.5,4,64,-60,1,0.855258098510603,14,0
24,1,1.5,4,56,-52,0,1.1772506758316,-6,0
24,1,1.5,29,54,-25,1,0.574577044673788,4,0
24,1,1.5,50,43,7,1,1.08385392898163,-7,0
24,1,10,3,100,-97,0,1.09709232531532,-50,0
24,1,10,89,19,70,1,6.5195110194727,-31,0
24,1,10,12,71,-59,0,4.0227401603679,-21,0
24,1,10,53,0,53,1,4.3940002749132,-50,0
24,1,10,92,0,92,0,1.93467674685053,50,0
24,1,10,41,91,-50,0,5.34057383734398,-41,0
24,1,10,25,55,-30,1,4.37916041237077,5,0
24,1,10,40,98,-58,0,3.04846258877478,-48,0
24,1,10,28,85,-57,0,2.41842694158004,-35,0
24,1,10,69,19,50,1,1.98098730813399,-31,0
24,1,10,80,45,35,1,3.82504760595657,-5,0
24,1,10,2,100,-98,0,4.48360027491435,-50,0
24,1,10,63,43,20,1,4.56407715922069,-7,0
24,1,10,44,73,-29,1,3.4574962657498,23,0
24,1,10,83,39,44,1,5.02737447880827,-11,0
24,1,10,3,100,-97,0,1.48605287514329,-50,0
24,1,10,88,42,46,1,6.30046753722854,-8,0
24,1,10,7,80,-73,0,2.41180261168302,-30,0
24,1,10,25,55,-30,0,6.39969063001263,-5,0
24,1,10,76,27,49,1,6.37093754868329,-23,0
24,1,1.5,54,17,37,1,0.403025521191012,-33,0
24,1,1.5,9,53,-44,0,0.870274272623647,-3,0
24,1,1.5,3,100,-97,1,0.822944696448758,50,0
24,1,1.5,15,75,-60,0,1.08955857960973,-25,0
24,1,1.5,65,31,34,1,0.505525956472411,-19,0
24,1,1.5,48,80,-32,0,1.18486799541824,-30,0
24,1,1.5,5,83,-78,0,0.956792668956041,-33,0
24,1,1.5,65,34,31,1,0.762110607101931,-16,0
24,1,1.5,34,92,-58,0,1.43805837342552,-42,0
24,1,1.5,7,100,-93,0,0.880044719357102,-50,0
24,1,1.5,49,100,-51,1,0.535980939288493,50,0
24,1,1.5,14,56,-42,0,0.84597369988478,-6,0
24,1,1.5,11,91,-80,0,1.44061873997634,-41,0
24,1,1.5,51,2,49,1,1.05858932416959,-48,0
24,1,1.5,49,98,-49,0,1.11657603665662,-48,0
24,1,1.5,82,6,76,1,0.803180939288723,-44,0
24,1,1.5,73,35,38,0,0.710434822451134,15,0
24,1,1.5,49,99,-50,0,0.941798854524677,-49,0
24,1,1.5,97,25,72,1,0.676421351661702,-25,0
24,1,1.5,82,46,36,1,1.26111486826994,-4,0
24,1,10,51,1,50,1,5.33886093929141,-49,0
24,1,10,94,19,75,0,5.40873053837277,31,0
24,1,10,82,5,77,0,5.97997489117915,45,0
24,1,10,49,97,-48,1,6.56060810996496,47,0
24,1,10,51,0,51,1,5.35774167239288,-50,0
24,1,10,80,42,38,1,4.3391321878571,-8,0
24,1,10,26,54,-28,1,5.19299665521248,4,0
24,1,10,49,99,-50,1,6.02095725085928,49,0
24,1,10,14,57,-43,0,9.30343807559984,-7,0
24,1,10,11,54,-43,1,6.1267680183264,4,0
24,1,10,52,19,33,1,8.32396719358439,-31,0
24,1,10,10,97,-87,1,5.37059702176339,47,0
24,1,10,29,54,-25,1,7.67109424971386,4,0
24,1,10,1,100,-99,0,1.59186584192503,-50,0
24,1,10,7,79,-72,1,7.94611793814329,29,0
24,1,10,90,18,72,1,6.17415624283967,-32,0
24,1,10,78,23,55,0,8.58667326460454,27,0
24,1,10,84,30,54,1,5.03064925544095,-20,0
24,1,10,92,0,92,0,6.40120155784643,50,0
24,1,10,11,54,-43,1,6.50848109965591,4,0
24,1,1.5,49,97,-48,1,0.765209072163998,47,0
24,1,1.5,61,34,27,1,0.961769347079098,-16,0
24,1,1.5,48,98,-50,0,1.1511408018323,-48,0
24,1,1.5,24,74,-50,NaN,NaN,0,0
24,1,1.5,51,0,51,1,0.915700343643039,-50,0
24,1,1.5,32,57,-25,0,1.0583217411222,-7,0
24,1,1.5,5,100,-95,0,0.995562886597327,-50,0
24,1,1.5,3,100,-97,1,1.35957773195878,50,0
24,1,1.5,96,11,85,1,1.35693085910498,-39,0
24,1,1.5,68,48,20,1,1.29016778923142,-2,0
24,1,1.5,8,66,-58,1,1.24954318442178,16,0
24,1,1.5,87,25,62,NaN,NaN,0,0
24,1,1.5,49,100,-51,NaN,NaN,0,0
24,1,1.5,80,45,35,1,0.689431386024808,-5,0
24,1,1.5,52,0,52,1,0.769323986254676,-50,0
24,1,1.5,13,58,-45,0,0.613993860251867,-8,0
24,1,1.5,29,54,-25,1,0.881327651775791,4,0
24,1,1.5,84,33,51,1,1.0338672164944,-17,0
24,1,1.5,12,87,-75,1,1.13989938144186,37,0
24,1,1.5,11,94,-83,1,0.91386098510884,44,0
24,1,10,31,62,-31,1,5.88701397479781,12,0
24,1,10,69,35,34,1,7.39889411225522,-15,0
24,1,10,52,0,52,0,5.85807358533748,50,0
24,1,10,46,86,-40,0,5.99540197021634,-36,0
24,1,10,42,87,-45,1,8.27924746849931,37,0
24,1,10,95,27,68,NaN,NaN,0,0
24,1,10,53,40,13,1,3.61916737686261,-10,0
24,1,10,68,48,20,1,1.49379922107619,-2,0
24,1,10,49,97,-48,0,2.14179189003335,-47,0
24,1,10,100,15,85,0,2.051734432991,35,0
24,1,10,65,3,62,0,2.53966332187883,47,0
24,1,10,44,61,-17,1,2.68163628865841,11,0
24,1,10,94,28,66,1,2.7615541809846,-22,0
24,1,10,77,8,69,0,3.04683326460508,42,0
24,1,10,80,6,74,0,7.39267812142134,44,0
24,1,10,53,40,13,1,3.46866180985126,-10,0
24,1,10,42,65,-23,0,3.3972013745697,-15,0
24,1,10,51,2,49,1,3.68926497136272,-48,0
24,1,10,31,81,-50,1,7.82512091637909,31,0
24,1,10,100,15,85,1,6.29166625429571,-35,0
24,1,1.5,87,8,79,1,0.729758350515112,-42,0
24,1,1.5,64,46,18,1,1.2803064375712,-4,0
24,1,1.5,52,49,3,0,1.48094423825933,1,0
24,1,1.5,80,6,74,0,1.36091271477562,44,0
24,1,1.5,48,80,-32,1,0.934247880870316,30,0
24,1,1.5,12,87,-75,1,0.788224513173191,37,0
24,1,1.5,73,0,73,1,0.920185475371909,-50,0
24,1,1.5,69,18,51,NaN,NaN,0,0
24,1,1.5,57,9,48,1,1.02942167239416,-41,0
24,1,1.5,93,25,68,0,1.40802895761772,25,0
24,1,1.5,50,18,32,1,1.00209447880843,-32,0
24,1,1.5,83,42,41,0,1.34934396334393,8,0
24,1,1.5,32,56,-24,0,1.34606112256552,-6,0
24,1,1.5,93,15,78,1,0.879303550973418,-35,0
24,1,1.5,4,55,-51,1,0.679901397479625,5,0
24,1,1.5,51,47,4,1,1.18450107674835,-3,0
24,1,1.5,92,0,92,0,0.923857594501897,50,0
24,1,1.5,49,99,-50,1,1.3618525544116,49,0
24,1,1.5,94,34,60,1,1.02255321878511,-16,0
24,1,1.5,29,54,-25,0,1.08907436426125,-4,0
25,1,10,28,85,-57,0,3.47047565984576,-35,0
25,1,10,30,100,-70,0,3.74374923252617,-50,0
25,1,10,100,0,100,1,4.43854140511394,-50,0
25,1,10,85,15,70,1,5.10529616711938,-35,0
25,1,10,53,23,30,1,4.47347444471416,-27,0
25,1,10,48,80,-32,1,5.26690578258604,30,0
25,1,10,53,40,13,0,3.85236601963697,10,0
25,1,10,25,55,-30,0,4.48649263866173,-5,0
25,1,10,48,100,-52,0,5.05530688884755,-50,0
25,1,10,50,100,-50,0,5.20124518667762,-50,0
25,1,10,50,43,7,1,2.54147402684248,-7,0
25,1,10,100,0,100,1,3.66826056915124,-50,0
25,1,10,48,100,-52,1,5.98166199614752,50,0
25,1,10,0,68,-68,0,3.37855141206092,-18,0
25,1,10,48,60,-12,0,3.98401527800524,-10,0
25,1,10,5,83,-78,0,5.3647960763974,-33,0
25,1,10,3,100,-97,0,3.82693481372553,-50,0
25,1,10,50,100,-50,1,4.91029194257499,50,0
25,1,10,53,0,53,1,4.67842110182755,-50,0
25,1,10,0,68,-68,0,4.4799452367115,-18,0
25,1,1.5,48,80,-32,0,0.922112601969275,-30,0
25,1,1.5,75,0,75,1,0.753556406369171,-50,0
25,1,1.5,85,15,70,1,0.823600997760877,-35,0
25,1,1.5,28,85,-57,0,0.650966879940825,-35,0
25,1,1.5,25,55,-30,1,0.797027973630975,5,0
25,1,1.5,100,15,85,1,0.793755372318628,-35,0
25,1,1.5,48,60,-12,0,0.518442288694132,-10,0
25,1,1.5,75,0,75,1,0.613849906803807,-50,0
25,1,1.5,53,23,30,1,0.705888519687505,-27,0
25,1,1.5,5,83,-78,0,0.569906216953314,-33,0
25,1,1.5,98,38,60,1,0.703296244097146,-12,0
25,1,1.5,80,45,35,1,0.567365625591265,-5,0
25,1,1.5,98,38,60,1,0.660750960831137,-12,0
25,1,1.5,50,43,7,0,0.598751147774237,7,0
25,1,1.5,100,15,85,1,0.578836225146006,-35,0
25,1,1.5,53,0,53,0,0.616209786647232,50,0
25,1,1.5,30,100,-70,0,0.73158767716086,-50,0
25,1,1.5,53,40,13,1,0.826895225807675,-10,0
25,1,1.5,3,100,-97,0,0.606283482491563,-50,0
25,1,1.5,80,45,35,1,0.586393119032437,-5,0
25,1,10,49,77,-28,1,3.1525872354614,27,0
25,1,10,50,65,-15,1,1.70262178325356,15,0
25,1,10,51,1,50,1,4.22146911500749,-49,0
25,1,10,49,98,-49,1,3.94359234706826,48,0
25,1,10,22,69,-47,0,3.60633223427976,-19,0
25,1,10,44,81,-37,0,3.81842231145674,-31,0
25,1,10,49,100,-51,1,3.09392820291032,50,0
25,1,10,18,76,-58,0,4.00668815899735,-26,0
25,1,10,51,3,48,1,4.13080544920376,-47,0
25,1,10,16,69,-53,0,4.43424721555857,-19,0
25,1,10,49,96,-47,1,3.60434074201839,46,0
25,1,10,75,40,35,1,4.60043803299413,-10,0
25,1,10,51,3,48,1,3.81259409003724,-47,0
25,1,10,15,95,-80,0,3.38471209869203,-45,0
25,1,10,51,1,50,1,3.09350483210801,-49,0
25,1,10,51,2,49,1,3.95023578638029,-48,0
25,1,10,71,39,32,1,4.30832061082765,-11,0
25,1,10,65,45,20,1,4.80443787904005,-5,0
25,1,10,90,12,78,1,3.64055892276883,-38,0
25,1,10,18,60,-42,0,3.86729139824274,-10,0
25,1,1.5,62,40,22,1,0.788939941829085,-10,0
25,1,1.5,49,96,-47,0,0.857626447663279,-46,0
25,1,1.5,57,49,8,1,1.10764248443411,-1,0
25,1,1.5,26,70,-44,0,0.803752421552417,-20,0
25,1,1.5,51,3,48,1,0.743759129505634,-47,0
25,1,1.5,8,77,-69,0,0.558491700283412,-27,0
25,1,1.5,49,97,-48,1,0.572542112566225,47,0
25,1,1.5,36,68,-32,0,0.993912624329823,-18,0
25,1,1.5,51,1,50,1,0.630647647360092,-49,0
25,1,1.5,81,4,77,1,0.594031754642856,-46,0
25,1,1.5,23,68,-45,0,0.622084560527583,-18,0
25,1,1.5,51,4,47,1,0.577383935002217,-46,0
25,1,1.5,42,91,-49,0,0.806857873873014,-41,0
25,1,1.5,49,100,-51,0,0.634884287812383,-50,0
25,1,1.5,30,95,-65,0,0.797622525526094,-45,0
25,1,1.5,59,45,14,1,0.882331508501011,-5,0
25,1,1.5,68,26,42,1,0.923038519411421,-24,0
25,1,1.5,48,91,-43,0,0.650441606903769,-41,0
25,1,1.5,51,0,51,1,0.580447966627617,-50,0
25,1,1.5,49,98,-49,0,0.82582085366812,-48,0
25,1,10,49,97,-48,0,3.38123899190214,-47,0
25,1,10,49,99,-50,0,3.06663893068617,-49,0
25,1,10,1,52,-51,0,3.0600889628513,-2,0
25,1,10,95,13,82,1,3.95013864935572,-37,0
25,1,10,51,0,51,1,2.98830286957491,-50,0
25,1,10,49,98,-49,0,3.53709992833683,-48,0
25,1,10,11,83,-72,0,3.79986510783237,-33,0
25,1,10,91,40,51,1,2.93997041902549,-10,0
25,1,10,7,76,-69,0,4.24267834265811,-26,0
25,1,10,46,52,-6,1,1.77349405539826,2,0
25,1,10,67,21,46,1,5.01637033765292,-29,0
25,1,10,49,97,-48,0,7.21175944474271,-47,0
25,1,10,46,60,-14,0,3.91139820498029,-10,0
25,1,10,72,9,63,1,3.31142936214019,-41,0
25,1,10,69,48,21,1,4.99961181846083,-2,0
25,1,10,20,78,-58,0,4.51568579655031,-28,0
25,1,10,46,89,-43,0,4.81923239757998,-39,0
25,1,10,49,98,-49,1,3.39063342503323,48,0
25,1,10,49,100,-51,1,4.14667873853796,50,0
25,1,10,51,4,47,1,3.70546258300237,-46,0
25,1,1.5,51,3,48,1,1.27434684515538,-47,0
25,1,1.5,49,96,-47,0,0.819063415814526,-46,0
25,1,1.5,58,19,39,1,0.782497741105544,-31,0
25,1,1.5,50,95,-45,0,0.658541368458827,-45,0
25,1,1.5,51,0,51,1,0.611958117448012,-50,0
25,1,1.5,82,3,79,1,0.543306800873324,-47,0
25,1,1.5,59,2,57,1,0.477370922308182,-48,0
25,1,1.5,18,94,-76,0,0.47878692352424,-44,0
25,1,1.5,75,15,60,1,0.743447924476641,-35,0
25,1,1.5,49,97,-48,0,0.525487472074019,-47,0
25,1,1.5,73,50,23,0,0.651506815169341,0,0
25,1,1.5,51,1,50,1,0.588939941826538,-49,0
25,1,1.5,51,2,49,1,0.400950843168175,-48,0
25,1,1.5,26,60,-34,0,0.493063866675584,-10,0
25,1,1.5,46,67,-21,0,0.780967374790634,-17,0
25,1,1.5,71,8,63,1,0.489832686058435,-42,0
25,1,1.5,49,100,-51,0,0.713799138962713,-50,0
25,1,1.5,51,6,45,1,0.777180863638932,-44,0
25,1,1.5,78,2,76,1,0.605881371868236,-48,0
25,1,1.5,49,99,-50,1,0.585326444546808,49,0
25,1,10,56,44,12,1,3.47071172114011,-6,0
25,1,10,32,91,-59,0,3.91942758801451,-41,0
25,1,10,28,71,-43,0,3.96623370434645,-21,0
25,1,10,57,6,51,1,4.04301850551929,-44,0
25,1,10,49,96,-47,0,4.21303102336606,-46,0
25,1,10,49,99,-50,1,3.17662589966312,49,0
25,1,10,70,38,32,1,3.23742561228391,-12,0
25,1,10,49,100,-51,1,2.76738651921551,50,0
25,1,10,49,97,-48,1,2.50022524792803,47,0
25,1,10,46,89,-43,1,2.77159640116406,39,0
25,1,10,51,27,24,1,2.24776135815955,-23,0
25,1,10,34,86,-52,0,0.94574292411744,-36,0
25,1,10,81,33,48,1,2.7907268965082,-17,0
25,1,10,51,0,51,1,3.0747581196465,-50,0
25,1,10,49,97,-48,1,4.24344334254056,47,0
25,1,10,65,10,55,1,3.40562844905071,-40,0
25,1,10,32,52,-20,0,3.44103727679067,-2,0
25,1,10,51,1,50,1,1.77116899826069,-49,0
25,1,10,79,24,55,1,3.87876346401572,-26,0
25,1,10,51,4,47,1,4.15949935944627,-46,0
25,1,1.5,42,83,-41,0,0.935050153861084,-33,0
25,1,1.5,49,99,-50,1,0.621158276533606,49,0
25,1,1.5,51,3,48,1,0.60789998918699,-47,0
25,1,1.5,51,0,51,1,0.451271120429737,-50,0
25,1,1.5,41,65,-24,0,0.540602359513287,-15,0
25,1,1.5,4,85,-81,0,0.53871093671296,-35,0
25,1,1.5,11,97,-86,0,0.848719165869625,-47,0
25,1,1.5,71,9,62,1,0.770796212022105,-41,0
25,1,1.5,59,15,44,1,0.567473392702595,-35,0
25,1,1.5,51,4,47,1,0.540224074951766,-46,0
25,1,1.5,49,96,-47,1,0.673600173013256,46,0
25,1,1.5,32,77,-45,1,0.642333048032015,27,0
25,1,1.5,15,95,-80,0,0.748312839863502,-45,0
25,1,1.5,51,2,49,1,0.674423455109718,-48,0
25,1,1.5,60,13,47,1,0.787082242068209,-37,0
25,1,1.5,51,1,50,1,0.559225176450127,-49,0
25,1,1.5,51,4,47,1,0.62056629052131,-46,0
25,1,1.5,9,59,-50,0,0.615257477260457,-9,0
25,1,1.5,19,99,-80,0,0.722030860250015,-49,0
25,1,1.5,22,67,-45,0,0.832708051926602,-17,0
25,1,10,49,99,-50,1,4.55472608275704,49,0
25,1,10,14,56,-42,0,4.48025534207773,-6,0
25,1,10,2,97,-95,0,4.19303912422765,-47,0
25,1,10,95,3,92,1,4.52510002364215,-47,0
25,1,10,51,1,50,1,4.53198575568058,-49,0
25,1,10,51,4,47,1,4.05074951294046,-46,0
25,1,10,63,44,19,1,3.69220942742322,-6,0
25,1,10,68,10,58,1,3.87633980363717,-40,0
25,1,10,49,98,-49,1,5.11701822327086,48,0
25,1,10,85,24,61,1,3.19592720954643,-26,0
25,1,10,49,98,-49,1,6.50255177128383,48,0
25,1,10,19,97,-78,0,3.32612124533262,-47,0
25,1,10,51,3,48,1,3.32492627666397,-47,0
25,1,10,49,100,-51,1,4.61165094452008,50,0
25,1,10,97,9,88,1,4.14307257235305,-41,0
25,1,10,49,97,-48,1,3.71724585380616,47,0
25,1,10,15,54,-39,0,4.84399097541973,-4,0
25,1,10,12,59,-47,0,4.61409806440679,-9,0
25,1,10,16,56,-40,0,4.06489999468431,-6,0
25,1,10,11,85,-74,0,3.93834218257689,-35,0
25,1,1.5,49,98,-49,0,0.689947051158015,-48,0
25,1,1.5,51,4,47,0,0.561949778324561,46,0
25,1,1.5,49,99,-50,1,0.967373323241191,49,0
25,1,1.5,24,97,-73,0,0.587333332110575,-47,0
25,1,1.5,22,99,-77,0,0.759461970854318,-49,0
25,1,1.5,86,18,68,1,0.636896307143616,-32,0
25,1,1.5,45,97,-52,0,0.758901875111405,-47,0
25,1,1.5,94,34,60,1,0.724186569064841,-16,0
25,1,1.5,91,25,66,1,0.554964343380561,-25,0
25,1,1.5,49,97,-48,0,0.872372947520489,-47,0
25,1,1.5,49,96,-47,1,0.847771988248496,46,0
25,1,1.5,28,64,-36,0,0.8658328766669,-14,0
25,1,1.5,90,2,88,1,0.641875221079317,-48,0
25,1,1.5,62,15,47,1,1.18719880649587,-35,0
25,1,1.5,51,4,47,0,0.535299044573549,46,0
25,1,1.5,11,76,-65,0,0.549348723749063,-26,0
25,1,1.5,49,99,-50,1,0.602007620675067,49,0
25,1,1.5,0,53,-53,0,1.06146427648491,-3,0
25,1,1.5,49,100,-51,1,0.342159484331205,50,0
25,1,1.5,85,43,42,1,0.596266272743378,-7,0
26,1,10,5,83,-78,0,2.5199745168502,-33,0
26,1,10,48,60,-12,1,2.43915198845207,10,0
26,1,10,48,60,-12,1,2.20163477852475,10,0
26,1,10,53,23,30,1,2.19775292184204,-27,0
26,1,10,80,45,35,1,3.49041082433541,-5,0
26,1,10,25,55,-30,1,2.85899989589234,5,0
26,1,10,0,68,-68,0,2.44502315917634,-18,0
26,1,10,48,100,-52,0,2.95957810559776,-50,0
26,1,10,85,15,70,0,2.0455434526084,35,0
26,1,10,50,100,-50,1,3.23865464158007,50,0
26,1,10,0,68,-68,0,3.81730677589076,-18,0
26,1,10,48,80,-32,1,3.32461229086039,30,0
26,1,10,100,15,85,0,3.44394950874266,35,0
26,1,10,28,85,-57,0,3.94257601327263,-35,0
26,1,10,100,0,100,0,3.58115792961325,50,0
26,1,10,53,40,13,1,3.71454644223559,-10,0
26,1,10,98,38,60,1,4.78642713764566,-12,0
26,1,10,53,40,13,1,4.27102947278763,-10,0
26,1,10,53,0,53,0,3.88031858351314,50,0
26,1,10,100,15,85,0,3.72167417622404,35,0
26,1,1.5,50,43,7,1,0.914940786111401,-7,0
26,1,1.5,80,45,35,1,1.13814937704592,-5,0
26,1,1.5,3,100,-97,0,0.77678920965991,-50,0
26,1,1.5,75,0,75,0,0.774171614000807,50,0
26,1,1.5,75,0,75,0,0.755487383779837,50,0
26,1,1.5,5,83,-78,0,0.769371894333744,-33,0
26,1,1.5,50,43,7,1,0.782714997680159,-7,0
26,1,1.5,48,100,-52,1,1.24334695952712,50,0
26,1,1.5,50,100,-50,1,0.806034362671198,50,0
26,1,1.5,85,15,70,0,1.27399016742129,35,0
26,1,1.5,30,100,-70,1,1.32330001069931,50,0
26,1,1.5,98,38,60,0,1.42648152029142,12,0
26,1,1.5,30,100,-70,NaN,NaN,0,0
26,1,1.5,48,80,-32,1,1.26128670902108,30,0
26,1,1.5,28,85,-57,0,0.935101514769485,-35,0
26,1,1.5,53,23,30,1,0.717806615371956,-27,0
26,1,1.5,3,100,-97,0,0.669081799773267,-50,0
26,1,1.5,100,0,100,0,0.694338427536422,50,0
26,1,1.5,53,0,53,0,0.895006590726553,50,0
26,1,1.5,25,55,-30,1,0.807675812538946,5,0
26,1,10,32,62,-30,1,2.26751637418056,12,0
26,1,10,51,34,17,1,3.0608036579797,-16,0
26,1,10,41,80,-39,1,3.13470629119547,30,0
26,1,10,1,72,-71,0,3.36536592090852,-22,0
26,1,10,45,80,-35,1,3.51457437404315,30,0
26,1,10,86,20,66,0,3.29854520183289,30,0
26,1,10,87,24,63,0,3.48322480751085,26,0
26,1,10,92,30,62,0,3.21167262204108,20,0
26,1,10,96,32,64,0,4.0077644464327,18,0
26,1,10,47,92,-45,1,3.3157492679893,42,0
26,1,10,3,56,-53,0,3.80969811690738,-6,0
26,1,10,42,76,-34,1,4.08555516783963,26,0
26,1,10,41,62,-21,1,3.86224907223368,12,0
26,1,10,82,30,52,0,3.07224248885177,20,0
26,1,10,8,69,-61,0,3.68949032211094,-19,0
26,1,10,2,85,-83,0,2.80942393100122,-35,0
26,1,10,52,31,21,1,3.73340588752762,-19,0
26,1,10,100,14,86,0,3.3879869915545,36,0
26,1,10,73,47,26,1,3.33601006717072,-3,0
26,1,10,70,39,31,1,3.37462995899841,-11,0
26,1,1.5,20,97,-77,0,1.24653858618694,-47,0
26,1,1.5,96,34,62,0,1.13713914129767,16,0
26,1,1.5,6,70,-64,0,0.6798058412096,-20,0
26,1,1.5,97,34,63,1,1.2891107139294,-16,0
26,1,1.5,41,79,-38,1,0.849830429942813,29,0
26,1,1.5,78,21,57,0,1.0037619919749,29,0
26,1,1.5,16,55,-39,0,0.72770333380322,-5,0
26,1,1.5,47,75,-28,1,0.687046108680079,25,0
26,1,1.5,76,38,38,1,1.02370791722205,-12,0
26,1,1.5,96,21,75,0,1.01102351985173,29,0
26,1,1.5,48,64,-16,1,0.741703676874749,14,0
26,1,1.5,36,71,-35,1,0.82027223581099,21,0
26,1,1.5,49,51,-2,1,0.751581700809766,1,0
26,1,1.5,42,62,-20,1,0.877441830816679,12,0
26,1,1.5,37,69,-32,1,0.782876283512451,19,0
26,1,1.5,48,78,-30,1,1.05156931112288,28,0
26,1,1.5,77,49,28,1,1.02944309468148,-1,0
26,1,1.5,87,35,52,1,1.24081403890159,-15,0
26,1,1.5,70,40,30,1,1.04340641538147,-10,0
26,1,1.5,54,28,26,0,1.30139666196192,22,0
26,1,10,93,16,77,0,3.45000139292097,34,0
26,1,10,94,23,71,0,3.17194718917017,27,0
26,1,10,10,68,-58,0,3.64129261794733,-18,0
26,1,10,43,72,-29,1,3.53180483242613,22,0
26,1,10,83,9,74,0,4.43372985211317,41,0
26,1,10,52,49,3,1,3.78043207005248,-1,0
26,1,10,45,84,-39,1,3.31372696362087,34,0
26,1,10,49,65,-16,1,4.44154011836508,15,0
26,1,10,28,60,-32,1,4.23557005007751,10,0
26,1,10,67,25,42,1,3.80620884461678,-25,0
26,1,10,79,49,30,1,3.61687504308065,-1,0
26,1,10,99,6,93,0,4.27608834946295,44,0
26,1,10,43,62,-19,1,4.06861575704534,12,0
26,1,10,27,58,-31,1,3.95003401665599,8,0
26,1,10,85,50,35,1,3.57129860017449,0,0
26,1,10,72,39,33,1,3.29655662085861,-11,0
26,1,10,62,48,14,1,2.6725388148916,-2,0
26,1,10,21,57,-36,0,2.85788115873584,-7,0
26,1,10,39,70,-31,1,2.61107498471392,20,0
26,1,10,49,65,-16,1,3.27040998858865,15,0
26,1,1.5,25,73,-48,0,1.18239337907289,-23,0
26,1,1.5,90,23,67,0,1.30631991190603,27,0
26,1,1.5,96,12,84,0,0.785632804967463,38,0
26,1,1.5,100,49,51,1,0.797654464171501,-1,0
26,1,1.5,13,74,-61,0,1.09032702900004,-24,0
26,1,1.5,97,21,76,0,0.858908622787567,29,0
26,1,1.5,6,52,-46,0,0.644212991115637,-2,0
26,1,1.5,97,49,48,1,0.718172807508381,-1,0
26,1,1.5,28,98,-70,0,0.868864723714069,-48,0
26,1,1.5,81,15,66,0,1.02953033565427,35,0
26,1,1.5,19,53,-34,0,0.903465299372328,-3,0
26,1,1.5,36,69,-33,0,0.894762462645303,-19,0
26,1,1.5,44,89,-45,1,0.974774163158145,39,0
26,1,1.5,38,65,-27,1,0.947420453099767,15,0
26,1,1.5,42,80,-38,1,0.98538677074248,30,0
26,1,1.5,69,22,47,0,1.27739513121196,28,0
26,1,1.5,14,75,-61,0,0.806010536354734,-25,0
26,1,1.5,42,81,-39,1,0.785190368595067,31,0
26,1,1.5,1,75,-74,0,0.645184738270473,-25,0
26,1,1.5,91,41,50,1,0.863219353137538,-9,0
26,1,10,46,59,-13,1,1.04148894679383,9,0
26,1,10,76,42,34,1,1.04191378830001,-8,0
26,1,10,92,19,73,0,3.21056854721974,31,0
26,1,10,10,98,-88,0,4.10981328965863,-48,0
26,1,10,46,64,-18,1,4.02115007059183,14,0
26,1,10,38,84,-46,1,3.53573177580256,34,0
26,1,10,8,82,-74,0,3.80574294849066,-32,0
26,1,10,49,66,-17,1,4.08893447250011,16,0
26,1,10,52,43,9,1,3.63292591556092,-7,0
26,1,10,34,89,-55,0,3.72284496473731,-39,0
26,1,10,37,70,-33,1,3.40087702835444,20,0
26,1,10,70,20,50,0,4.18815348250791,30,0
26,1,10,63,20,43,0,3.30412679119036,30,0
26,1,10,40,64,-24,1,3.42340022785356,14,0
26,1,10,0,84,-84,0,3.60198579510325,-34,0
26,1,10,71,33,38,0,4.26116391186952,17,0
26,1,10,92,22,70,0,3.5425574654073,28,0
26,1,10,83,39,44,1,3.93248208626756,-11,0
26,1,10,96,11,85,0,3.33849753451068,39,0
26,1,10,8,93,-85,0,4.02439741414855,-43,0
26,1,1.5,4,51,-47,0,0.622451134055154,-1,0
26,1,1.5,48,67,-19,1,0.745035695494153,17,0
26,1,1.5,17,69,-52,0,0.750985309801763,-19,0
26,1,1.5,60,36,24,1,0.940369329880923,-14,0
26,1,1.5,84,46,38,1,0.898284358641831,-4,0
26,1,1.5,87,25,62,0,0.938284710544394,25,0
26,1,1.5,48,73,-25,1,0.808251309732441,23,0
26,1,1.5,67,9,58,0,0.923576542612864,41,0
26,1,1.5,49,57,-8,1,1.10619168967241,7,0
26,1,1.5,32,96,-64,0,0.873468334466452,-46,0
26,1,1.5,45,82,-37,1,1.01684263930656,32,0
26,1,1.5,91,18,73,0,1.01944300672039,32,0
26,1,1.5,67,39,28,0,1.32604773473577,11,0
26,1,1.5,55,31,24,0,0.96457869943697,19,0
26,1,1.5,42,87,-45,1,0.978071358724264,37,0
26,1,1.5,49,53,-4,1,1.11071649030782,3,0
26,1,1.5,94,45,49,1,0.998041476850631,-5,0
26,1,1.5,50,84,-34,1,1.03392537453328,34,0
26,1,1.5,89,23,66,0,0.995955757854972,27,0
26,1,1.5,35,97,-62,0,1.31979754229542,-47,0
26,1,10,49,84,-35,1,3.2111920635798,34,0
26,1,10,100,48,52,1,3.47843791742343,-2,0
26,1,10,25,97,-72,0,4.43905814940808,-47,0
26,1,10,64,50,14,1,3.60900026245508,0,0
26,1,10,67,32,35,0,3.59632466250332,18,0
26,1,10,91,4,87,0,3.29622891740291,46,0
26,1,10,84,15,69,0,2.84020019968739,35,0
26,1,10,100,26,74,0,2.85813628358301,24,0
26,1,10,67,39,28,1,3.23548830748769,-11,0
26,1,10,100,18,82,0,3.39743577525951,32,0
26,1,10,44,77,-33,1,3.41664528407273,27,0
26,1,10,98,7,91,0,3.39536691794638,43,0
26,1,10,52,16,36,0,3.29464904934866,34,0
26,1,10,36,68,-32,0,3.15052879758878,-18,0
26,1,10,11,50,-39,0,3.61985736468341,0,0
26,1,10,17,83,-66,0,3.38249484251719,-33,0
26,1,10,24,62,-38,0,4.28238399515976,-12,0
26,1,10,70,12,58,0,4.27439154920285,38,0
26,1,10,11,65,-54,0,4.39491751696914,-15,0
26,1,10,38,81,-43,0,3.50294823164586,-31,0
26,1,1.5,93,11,82,0,0.712223559763515,39,0
26,1,1.5,32,70,-38,0,0.855588700593216,-20,0
26,1,1.5,31,87,-56,0,0.768120096385246,-37,0
26,1,1.5,63,40,23,1,0.980845474987291,-10,0
26,1,1.5,87,21,66,0,1.4087492430408,29,0
26,1,1.5,43,63,-20,1,0.803898791695246,13,0
26,1,1.5,24,56,-32,0,0.855429980700137,-6,0
26,1,1.5,29,86,-57,0,0.768642809067387,-36,0
26,1,1.5,89,9,80,0,0.78064137508045,41,0
26,1,1.5,84,15,69,0,0.921387087437324,35,0
26,1,1.5,94,23,71,0,0.83864415800781,27,0
26,1,1.5,31,58,-27,0,0.592608856939478,-8,0
26,1,1.5,95,20,75,0,0.907921920035733,30,0
26,1,1.5,41,80,-39,1,0.90730903390795,30,0
26,1,1.5,35,99,-64,0,1.03455548893544,-49,0
26,1,1.5,88,2,86,0,0.860603223642102,48,0
26,1,1.5,5,89,-84,0,0.653868147375761,-39,0
26,1,1.5,3,59,-56,0,0.591185876051895,-9,0
26,1,1.5,15,93,-78,0,0.915130296954885,-43,0
26,1,1.5,35,94,-59,0,1.07311123295221,-44,0
27,1,10,100,15,85,1,4.74629555776482,-35,0
27,1,10,75,0,75,1,4.53610933126765,-50,0
27,1,10,53,0,53,1,3.47063314949628,-50,0
27,1,10,25,55,-30,0,3.99195770206279,-5,0
27,1,10,53,40,13,1,3.82866129829199,-10,0
27,1,10,85,15,70,1,4.1359591888322,-35,0
27,1,10,85,15,70,1,4.37452548975125,-35,0
27,1,10,48,60,-12,0,3.89184208944789,-10,0
27,1,10,100,0,100,1,4.54841983874212,-50,0
27,1,10,50,100,-50,1,4.73035575254471,50,0
27,1,10,53,23,30,1,4.53760965602123,-27,0
27,1,10,50,100,-50,0,5.0642163195007,-50,0
27,1,10,100,0,100,1,4.37024005196872,-50,0
27,1,10,28,85,-57,0,5.19145287739229,-35,0
27,1,10,48,80,-32,1,5.93207080740831,30,0
27,1,10,0,68,-68,0,4.98740504297893,-18,0
27,1,10,30,100,-70,0,5.4719615582726,-50,0
27,1,10,3,100,-97,0,4.72925570988446,-50,0
27,1,10,80,45,35,1,4.40846296070958,-5,0
27,1,10,98,38,60,1,4.0764846726961,-12,0
27,1,1.5,50,43,7,1,0.610518548579421,-7,0
27,1,1.5,100,15,85,1,0.414410742203472,-35,0
27,1,1.5,25,55,-30,0,0.458383124205284,-5,0
27,1,1.5,5,83,-78,0,0.492344421480084,-33,0
27,1,1.5,48,100,-52,0,0.852943979582051,-50,0
27,1,1.5,0,68,-68,0,0.598877743876074,-18,0
27,1,1.5,48,100,-52,1,0.538824431569083,50,0
27,1,1.5,30,100,-70,0,0.641617388959276,-50,0
27,1,1.5,28,85,-57,0,0.612231477425667,-35,0
27,1,1.5,53,0,53,1,0.520323847274994,-50,0
27,1,1.5,48,60,-12,1,0.831575073447311,10,0
27,1,1.5,5,83,-78,0,0.602839510334888,-33,0
27,1,1.5,3,100,-97,0,0.598804065579316,-50,0
27,1,1.5,53,23,30,1,0.546846568788169,-27,0
27,1,1.5,53,40,13,1,0.497287099045934,-10,0
27,1,1.5,75,0,75,1,0.618093850760488,-50,0
27,1,1.5,98,38,60,1,0.525399952224689,-12,0
27,1,1.5,50,43,7,1,0.588744595093885,-7,0
27,1,1.5,80,45,35,1,0.641278322145808,-5,0
27,1,1.5,48,80,-32,0,0.763999976537889,-30,0
27,1,10,51,3,48,0,3.57062449870864,47,0
27,1,10,76,46,30,1,3.27987233491149,-4,0
27,1,10,74,5,69,1,3.27309356484329,-45,0
27,1,10,24,54,-30,0,3.17040764261037,-4,0
27,1,10,28,53,-25,0,3.66374873719178,-3,0
27,1,10,49,100,-51,1,3.57765582777211,50,0
27,1,10,58,4,54,1,3.3988023060956,-46,0
27,1,10,49,97,-48,1,3.57886987019447,47,0
27,1,10,51,2,49,1,4.08015282565611,-48,0
27,1,10,14,87,-73,0,3.68141100174398,-37,0
27,1,10,47,54,-7,1,3.46599398259423,4,0
27,1,10,21,76,-55,0,3.57136054860894,-26,0
27,1,10,51,2,49,0,3.79269345870125,48,0
27,1,10,2,72,-70,0,3.82126487678033,-22,0
27,1,10,36,53,-17,0,4.03267357652658,-3,0
27,1,10,51,1,50,0,3.43518509014393,49,0
27,1,10,50,50,0,1,4.32578711150563,0,0
27,1,10,49,96,-47,1,3.99703417351702,46,0
27,1,10,51,4,47,0,3.92959946862538,46,0
27,1,10,88,28,60,1,4.40091331765871,-22,0
27,1,1.5,49,97,-48,0,0.622344465489732,-47,0
27,1,1.5,18,74,-56,0,0.625589243107243,-24,0
27,1,1.5,49,98,-49,0,0.644923748448491,-48,0
27,1,1.5,0,55,-55,0,0.527606269024545,-5,0
27,1,1.5,20,70,-50,0,0.550839859293774,-20,0
27,1,1.5,51,27,24,1,0.444824117788812,-23,0
27,1,1.5,7,64,-57,0,0.487519775837427,-14,0
27,1,1.5,51,1,50,1,0.424107319588074,-49,0
27,1,1.5,44,88,-44,0,0.523496046283981,-38,0
27,1,1.5,49,96,-47,0,0.618034101673402,-46,0
27,1,1.5,44,59,-15,0,0.604667905136012,-9,0
27,1,1.5,69,34,35,1,0.496676412236411,-16,0
27,1,1.5,70,2,68,1,0.545360906340647,-48,0
27,1,1.5,10,81,-71,0,0.423186890693614,-31,0
27,1,1.5,24,85,-61,0,0.562725158699322,-35,0
27,1,1.5,49,96,-47,0,0.632644765049918,-46,0
27,1,1.5,41,61,-20,0,1.03519989911001,-11,0
27,1,1.5,51,1,50,1,0.493966443726094,-49,0
27,1,1.5,49,100,-51,0,0.726613921317039,-50,0
27,1,1.5,49,99,-50,0,0.613852400012547,-49,0
27,1,10,72,0,72,1,4.43441385062761,-50,0
27,1,10,49,100,-51,1,4.06888371144305,50,0
27,1,10,90,3,87,1,4.51826305425493,-47,0
27,1,10,69,21,48,1,5.13288596065831,-29,0
27,1,10,49,99,-50,1,4.71539026038954,49,0
27,1,10,70,45,25,1,4.45811333699385,-5,0
27,1,10,51,1,50,0,3.42001249230816,49,0
27,1,10,66,15,51,1,4.84662267472595,-35,0
27,1,10,7,51,-44,0,4.12125651925453,-1,0
27,1,10,51,0,51,0,3.91991608738317,50,0
27,1,10,20,86,-66,0,4.07051123210113,-36,0
27,1,10,51,1,50,0,3.47912448187708,49,0
27,1,10,49,99,-50,1,3.99240307087894,49,0
27,1,10,27,72,-45,0,3.78028617970995,-22,0
27,1,10,49,98,-49,1,3.76163127421751,48,0
27,1,10,26,85,-59,0,3.95888970833039,-35,0
27,1,10,51,0,51,0,4.58087201381568,50,0
27,1,10,16,76,-60,0,5.42545405626879,-26,0
27,1,10,81,21,60,1,4.07674126379425,-29,0
27,1,10,63,8,55,1,4.47736829912174,-42,0
27,1,1.5,68,40,28,1,0.774558333418099,-10,0
27,1,1.5,51,3,48,1,0.499167911737459,-47,0
27,1,1.5,26,78,-52,0,0.410538416093914,-28,0
27,1,1.5,49,97,-48,1,0.581848159636138,47,0
27,1,1.5,3,51,-48,0,0.546458383119898,-1,0
27,1,1.5,49,96,-47,1,0.576442885008873,46,0
27,1,1.5,49,100,-51,0,0.629069351445651,-50,0
27,1,1.5,40,95,-55,0,0.599688571732258,-45,0
27,1,1.5,46,76,-30,0,0.475068143248791,-26,0
27,1,1.5,35,73,-38,0,0.547742438240675,-23,0
27,1,1.5,50,61,-11,1,0.577004452934489,11,0
27,1,1.5,51,0,51,1,0.429686709627276,-50,0
27,1,1.5,59,4,55,1,0.456309135071933,-46,0
27,1,1.5,49,100,-51,0,0.545607966952957,-50,0
27,1,1.5,50,37,13,1,0.503555619419785,-13,0
27,1,1.5,84,40,44,1,0.510887160053244,-10,0
27,1,1.5,51,2,49,1,0.494227433548076,-48,0
27,1,1.5,51,3,48,1,0.494170616933843,-47,0
27,1,1.5,7,88,-81,0,0.518143922672607,-38,0
27,1,1.5,5,95,-90,0,0.532847691938514,-45,0
27,1,10,49,98,-49,1,3.7766851070046,48,0
27,1,10,38,66,-28,0,5.03730174672091,-16,0
27,1,10,17,61,-44,0,3.55922122404445,-11,0
27,1,10,51,0,51,0,3.52448795412784,50,0
27,1,10,65,23,42,1,3.5951267486671,-27,0
27,1,10,51,1,50,0,3.63113381003495,49,0
27,1,10,49,100,-51,1,4.03377141983947,50,0
27,1,10,20,70,-50,0,3.81168926379178,-20,0
27,1,10,100,17,83,1,3.50301604499691,-33,0
27,1,10,68,31,37,1,4.07829437303008,-19,0
27,1,10,100,39,61,1,4.25419636402512,-11,0
27,1,10,93,21,72,1,3.16748800253845,-29,0
27,1,10,49,97,-48,1,3.38001360665658,47,0
27,1,10,37,61,-24,0,3.36075058026472,-11,0
27,1,10,86,20,66,1,3.79799939590157,-30,0
27,1,10,65,32,33,1,4.55398529954255,-18,0
27,1,10,51,1,50,0,3.85527932507102,49,0
27,1,10,49,99,-50,0,4.24858435028,-49,0
27,1,10,21,68,-47,0,4.16912871928071,-18,0
27,1,10,51,4,47,0,3.94178021434345,46,0
27,1,1.5,23,68,-45,0,0.554405742353993,-18,0
27,1,1.5,49,98,-49,1,0.711720641207648,48,0
27,1,1.5,12,68,-56,0,0.455043041321915,-18,0
27,1,1.5,70,50,20,1,0.584316932538059,0,0
27,1,1.5,49,100,-51,0,0.612295258644735,-50,0
27,1,1.5,90,7,83,1,0.487611782096792,-43,0
27,1,1.5,51,0,51,1,0.559478181676241,-50,0
27,1,1.5,52,27,25,1,0.452893174544442,-23,0
27,1,1.5,71,4,67,1,0.518248391890666,-46,0
27,1,1.5,51,2,49,1,0.548886467964621,-48,0
27,1,1.5,69,11,58,1,0.458220005588373,-39,0
27,1,1.5,49,97,-48,0,0.611493228178006,-47,0
27,1,1.5,51,4,47,1,0.406789253669558,-46,0
27,1,1.5,76,50,26,1,0.474095296463929,0,0
27,1,1.5,49,96,-47,0,0.586734387179604,-46,0
27,1,1.5,53,35,18,1,0.470700596313691,-15,0
27,1,1.5,24,64,-40,0,0.487381949787959,-14,0
27,1,1.5,49,100,-51,0,0.575390495010652,-50,0
27,1,1.5,89,24,65,1,0.524020591808949,-26,0
27,1,1.5,2,99,-97,0,0.866649976029294,-49,0
27,1,10,96,38,58,1,3.54445147421211,-12,0
27,1,10,51,4,47,0,3.83041821417282,46,0
27,1,10,24,66,-42,0,3.20894615841098,-16,0
27,1,10,82,12,70,1,3.30829749611439,-38,0
27,1,10,51,3,48,0,3.46759841003222,47,0
27,1,10,30,80,-50,0,3.19622877074289,-30,0
27,1,10,41,99,-58,0,3.19209178921301,-49,0
27,1,10,51,2,49,0,3.41214577600476,48,0
27,1,10,49,100,-51,0,3.60671256959904,-50,0
27,1,10,56,46,10,1,3.57794540913892,-4,0
27,1,10,51,4,47,0,4.0213901665411,46,0
27,1,10,84,7,77,1,4.94397296849638,-43,0
27,1,10,88,20,68,1,3.92587706501945,-30,0
27,1,10,51,0,51,0,3.69986136749503,50,0
27,1,10,58,25,33,1,3.8430058399972,-25,0
27,1,10,49,100,-51,1,4.2930523196701,50,0
27,1,10,99,30,69,1,3.64504727875465,-20,0
27,1,10,100,6,94,1,3.76702005369589,-44,0
27,1,10,49,96,-47,0,3.77157784462906,-46,0
27,1,10,63,10,53,1,3.69555100370781,-40,0
27,1,1.5,88,43,45,1,0.817556768946815,-7,0
27,1,1.5,49,100,-51,0,0.516164872242371,-50,0
27,1,1.5,27,55,-28,0,0.490764553484041,-5,0
27,1,1.5,51,3,48,1,0.514716232253704,-47,0
27,1,1.5,49,97,-48,0,0.617987548728706,-47,0
27,1,1.5,69,41,28,1,0.48475372386747,-9,0
27,1,1.5,72,23,49,1,0.484684810828185,-27,0
27,1,1.5,69,12,57,1,0.484695807594107,-38,0
27,1,1.5,49,96,-47,0,0.524678564659553,-46,0
27,1,1.5,72,48,24,1,0.435335012647556,-2,0
27,1,1.5,36,61,-25,0,0.475966945203254,-11,0
27,1,1.5,51,4,47,0,0.956599083030596,46,0
27,1,1.5,49,100,-51,0,0.505241422884865,-50,0
27,1,1.5,11,62,-51,0,0.599877716012998,-12,0
27,1,1.5,74,5,69,1,0.571213192015421,-45,0
27,1,1.5,80,38,42,1,0.495843957440229,-12,0
27,1,1.5,51,3,48,0,0.79983292252291,47,0
27,1,1.5,37,70,-33,0,0.554475755081512,-20,0
27,1,1.5,51,0,51,1,0.487039950501639,-50,0
27,1,1.5,78,41,37,1,0.574463834607741,-9,0
28,1,10,48,100,-52,1,2.85220536377165,50,0
28,1,10,30,100,-70,0,2.90230074236752,-50,0
28,1,10,100,0,100,0,2.67844664151198,50,0
28,1,10,50,43,7,1,3.63188158979756,-7,0
28,1,10,28,85,-57,0,3.11462437262526,-35,0
28,1,10,53,0,53,0,3.10675619007088,50,0
28,1,10,48,80,-32,1,2.72287245662301,30,0
28,1,10,25,55,-30,0,2.79427222703816,-5,0
28,1,10,50,43,7,0,3.11897945657256,7,0
28,1,10,30,100,-70,0,2.91049919428769,-50,0
28,1,10,3,100,-97,0,3.23053536633961,-50,0
28,1,10,5,83,-78,0,3.13795766685507,-33,0
28,1,10,48,100,-52,1,3.60079301311634,50,0
28,1,10,98,38,60,0,3.38084202934988,12,0
28,1,10,100,0,100,0,2.96224262082251,50,0
28,1,10,80,45,35,1,3.69628448766889,-5,0
28,1,10,3,100,-97,0,3.24106293226941,-50,0
28,1,10,50,100,-50,1,3.2758350574004,50,0
28,1,10,25,55,-30,0,3.11728045699419,-5,0
28,1,10,53,40,13,0,3.69273253384745,10,0
28,1,1.5,48,80,-32,1,1.20363582248683,30,0
28,1,1.5,53,40,13,0,0.839593178476207,10,0
28,1,1.5,85,15,70,0,0.514425551169552,35,0
28,1,1.5,53,0,53,0,0.474333559628576,50,0
28,1,1.5,0,68,-68,0,0.603798061347334,-18,0
28,1,1.5,100,15,85,0,0.887839268427342,35,0
28,1,1.5,98,38,60,0,0.728601769165834,12,0
28,1,1.5,53,23,30,0,0.623934230563464,27,0
28,1,1.5,75,0,75,0,0.523320831242017,50,0
28,1,1.5,100,15,85,0,0.77063395595178,35,0
28,1,1.5,85,15,70,0,0.696081047586631,35,0
28,1,1.5,0,68,-68,0,0.672744087758474,-18,0
28,1,1.5,48,60,-12,1,1.41019165155012,10,0
28,1,1.5,80,45,35,1,1.26227568439208,-5,0
28,1,1.5,50,100,-50,1,0.888302598585142,50,0
28,1,1.5,75,0,75,0,0.561004532122752,50,0
28,1,1.5,28,85,-57,0,1.07904508526553,-35,0
28,1,1.5,5,83,-78,0,0.568438709160546,-33,0
28,1,1.5,53,23,30,0,0.44581602566177,27,0
28,1,1.5,48,60,-12,0,0.512497452436946,-10,0
28,1,10,62,45,17,0,1.91543893938069,5,0
28,1,10,96,37,59,0,1.11482011497719,13,0
28,1,10,94,16,78,0,2.58572305171401,34,0
28,1,10,35,87,-52,0,2.2224681423977,-37,0
28,1,10,87,22,65,0,2.86466286130599,28,0
28,1,10,66,26,40,0,3.22671765740961,24,0
28,1,10,68,35,33,0,3.60618692441494,15,0
28,1,10,10,98,-88,0,3.28226999539766,-48,0
28,1,10,54,41,13,0,4.11505984439282,9,0
28,1,10,43,59,-16,0,4.37119750329293,-9,0
28,1,10,93,15,78,0,4.37459586904151,35,0
28,1,10,49,98,-49,1,4.11609500614577,48,0
28,1,10,90,43,47,1,4.8275850819191,-7,0
28,1,10,25,50,-25,0,4.43903505621711,0,0
28,1,10,28,70,-42,0,3.47377712349407,-20,0
28,1,10,49,67,-18,1,4.1072770699684,17,0
28,1,10,4,68,-64,0,4.29127634273027,-18,0
28,1,10,72,39,33,0,4.02813997850171,11,0
28,1,10,33,52,-19,0,4.03958870648057,-2,0
28,1,10,78,38,40,0,3.83429163997062,12,0
28,1,1.5,33,64,-31,0,0.786480655253399,-14,0
28,1,1.5,91,22,69,0,0.495225939434022,28,0
28,1,1.5,100,7,93,0,0.527994088130072,43,0
28,1,1.5,76,7,69,0,0.511375049652997,43,0
28,1,1.5,83,18,65,0,0.831355871312553,32,0
28,1,1.5,17,99,-82,0,0.706743140588515,-49,0
28,1,1.5,98,30,68,0,0.72286365920445,20,0
28,1,1.5,68,27,41,0,0.626169138966361,23,0
28,1,1.5,95,36,59,0,0.597594055288937,14,0
28,1,1.5,35,71,-36,0,0.626255646842765,-21,0
28,1,1.5,85,38,47,0,0.724357019382296,12,0
28,1,1.5,81,35,46,0,0.619674085348379,15,0
28,1,1.5,61,8,53,0,0.743065075919731,42,0
28,1,1.5,40,56,-16,0,1.16579853347503,-6,0
28,1,1.5,17,69,-52,0,0.699247015116271,-19,0
28,1,1.5,36,86,-50,0,0.882680321199587,-36,0
28,1,1.5,79,38,41,0,0.906625035393517,12,0
28,1,1.5,94,44,50,0,0.626661793881794,6,0
28,1,1.5,16,57,-41,0,0.65403309877729,-7,0
28,1,1.5,99,32,67,0,0.744129195809364,18,0
28,1,10,12,84,-72,0,3.63012797298143,-34,0
28,1,10,22,97,-75,0,3.70554742609966,-47,0
28,1,10,29,93,-64,0,3.94579146621982,-43,0
28,1,10,100,35,65,0,5.83255561793339,15,0
28,1,10,60,6,54,0,4.81127651871066,44,0
28,1,10,52,28,24,0,4.47143811240676,22,0
28,1,10,47,76,-29,1,4.7929159598134,26,0
28,1,10,49,70,-21,1,5.1009872891882,20,0
28,1,10,74,50,24,1,5.01320161169861,0,0
28,1,10,30,52,-22,0,4.40131176699651,-2,0
28,1,10,76,40,36,0,4.01940158559592,10,0
28,1,10,24,91,-67,0,4.39890714190551,-41,0
28,1,10,58,43,15,0,3.93902076041559,7,0
28,1,10,24,57,-33,0,3.77785076369764,-7,0
28,1,10,3,70,-67,0,3.9351964534726,-20,0
28,1,10,46,81,-35,1,4.73398138469202,31,0
28,1,10,35,77,-42,1,3.72483904406545,27,0
28,1,10,85,28,57,0,3.93954787185066,22,0
28,1,10,34,74,-40,0,3.69029968374525,-24,0
28,1,10,69,36,33,0,3.41037603057339,14,0
28,1,1.5,14,61,-47,0,0.94938007593737,-11,0
28,1,1.5,29,82,-53,0,0.594752858800348,-32,0
28,1,1.5,88,14,74,0,0.599363434157567,36,0
28,1,1.5,94,20,74,0,0.490793878154363,30,0
28,1,1.5,98,4,94,0,0.515531458804617,46,0
28,1,1.5,29,79,-50,0,0.634228298615199,-29,0
28,1,1.5,84,47,37,1,0.924951870838413,-3,0
28,1,1.5,62,1,61,0,0.52359758305829,49,0
28,1,1.5,48,87,-39,1,1.0830812631466,37,0
28,1,1.5,20,71,-51,0,0.49106219917303,-21,0
28,1,1.5,93,9,84,0,0.674366843129974,41,0
28,1,1.5,28,85,-57,0,0.64323244660045,-35,0
28,1,1.5,91,21,70,0,0.613257108692778,29,0
28,1,1.5,84,43,41,NaN,NaN,0,0
28,1,1.5,97,25,72,0,0.735345349618001,25,0
28,1,1.5,85,40,45,0,0.917407726170495,10,0
28,1,1.5,83,25,58,0,0.628097237757174,25,0
28,1,1.5,66,44,22,0,0.879544411523966,6,0
28,1,1.5,88,24,64,0,0.544286156247836,26,0
28,1,1.5,81,26,55,0,0.590364784555277,24,0
28,1,10,22,52,-30,0,2.91370694950456,-2,0
28,1,10,83,31,52,0,2.72118445381057,19,0
28,1,10,88,35,53,0,2.11996146736783,15,0
28,1,10,89,10,79,0,2.16544223841629,40,0
28,1,10,32,71,-39,0,3.36102256682352,-21,0
28,1,10,98,49,49,1,3.32647734152852,-1,0
28,1,10,79,39,40,0,5.12529672926757,11,0
28,1,10,80,36,44,0,3.12407315633027,14,0
28,1,10,69,50,19,1,2.96285440729116,0,0
28,1,10,79,29,50,0,3.16828820016235,21,0
28,1,10,100,8,92,0,3.54835239192471,42,0
28,1,10,5,93,-88,0,2.97042311137193,-43,0
28,1,10,30,71,-41,0,3.57525340202847,-21,0
28,1,10,38,73,-35,0,3.45191263000015,-23,0
28,1,10,69,37,32,0,2.95739158292417,13,0
28,1,10,100,12,88,0,3.52281021495583,38,0
28,1,10,42,86,-44,0,3.06560411074315,-36,0
28,1,10,47,56,-9,0,2.91434146263055,-6,0
28,1,10,77,23,54,0,3.18582033636631,27,0
28,1,10,28,53,-25,0,2.9419162076083,-3,0
28,1,1.5,79,36,43,0,0.765409761312185,14,0
28,1,1.5,44,61,-17,0,0.570074660674436,-11,0
28,1,1.5,13,84,-71,0,0.470875444822013,-34,0
28,1,1.5,43,96,-53,0,1.07953810671461,-46,0
28,1,1.5,68,21,47,0,0.544374496879755,29,0
28,1,1.5,43,100,-57,1,0.790310827142093,50,0
28,1,1.5,80,32,48,0,0.530353626527358,18,0
28,1,1.5,18,66,-48,0,0.521122945239767,-16,0
28,1,1.5,100,20,80,0,0.599810635758331,30,0
28,1,1.5,69,35,34,0,0.635221306147287,15,0
28,1,1.5,4,96,-92,0,0.468599481828278,-46,0
28,1,1.5,48,95,-47,1,0.7973425227392,45,0
28,1,1.5,81,30,51,0,0.529302702692803,20,0
28,1,1.5,62,5,57,0,0.456096897600219,45,0
28,1,1.5,54,41,13,0,0.737428502732655,9,0
28,1,1.5,0,51,-51,0,0.503492204763461,-1,0
28,1,1.5,14,87,-73,0,0.51747495305608,-37,0
28,1,1.5,49,77,-28,1,0.908280414470937,27,0
28,1,1.5,73,20,53,0,0.45163404539926,30,0
28,1,1.5,58,2,56,0,0.485016179911327,48,0
28,1,10,99,10,89,0,3.52973670820938,40,0
28,1,10,47,96,-49,1,3.96855329541722,46,0
28,1,10,93,19,74,0,4.09330238599796,31,0
28,1,10,44,66,-22,0,3.70132723575807,-16,0
28,1,10,69,26,43,0,4.08485137511161,24,0
28,1,10,3,77,-74,0,4.33287452399964,-27,0
28,1,10,11,86,-75,0,4.04308017811854,-36,0
28,1,10,65,31,34,0,4.91720025395625,19,0
28,1,10,10,98,-88,0,4.42786198039539,-48,0
28,1,10,91,24,67,0,4.81474966238602,26,0
28,1,10,53,42,11,0,4.3855449775001,8,0
28,1,10,3,70,-67,0,4.02170357425348,-20,0
28,1,10,23,57,-34,0,3.76042273017811,-7,0
28,1,10,70,36,34,0,3.78987352258991,14,0
28,1,10,91,28,63,0,3.77000274186139,22,0
28,1,10,43,61,-18,0,3.09477191985934,-11,0
28,1,10,66,42,24,0,2.93489660843625,8,0
28,1,10,77,37,40,0,2.84497022809228,13,0
28,1,10,88,18,70,0,2.32707629847573,32,0
28,1,10,95,25,70,0,2.56573973744526,25,0
28,1,1.5,100,31,69,0,0.952520017774077,19,0
28,1,1.5,11,93,-82,0,0.494047453219537,-43,0
28,1,1.5,43,66,-23,0,0.606022339547053,-16,0
28,1,1.5,59,30,29,0,0.513408717350103,20,0
28,1,1.5,74,32,42,0,0.488814827724127,18,0
28,1,1.5,53,50,3,0,0.464880010695197,0,0
28,1,1.5,0,52,-52,0,0.586251262808219,-2,0
28,1,1.5,87,20,67,0,0.590294771856861,30,0
28,1,1.5,1,53,-52,0,0.546352447650861,-3,0
28,1,1.5,2,88,-86,0,0.544423982326407,-38,0
28,1,1.5,45,82,-37,0,1.30109938283567,-32,0
28,1,1.5,34,92,-58,0,0.876482913241489,-42,0
28,1,1.5,44,61,-17,0,0.917189990286715,-11,0
28,1,1.5,84,24,60,0,0.62717570917448,26,0
28,1,1.5,43,65,-22,0,0.805973880487727,-15,0
28,1,1.5,83,2,81,0,0.521410693851067,48,0
28,1,1.5,87,24,63,0,0.743364554364234,26,0
28,1,1.5,53,1,52,0,0.453379231359577,49,0
28,1,1.5,61,20,41,0,0.454078991926508,30,0
28,1,1.5,95,16,79,0,0.838813508133171,34,0
29,1,10,28,85,-57,0,2.30674735762295,-35,0
29,1,10,100,0,100,0,1.87448906840291,50,0
29,1,10,53,0,53,0,1.96379391555092,50,0
29,1,10,30,100,-70,1,2.16173424411681,50,0
29,1,10,25,55,-30,0,2.22226197304553,-5,0
29,1,10,98,38,60,1,3.07349937045365,-12,0
29,1,10,50,100,-50,0,2.77883879104047,-50,0
29,1,10,48,80,-32,1,3.48817439211416,30,0
29,1,10,0,68,-68,0,3.06476950118667,-18,0
29,1,10,25,55,-30,0,3.32196451383061,-5,0
29,1,10,75,0,75,0,2.97719699202571,50,0
29,1,10,53,0,53,0,3.6624730353069,50,0
29,1,10,0,68,-68,0,2.44849556742702,-18,0
29,1,10,75,0,75,1,2.6905214425351,-50,0
29,1,10,100,15,85,0,3.11503992698272,35,0
29,1,10,48,60,-12,1,2.23443195916479,10,0
29,1,10,80,45,35,1,2.01302882403252,-5,0
29,1,10,28,85,-57,0,1.75292703177547,-35,0
29,1,10,48,100,-52,1,2.15894366236171,50,0
29,1,10,50,100,-50,1,2.48489995801356,50,0
29,1,1.5,85,15,70,1,0.940884606738109,-35,0
29,1,1.5,48,60,-12,1,1.01162052046857,10,0
29,1,1.5,53,40,13,1,1.03138772150851,-10,0
29,1,1.5,48,100,-52,1,1.4507128574478,50,0
29,1,1.5,98,38,60,0,1.07669352903031,12,0
29,1,1.5,3,100,-97,0,0.765980048425263,-50,0
29,1,1.5,100,15,85,0,1.4033048581332,35,0
29,1,1.5,30,100,-70,0,0.93527925061062,-50,0
29,1,1.5,85,15,70,0,0.981892192561645,35,0
29,1,1.5,5,83,-78,0,0.994537600287003,-33,0
29,1,1.5,53,40,13,1,0.967195177625399,-10,0
29,1,1.5,80,45,35,1,1.35645622145967,-5,0
29,1,1.5,3,100,-97,0,0.794424334832001,-50,0
29,1,1.5,5,83,-78,0,0.855095020175213,-33,0
29,1,1.5,53,23,30,0,1.16912435553968,27,0
29,1,1.5,50,43,7,1,1.47036935892538,-7,0
29,1,1.5,53,23,30,0,1.16763650957728,27,0
29,1,1.5,100,0,100,0,0.867591973190429,50,0
29,1,1.5,48,80,-32,NaN,NaN,0,0
29,1,1.5,50,43,7,1,0.628250745503465,-7,0
29,1,10,28,60,-32,0,2.94142270917655,-10,0
29,1,10,14,99,-85,0,3.10800060848123,-49,0
29,1,10,48,100,-52,0,3.17194866033969,-50,0
29,1,10,91,14,77,0,2.59315862110816,36,0
29,1,10,5,76,-71,0,3.0537867860694,-26,0
29,1,10,49,54,-5,0,3.27968388312729,-4,0
29,1,10,98,38,60,1,2.86494544747984,-12,0
29,1,10,68,12,56,0,1.99430703732651,38,0
29,1,10,100,4,96,0,2.95891910319915,46,0
29,1,10,87,18,69,0,3.01279496206553,32,0
29,1,10,96,6,90,0,3.15154585326673,44,0
29,1,10,5,67,-62,0,3.19733551310492,-17,0
29,1,10,67,12,55,0,3.19337452185573,38,0
29,1,10,18,62,-44,0,3.69393663367373,-12,0
29,1,10,97,5,92,0,3.56658706319286,45,0
29,1,10,97,13,84,0,2.77986294514267,37,0
29,1,10,29,52,-23,0,2.40923424868379,-2,0
29,1,10,68,30,38,1,2.54908846985199,-20,0
29,1,10,79,33,46,1,3.1071065813012,-17,0
29,1,10,99,7,92,0,2.86699485540157,43,0
29,1,1.5,39,86,-47,1,1.12108111675479,36,0
29,1,1.5,9,85,-76,0,1.18423337812419,-35,0
29,1,1.5,57,31,26,0,1.30096678828704,19,0
29,1,1.5,26,64,-38,1,0.876944619056303,14,0
29,1,1.5,99,12,87,0,1.19822184261284,38,0
29,1,1.5,70,40,30,1,0.786943684332073,-10,0
29,1,1.5,79,9,70,0,0.799497819913086,41,0
29,1,1.5,9,76,-67,0,0.731441055220785,-26,0
29,1,1.5,87,18,69,0,1.01809094590135,32,0
29,1,1.5,100,0,100,0,0.709366391674848,50,0
29,1,1.5,15,81,-66,0,0.748021428793436,-31,0
29,1,1.5,15,79,-64,0,0.826732108922442,-29,0
29,1,1.5,45,83,-38,1,0.862031336757354,33,0
29,1,1.5,0,61,-61,0,0.559998973651091,-11,0
29,1,1.5,97,6,91,0,0.757963494805153,44,0
29,1,1.5,18,69,-51,0,0.827905450831167,-19,0
29,1,1.5,97,10,87,0,0.975226759939687,40,0
29,1,1.5,1,63,-62,0,0.660529195156414,-13,0
29,1,1.5,73,9,64,0,0.717887691251235,41,0
29,1,1.5,98,8,90,0,0.86111494974466,42,0
29,1,10,99,4,95,0,3.53044439270161,46,0
29,1,10,25,80,-55,0,4.24158271032502,-30,0
29,1,10,7,85,-78,0,4.74019951577066,-35,0
29,1,10,68,36,32,1,3.13085786651936,-14,0
29,1,10,29,62,-33,1,2.96084168314701,12,0
29,1,10,28,61,-33,0,2.68671733673546,-11,0
29,1,10,94,10,84,0,3.0153883373132,40,0
29,1,10,99,14,85,0,3.88260422527674,36,0
29,1,10,96,11,85,0,2.81859349255683,39,0
29,1,10,10,84,-74,0,2.86985068389913,-34,0
29,1,10,63,8,55,0,2.63781672625919,42,0
29,1,10,16,66,-50,0,2.39246876494144,-16,0
29,1,10,73,9,64,0,1.99643085585558,41,0
29,1,10,1,52,-51,0,2.62431248064968,-2,0
29,1,10,41,76,-35,1,3.0989217790484,26,0
29,1,10,28,64,-36,1,2.8829506195616,14,0
29,1,10,48,100,-52,1,2.90692440356361,50,0
29,1,10,99,4,95,0,1.97879113888484,46,0
29,1,10,88,27,61,1,2.00814741369686,-23,0
29,1,10,99,7,92,0,2.09210825827904,43,0
29,1,1.5,95,11,84,0,0.902787099475972,39,0
29,1,1.5,78,20,58,0,0.998106744431425,30,0
29,1,1.5,88,2,86,0,0.865988662437303,48,0
29,1,1.5,7,69,-62,0,0.986651540180901,-19,0
29,1,1.5,80,42,38,1,0.670656004804187,-8,0
29,1,1.5,12,91,-79,0,0.647201995510841,-41,0
29,1,1.5,70,45,25,1,0.737254614476115,-5,0
29,1,1.5,95,13,82,0,1.07926161200157,37,0
29,1,1.5,97,12,85,0,0.751870987354778,38,0
29,1,1.5,66,2,64,0,0.893071930884616,48,0
29,1,1.5,28,69,-41,0,1.08448025278631,-19,0
29,1,1.5,80,29,51,1,0.876460033614421,-21,0
29,1,1.5,29,54,-25,1,1.14904594948166,4,0
29,1,1.5,93,11,82,0,1.27438130130759,39,0
29,1,1.5,100,15,85,0,1.03503604151774,35,0
29,1,1.5,93,8,85,0,0.908975277707214,42,0
29,1,1.5,16,65,-49,1,1.29219806421315,15,0
29,1,1.5,80,24,56,1,1.11625102406833,-26,0
29,1,1.5,48,100,-52,0,1.21093139742152,-50,0
29,1,1.5,71,18,53,0,1.07815424993169,32,0
29,1,10,97,8,89,0,3.38609364375588,42,0
29,1,10,22,84,-62,0,3.75799538509455,-34,0
29,1,10,13,61,-48,0,3.17918921742239,-11,0
29,1,10,88,2,86,0,3.00788935908349,48,0
29,1,10,76,36,40,1,3.38718011221499,-14,0
29,1,10,92,10,82,0,3.67105408333009,40,0
29,1,10,27,80,-53,1,4.6237168290827,30,0
29,1,10,19,100,-81,0,2.77828419359867,-50,0
29,1,10,30,99,-69,0,2.65494803170441,-49,0
29,1,10,63,14,49,1,3.12824909598567,-36,0
29,1,10,34,74,-40,1,2.33351502232836,24,0
29,1,10,66,50,16,1,2.44197822295246,0,0
29,1,10,28,91,-63,1,3.71596657752525,41,0
29,1,10,89,12,77,0,2.33056572233909,38,0
29,1,10,97,4,93,0,2.28857576963492,46,0
29,1,10,73,42,31,1,3.8870388053183,-8,0
29,1,10,94,10,84,0,3.83103802823462,40,0
29,1,10,53,3,50,0,3.00963709241478,47,0
29,1,10,22,97,-75,0,2.43698941206094,-47,0
29,1,10,80,32,48,1,3.27891045249999,-18,0
29,1,1.5,14,86,-72,0,1.29087003614404,-36,0
29,1,1.5,99,19,80,0,0.849541348288767,31,0
29,1,1.5,18,97,-79,0,0.874804672086611,-47,0
29,1,1.5,98,5,93,0,0.835393432440469,45,0
29,1,1.5,71,3,68,0,0.917312566773035,47,0
29,1,1.5,91,10,81,0,0.923938044899842,40,0
29,1,1.5,91,48,43,1,1.04263288984657,-2,0
29,1,1.5,75,41,34,1,0.932611098192865,-9,0
29,1,1.5,14,98,-84,0,1.1146139902994,-48,0
29,1,1.5,92,9,83,0,0.977929368556943,41,0
29,1,1.5,100,10,90,0,0.997232144669397,40,0
29,1,1.5,54,17,37,0,1.04111205396475,33,0
29,1,1.5,7,70,-63,0,1.19507680239622,-20,0
29,1,1.5,82,38,44,1,1.03115239334875,-12,0
29,1,1.5,48,100,-52,1,1.26504441726138,50,0
29,1,1.5,14,53,-39,0,1.0344095993496,-3,0
29,1,1.5,94,7,87,0,1.02033646064228,43,0
29,1,1.5,67,38,29,0,1.34292888286291,12,0
29,1,1.5,68,22,46,0,1.06097126027453,28,0
29,1,1.5,41,63,-22,1,0.790321120352019,13,0
29,1,10,35,89,-54,1,4.26593807787867,39,0
29,1,10,12,68,-56,0,2.59460431325715,-18,0
29,1,10,95,11,84,0,3.47055263633956,39,0
29,1,10,53,10,43,0,3.55914893303998,40,0
29,1,10,33,80,-47,1,2.93238383420976,30,0
29,1,10,96,14,82,0,3.57827026452287,36,0
29,1,10,11,71,-60,0,2.35102387922234,-21,0
29,1,10,91,12,79,0,3.14826628740411,38,0
29,1,10,91,43,48,1,2.77751479504514,-7,0
29,1,10,8,92,-84,0,2.79818555372185,-42,0
29,1,10,40,66,-26,1,2.39348485486698,16,0
29,1,10,19,93,-74,0,3.34130834406824,-43,0
29,1,10,93,15,78,0,3.38668599634548,35,0
29,1,10,41,66,-25,1,2.81457311942359,16,0
29,1,10,41,94,-53,1,2.14591593798832,44,0
29,1,10,5,97,-92,0,2.15181380481226,-47,0
29,1,10,100,4,96,0,2.58850814026664,46,0
29,1,10,92,14,78,0,2.6884647035331,36,0
29,1,10,45,71,-26,1,2.663781635958,21,0
29,1,10,32,82,-50,1,2.99294088751776,32,0
29,1,1.5,10,85,-75,1,1.10036857085652,35,0
29,1,1.5,48,61,-13,1,0.867634860100225,11,0
29,1,1.5,76,3,73,0,1.17956933478126,47,0
29,1,1.5,38,58,-20,1,1.24816603466752,8,0
29,1,1.5,47,69,-22,1,1.27276442805305,19,0
29,1,1.5,94,8,86,0,1.17740922726807,42,0
29,1,1.5,27,58,-31,0,0.918151244171895,-8,0
29,1,1.5,30,62,-32,0,1.27669682801934,-12,0
29,1,1.5,3,69,-66,0,0.708708425809164,-19,0
29,1,1.5,73,9,64,0,0.835949496075045,41,0
29,1,1.5,15,51,-36,0,0.740598327422049,-1,0
29,1,1.5,37,99,-62,0,1.04258743705577,-49,0
29,1,1.5,75,0,75,0,1.07664880933589,50,0
29,1,1.5,87,38,49,1,1.04521490191109,-12,0
29,1,1.5,100,2,98,0,0.718599174142582,48,0
29,1,1.5,53,23,30,0,1.37313116612495,27,0
29,1,1.5,71,11,60,0,0.913768714905018,39,0
29,1,1.5,3,57,-54,0,0.68103757002973,-7,0
29,1,1.5,15,85,-70,0,0.88844820857048,-35,0
29,1,1.5,35,94,-59,0,0.967631377832731,-44,0
30,1,10,5,83,-78,0,2.97967212056392,-33,0
30,1,10,0,68,-68,0,0.960184393683448,-18,0
30,1,10,3,100,-97,0,1.6840436263592,-50,0
30,1,10,85,15,70,1,2.02061049616896,-35,0
30,1,10,48,100,-52,1,1.72657873170101,50,0
30,1,10,53,0,53,0,1.27787385688862,50,0
30,1,10,50,43,7,0,1.14319249172695,7,0
30,1,10,48,60,-12,0,1.30841406178661,-10,0
30,1,10,98,38,60,1,1.14693322326639,-12,0
30,1,10,28,85,-57,0,1.68157302067266,-35,0
30,1,10,25,55,-30,0,1.08136466873111,-5,0
30,1,10,30,100,-70,0,3.22481265183887,-50,0
30,1,10,48,80,-32,0,2.44400009384844,-30,0
30,1,10,100,15,85,0,2.17473486810923,35,0
30,1,10,100,0,100,0,2.13995834428351,50,0
30,1,10,25,55,-30,1,1.41712144383928,5,0
30,1,10,53,23,30,0,2.09899467611103,27,0
30,1,10,53,40,13,0,1.97105102642672,10,0
30,1,10,48,60,-12,1,1.24832079457701,10,0
30,1,10,80,45,35,1,1.72299562036642,-5,0
30,1,1.5,53,40,13,0,1.20428389823064,10,0
30,1,1.5,53,23,30,0,0.528083161916584,27,0
30,1,1.5,48,80,-32,1,0.775450170738623,30,0
30,1,1.5,48,100,-52,0,0.804825085535413,-50,0
30,1,1.5,53,0,53,0,0.536835850594798,50,0
30,1,1.5,98,38,60,1,0.679490600712597,-12,0
30,1,1.5,75,0,75,1,0.688723481289344,-50,0
30,1,1.5,50,43,7,0,0.993421370949363,7,0
30,1,1.5,30,100,-70,0,0.742031380359549,-50,0
30,1,1.5,80,45,35,0,0.98062004140229,5,0
30,1,1.5,28,85,-57,0,0.849927934556035,-35,0
30,1,1.5,50,100,-50,0,0.739874915510882,-50,0
30,1,1.5,100,15,85,0,1.05858744404395,35,0
30,1,1.5,3,100,-97,0,0.764588303252822,-50,0
30,1,1.5,50,100,-50,0,0.514499229495414,-50,0
30,1,1.5,100,0,100,1,1.18649077226291,-50,0
30,1,1.5,75,0,75,0,1.43915198842296,50,0
30,1,1.5,85,15,70,1,1.12179719333653,-35,0
30,1,1.5,0,68,-68,1,0.872930959390942,18,0
30,1,1.5,5,83,-78,NaN,NaN,0,0
30,1,10,14,59,-45,0,1.93466824237839,-9,0
30,1,10,60,35,25,1,0.573273251909995,-15,0
30,1,10,0,96,-96,0,1.20177700326894,-46,0
30,1,10,12,87,-75,0,1.10045028070454,-37,0
30,1,10,25,55,-30,0,1.38023830714519,-5,0
30,1,10,45,94,-49,0,1.87368130506366,-44,0
30,1,10,53,40,13,0,2.0910245902196,10,0
30,1,10,50,86,-36,0,3.8741640628723,-36,0
30,1,10,50,43,7,0,2.37148305249866,7,0
30,1,10,51,25,26,0,2.20870862834272,25,0
30,1,10,43,84,-41,0,2.15541429197765,-34,0
30,1,10,30,71,-41,0,1.36931302500307,-21,0
30,1,10,100,0,100,1,2.15064206422539,-50,0
30,1,10,0,68,-68,0,2.02059913286939,-18,0
30,1,10,24,80,-56,0,3.44650442290003,-30,0
30,1,10,7,66,-59,0,2.35258071991848,-16,0
30,1,10,18,97,-79,0,6.62910344137345,-47,0
30,1,10,50,43,7,0,2.28023852707702,7,0
30,1,10,53,40,13,0,1.73765870160423,10,0
30,1,10,22,68,-46,0,1.20825519526261,-18,0
30,1,1.5,48,100,-52,0,0.554826918290928,-50,0
30,1,1.5,48,80,-32,0,0.576800646318588,-30,0
30,1,1.5,44,61,-17,0,0.5340386411699,-11,0
30,1,1.5,56,17,39,0,0.436671485687839,33,0
30,1,1.5,53,23,30,0,0.503403497568797,27,0
30,1,1.5,17,84,-67,0,0.798693291551899,-34,0
30,1,1.5,39,73,-34,0,0.506677599885734,-23,0
30,1,1.5,50,99,-49,0,0.634652407054091,-49,0
30,1,1.5,18,81,-63,0,0.597338930441765,-31,0
30,1,1.5,34,50,-16,0,1.08996743493481,0,0
30,1,1.5,53,0,53,0,0.953210980922449,50,0
30,1,1.5,40,58,-18,0,0.951189043116756,-8,0
30,1,1.5,80,45,35,1,1.15715397958411,-5,0
30,1,1.5,50,43,7,1,1.37922880449332,-7,0
30,1,1.5,53,1,52,0,0.904441811726429,49,0
30,1,1.5,17,59,-42,0,0.831801973254187,-9,0
30,1,1.5,76,12,64,0,0.563060193351703,38,0
30,1,1.5,24,100,-76,0,0.705162172904238,-50,0
30,1,1.5,52,42,10,0,0.6650056669896,8,0
30,1,1.5,27,84,-57,0,0.731027288071346,-34,0
30,1,10,89,20,69,1,1.22440907070995,-30,0
30,1,10,62,30,32,0,2.35411623431719,20,0
30,1,10,39,57,-18,0,1.28022679718561,-7,0
30,1,10,47,59,-12,0,1.5455152275681,-9,0
30,1,10,13,82,-69,0,2.63863470079377,-32,0
30,1,10,15,80,-65,0,1.1453713166411,-30,0
30,1,10,100,0,100,1,3.84577555759461,-50,0
30,1,10,78,44,34,1,0.960543621215038,-6,0
30,1,10,56,17,39,0,6.45295915511088,33,0
30,1,10,48,100,-52,0,1.04703827897902,-50,0
30,1,10,71,16,55,0,1.43080654644291,34,0
30,1,10,29,58,-29,0,2.88229653425515,-8,0
30,1,10,70,42,28,1,6.29016237083124,-8,0
30,1,10,53,1,52,0,2.31484716699924,49,0
30,1,10,100,15,85,1,1.69749009926454,-35,0
30,1,10,65,6,59,0,5.20199107358349,44,0
30,1,10,1,70,-69,0,0.829329168249387,-20,0
30,1,10,61,12,49,0,9.65445720721618,38,0
30,1,10,4,86,-82,0,3.07184880480054,-36,0
30,1,10,80,45,35,0,5.88032701433985,5,0
30,1,1.5,48,80,-32,0,0.767090799519792,-30,0
30,1,1.5,56,48,8,1,0.532343307131669,-2,0
30,1,1.5,11,79,-68,0,0.634228298615199,-29,0
30,1,1.5,99,46,53,1,1.0683426707983,-4,0
30,1,1.5,47,87,-40,0,0.748920484620612,-37,0
30,1,1.5,71,16,55,0,0.730188968358561,34,0
30,1,1.5,25,55,-30,0,0.61684241934563,-5,0
30,1,1.5,12,68,-56,0,0.971587301813997,-18,0
30,1,1.5,38,66,-28,0,0.680146374215838,-16,0
30,1,1.5,77,10,67,0,0.392577039630851,40,0
30,1,1.5,24,66,-42,0,0.46811965649249,-16,0
30,1,1.5,65,6,59,0,1.22877625111141,44,0
30,1,1.5,83,42,41,1,0.78339349781163,-8,0
30,1,1.5,80,18,62,1,0.620027081342414,-32,0
30,1,1.5,11,97,-86,0,0.486686587915756,-47,0
30,1,1.5,21,62,-41,0,0.550704232562566,-12,0
30,1,1.5,29,69,-40,0,0.611971220729174,-19,0
30,1,1.5,100,0,100,1,0.567337566841161,-50,0
30,1,1.5,94,43,51,0,0.875953235925408,7,0
30,1,1.5,71,16,55,0,1.05257038294803,34,0
30,1,10,96,24,72,0,2.02856078790501,26,0
30,1,10,31,55,-24,0,4.94313758119824,-5,0
30,1,10,56,17,39,0,2.8371302705782,33,0
30,1,10,37,76,-39,0,1.67099083750509,-26,0
30,1,10,80,35,45,1,2.09427046752535,-15,0
30,1,10,48,80,-32,1,1.06217642029515,30,0
30,1,10,4,57,-53,0,5.41417394531891,-7,0
30,1,10,95,29,66,0,1.48072524371673,21,0
30,1,10,100,15,85,NaN,NaN,0,0
30,1,10,55,36,19,1,2.61925034344313,-14,0
30,1,10,100,15,85,0,4.10118743026396,35,0
30,1,10,79,11,68,1,5.78048082237365,-39,0
30,1,10,13,69,-56,1,6.7530442700081,19,0
30,1,10,43,94,-51,1,3.71027639991371,44,0
30,1,10,51,25,26,0,4.79760497875395,25,0
30,1,10,45,77,-32,1,2.30551164995995,27,0
30,1,10,9,89,-80,1,5.5208337304357,39,0
30,1,10,96,24,72,0,5.51122072845465,26,0
30,1,10,94,33,61,1,3.70270476336009,-17,0
30,1,10,33,62,-29,0,1.55000153955189,-12,0
30,1,1.5,9,51,-42,1,0.858536565705435,1,0
30,1,1.5,76,12,64,0,0.723878293705638,38,0
30,1,1.5,14,86,-72,0,0.746459409507224,-36,0
30,1,1.5,6,100,-94,0,0.640500484587392,-50,0
30,1,1.5,76,11,65,0,0.682391912851017,39,0
30,1,1.5,95,29,66,1,1.21831283290521,-21,0
30,1,1.5,88,19,69,0,1.16506834852044,31,0
30,1,1.5,74,6,68,0,0.650330489326734,44,0
30,1,1.5,71,16,55,0,0.475603318976937,34,0
30,1,1.5,87,30,57,0,0.620205228886334,20,0
30,1,1.5,20,59,-39,0,0.502287326293299,-9,0
30,1,1.5,76,11,65,0,0.461572918080492,39,0
30,1,1.5,84,31,53,0,0.374885450408328,19,0
30,1,1.5,100,15,85,1,0.531617520930013,-35,0
30,1,1.5,50,43,7,0,0.673546118225204,7,0
30,1,1.5,30,54,-24,0,0.650215023342753,-4,0
30,1,1.5,26,96,-70,0,0.53953518893104,-46,0
30,1,1.5,63,19,44,0,0.657418634975329,31,0
30,1,1.5,96,39,57,0,0.562826328881783,11,0
30,1,1.5,7,97,-90,0,0.440115671255626,-47,0
30,1,10,77,10,67,0,1.07945783034666,40,0
30,1,10,25,86,-61,1,3.59124085988151,36,0
30,1,10,60,26,34,1,2.41125723769073,-24,0
30,1,10,100,3,97,1,5.23052583579556,-47,0
30,1,10,5,70,-65,1,5.20915729619446,20,0
30,1,10,61,12,49,1,2.42043880009442,-38,0
30,1,10,59,26,33,0,2.43901013021241,24,0
30,1,10,65,6,59,0,3.336953955848,44,0
30,1,10,10,98,-88,1,4.11897322506411,48,0
30,1,10,29,73,-44,1,2.36559721943922,23,0
30,1,10,38,68,-30,0,2.7767840778688,-18,0
30,1,10,82,16,66,1,4.95751364697935,-34,0
30,1,10,12,52,-40,1,2.77067611020175,2,0
30,1,10,0,99,-99,NaN,NaN,0,0
30,1,10,45,77,-32,1,1.41868664947106,27,0
30,1,10,56,28,28,1,1.95731203968171,-22,0
30,1,10,71,16,55,0,3.99446789606009,34,0
30,1,10,13,69,-56,1,1.91848357598064,19,0
30,1,10,69,40,29,0,4.0430581845867,10,0
30,1,10,65,25,40,0,5.77302648458863,25,0
30,1,1.5,2,100,-98,NaN,NaN,0,0
30,1,1.5,20,93,-73,0,0.69226810397231,-43,0
30,1,1.5,81,50,31,0,1.06808498001192,0,0
30,1,1.5,0,68,-68,NaN,NaN,0,0
30,1,1.5,52,37,15,0,0.731523608585121,13,0
30,1,1.5,85,50,35,NaN,NaN,0,0
30,1,1.5,59,26,33,0,1.3054779265658,24,0
30,1,1.5,76,12,64,NaN,NaN,0,0
30,1,1.5,35,52,-17,0,0.744060649332823,-2,0
30,1,1.5,74,4,70,0,1.342029327614,46,0
30,1,1.5,17,99,-82,0,1.31456455023726,-49,0
30,1,1.5,2,100,-98,NaN,NaN,0,0
30,1,1.5,18,77,-59,1,1.28123520020745,27,0
30,1,1.5,48,100,-52,0,0.777239710325375,-50,0
30,1,1.5,75,24,51,0,0.637879223329946,26,0
30,1,1.5,9,51,-42,NaN,NaN,0,0
30,1,1.5,52,36,16,0,0.679129906930029,14,0
30,1,1.5,59,28,31,NaN,NaN,0,0
30,1,1.5,87,30,57,0,0.495089579606429,20,0
30,1,1.5,36,72,-36,0,0.911063328152522,-22,0
31,1,10,80,45,35,0,1.21619082457619,5,0
31,1,10,25,55,-30,0,4.28190197047661,-5,0
31,1,10,53,23,30,0,3.89062804702553,27,0
31,1,10,5,83,-78,0,3.45125905584428,-33,0
31,1,10,75,0,75,0,3.59717361244839,50,0
31,1,10,3,100,-97,0,3.59382619839744,-50,0
31,1,10,98,38,60,0,3.69442200291087,12,0
31,1,10,50,43,7,0,3.83100910679786,7,0
31,1,10,53,0,53,0,3.24229163702694,50,0
31,1,10,25,55,-30,0,4.70883912325371,-5,0
31,1,10,50,100,-50,0,4.10083846637281,-50,0
31,1,10,28,85,-57,0,4.13280238528387,-35,0
31,1,10,85,15,70,0,3.91546093291254,35,0
31,1,10,80,45,35,0,3.47466419555712,5,0
31,1,10,53,23,30,0,3.69204083757359,27,0
31,1,10,5,83,-78,0,4.02860000968212,-33,0
31,1,10,50,100,-50,0,3.29599395324476,-50,0
31,1,10,30,100,-70,0,3.32853923426592,-50,0
31,1,10,85,15,70,0,2.68777262803633,35,0
31,1,10,48,80,-32,0,3.44044557408779,-30,0
31,1,1.5,75,0,75,0,1.21853166847723,50,0
31,1,1.5,28,85,-57,NaN,NaN,0,0
31,1,1.5,48,60,-12,0,0.645028584258398,-10,0
31,1,1.5,48,100,-52,0,0.463656437728787,-50,0
31,1,1.5,50,43,7,0,0.321621538401814,7,0
31,1,1.5,98,38,60,0,0.352867735375185,12,0
31,1,1.5,48,60,-12,0,0.270945897384081,-10,0
31,1,1.5,53,40,13,0,0.376282405602979,10,0
31,1,1.5,0,68,-68,0,0.397571401961613,-18,0
31,1,1.5,30,100,-70,0,0.498232453945093,-50,0
31,1,1.5,53,0,53,0,0.410875650093658,50,0
31,1,1.5,48,100,-52,0,0.318858052341966,-50,0
31,1,1.5,0,68,-68,0,0.334114592144033,-18,0
31,1,1.5,53,40,13,0,0.268778435769491,10,0
31,1,1.5,100,15,85,0,0.302078094595345,35,0
31,1,1.5,3,100,-97,0,0.718065039254725,-50,0
31,1,1.5,100,15,85,0,0.789461510605179,35,0
31,1,1.5,100,0,100,0,0.666022134304512,50,0
31,1,1.5,48,80,-32,0,0.627334062563023,-30,0
31,1,1.5,100,0,100,0,0.582604736817302,50,0
31,1,10,31,68,-37,0,3.3825872153102,-18,0
31,1,10,71,13,58,0,2.93119949736865,37,0
31,1,10,68,28,40,0,2.81046312491526,22,0
31,1,10,10,78,-68,0,2.53441912907874,-28,0
31,1,10,94,32,62,0,3.08497160638217,18,0
31,1,10,57,45,12,0,2.10166249034228,5,0
31,1,10,64,24,40,0,2.32566944614518,26,0
31,1,10,98,26,72,0,3.10891705361428,24,0
31,1,10,12,96,-84,0,3.27691603900166,-46,0
31,1,10,99,32,67,0,2.85411953332368,18,0
31,1,10,28,50,-22,0,2.96613400799106,0,0
31,1,10,25,92,-67,0,1.81940752381342,-42,0
31,1,10,82,22,60,0,2.19075311682536,28,0
31,1,10,3,96,-93,0,4.83391005234444,-46,0
31,1,10,100,50,50,0,4.48458693965222,0,0
31,1,10,73,49,24,0,3.57323036453454,1,0
31,1,10,89,30,59,0,3.93782614558586,20,0
31,1,10,64,45,19,0,3.44832805244369,5,0
31,1,10,90,1,89,0,2.7390142356744,49,0
31,1,10,95,48,47,0,2.7616686631809,2,0
31,1,1.5,69,41,28,0,0.329687296092743,9,0
31,1,1.5,84,34,50,0,0.280955149326473,16,0
31,1,1.5,51,11,40,0,0.274272051057778,39,0
31,1,1.5,80,46,34,0,0.283591072977288,4,0
31,1,1.5,6,85,-79,0,0.284258942934684,-35,0
31,1,1.5,62,2,60,0,0.196917901106644,48,0
31,1,1.5,63,21,42,0,0.409479794558138,29,0
31,1,1.5,11,87,-76,0,0.253564050246496,-37,0
31,1,1.5,33,78,-45,0,0.143514330266044,-28,0
31,1,1.5,85,48,37,0,0.350133940548403,2,0
31,1,1.5,88,24,64,0,0.418110785773024,26,0
31,1,1.5,6,71,-65,0,0.26135562203126,-21,0
31,1,1.5,55,21,34,0,0.319471305032494,29,0
31,1,1.5,68,31,37,0,0.270009339903481,19,0
31,1,1.5,59,45,14,0,0.607435789919691,5,0
31,1,1.5,66,23,43,0,0.403390154795488,27,0
31,1,1.5,87,42,45,0,0.367291820322862,8,0
31,1,1.5,48,57,-9,0,0.284023245680146,-7,0
31,1,1.5,28,57,-29,0,0.396621281804983,-7,0
31,1,1.5,58,5,53,0,0.377275779697811,45,0
31,1,10,97,4,93,0,4.89322328264825,46,0
31,1,10,82,49,33,0,3.09378404414747,1,0
31,1,10,44,99,-55,0,2.80566743740928,-49,0
31,1,10,64,38,26,0,1.70574316845159,12,0
31,1,10,66,3,63,0,1.27371231591678,47,0
31,1,10,11,63,-52,0,4.07949631902738,-13,0
31,1,10,54,28,26,0,1.8875727802515,22,0
31,1,10,46,81,-35,0,2.56813996387064,-31,0
31,1,10,100,46,54,0,2.81271709437715,4,0
31,1,10,42,65,-23,0,3.49668154405663,-15,0
31,1,10,54,43,11,0,3.25464356562588,7,0
31,1,10,27,94,-67,0,3.24067914529587,-44,0
31,1,10,23,61,-38,0,3.38658893667161,-11,0
31,1,10,59,48,11,0,2.35927224901388,2,0
31,1,10,39,88,-49,0,3.68453041629982,-38,0
31,1,10,18,84,-66,0,4.86915283885901,-34,0
31,1,10,82,42,40,0,2.70174291331205,8,0
31,1,10,66,45,21,0,4.57374024772434,5,0
31,1,10,91,15,76,0,2.30639212398091,35,0
31,1,10,80,43,37,0,3.03426187540754,7,0
31,1,1.5,67,39,28,0,1.03542386650224,11,0
31,1,1.5,75,3,72,0,1.01350145670585,47,0
31,1,1.5,94,26,68,0,0.328793259424856,24,0
31,1,1.5,48,75,-27,0,0.255403808376286,-25,0
31,1,1.5,65,38,27,0,0.288715563627193,12,0
31,1,1.5,33,93,-60,0,0.28075647453079,-43,0
31,1,1.5,94,45,49,0,0.321429828181863,5,0
31,1,1.5,19,60,-41,0,0.368087619281141,-10,0
31,1,1.5,61,3,58,0,0.356698640360264,47,0
31,1,1.5,39,88,-49,0,0.0899802644562442,-38,0
31,1,1.5,74,42,32,0,0.344568846339826,8,0
31,1,1.5,11,96,-85,0,0.398610229342012,-46,0
31,1,1.5,7,55,-48,0,0.673967294162139,-5,0
31,1,1.5,66,28,38,0,0.514558611990651,22,0
31,1,1.5,70,45,25,0,0.681919052090961,5,0
31,1,1.5,98,16,82,0,0.69859307439765,34,0
31,1,1.5,23,98,-75,0,0.778578382713022,-48,0
31,1,1.5,38,58,-20,0,0.351156639342662,-8,0
31,1,1.5,25,78,-53,0,0.316460391855799,-28,0
31,1,1.5,41,81,-40,0,0.275181483186316,-31,0
31,1,10,91,20,71,0,1.0807965027343,30,0
31,1,10,73,8,65,0,3.7438766368723,42,0
31,1,10,63,1,62,0,2.0619165301614,49,0
31,1,10,93,39,54,0,2.59922377529438,11,0
31,1,10,20,82,-62,0,2.68249454925535,-32,0
31,1,10,31,59,-28,0,2.25850856059697,-9,0
31,1,10,66,9,57,0,2.17172688737628,41,0
31,1,10,88,48,40,0,1.9763782240625,2,0
31,1,10,54,49,5,0,2.00506804062752,1,0
31,1,10,23,77,-54,0,1.84835209872108,-27,0
31,1,10,95,33,62,0,5.59090472551179,17,0
31,1,10,74,10,64,0,3.36283190056565,40,0
31,1,10,21,90,-69,0,2.9441236241255,-40,0
31,1,10,89,29,60,0,3.17405196922482,21,0
31,1,10,88,27,61,0,3.37872735215933,23,0
31,1,10,59,42,17,0,1.81461843437864,8,0
31,1,10,29,76,-47,0,5.50450903861201,-26,0
31,1,10,0,50,-50,0,2.90386521490291,0,0
31,1,10,25,77,-52,0,2.703127405548,-27,0
31,1,10,13,78,-65,0,2.80638076065225,-28,0
31,1,1.5,55,13,42,0,0.316315967735136,37,0
31,1,1.5,89,29,60,0,0.25095195294125,21,0
31,1,1.5,79,37,42,0,0.284300364088267,13,0
31,1,1.5,47,87,-40,0,0.276369133411208,-37,0
31,1,1.5,60,48,12,0,0.332955166930333,2,0
31,1,1.5,92,31,61,0,0.274950551218353,19,0
31,1,1.5,94,47,47,0,0.187537663907278,3,0
31,1,1.5,33,89,-56,0,0.263542511267588,-39,0
31,1,1.5,33,88,-55,0,0.344862093275879,-38,0
31,1,1.5,50,53,-3,0,0.270837029471295,-3,0
31,1,1.5,100,1,99,0,0.261553930322407,49,0
31,1,1.5,98,45,53,0,0.814730967918877,5,0
31,1,1.5,32,67,-35,0,0.38615089902305,-17,0
31,1,1.5,94,4,90,0,0.390117797331186,46,0
31,1,1.5,78,5,73,0,0.946129799907794,45,0
31,1,1.5,90,11,79,0,0.360015996615402,39,0
31,1,1.5,39,74,-35,0,0.35736027880921,-24,0
31,1,1.5,13,81,-68,0,0.186719504883513,-31,0
31,1,1.5,5,89,-84,0,0.27069810370449,-39,0
31,1,1.5,86,15,71,0,0.319351440353785,35,0
31,1,10,16,89,-73,0,3.74788312349119,-39,0
31,1,10,71,1,70,0,2.45792126026936,49,0
31,1,10,91,44,47,0,2.51517443062039,6,0
31,1,10,26,90,-64,0,2.31442929009791,-40,0
31,1,10,97,34,63,0,2.16975516811362,16,0
31,1,10,82,20,62,0,3.6849153029325,30,0
31,1,10,92,17,75,0,3.45289244141895,33,0
31,1,10,77,35,42,0,2.80620774492854,15,0
31,1,10,77,36,41,0,2.64155763990129,14,0
31,1,10,20,63,-43,0,1.78748649230693,-13,0
31,1,10,79,42,37,0,2.10210089455359,8,0
31,1,10,84,35,49,0,2.36531863483833,15,0
31,1,10,35,69,-34,0,2.72203926870134,-19,0
31,1,10,4,81,-77,0,3.28069709203555,-31,0
31,1,10,72,32,40,0,2.61727055991651,18,0
31,1,10,84,37,47,0,2.21993998700054,13,0
31,1,10,93,22,71,0,2.38259894520161,28,0
31,1,10,17,77,-60,0,2.5384586059663,-27,0
31,1,10,57,27,30,0,2.42449037343613,23,0
31,1,10,32,65,-33,0,2.50711490443791,-15,0
31,1,1.5,79,43,36,0,0.326475508773001,7,0
31,1,1.5,100,39,61,0,0.309069468727103,11,0
31,1,1.5,87,37,50,0,0.243659267551266,13,0
31,1,1.5,92,29,63,0,0.253522995684762,21,0
31,1,1.5,82,21,61,0,0.3590145582275,29,0
31,1,1.5,25,92,-67,0,0.316318167111604,-42,0
31,1,1.5,3,84,-81,0,0.410322146432009,-34,0
31,1,1.5,49,73,-24,0,0.373542745888699,-23,0
31,1,1.5,33,64,-31,0,0.337536051054485,-14,0
31,1,1.5,28,56,-28,0,0.295586339954752,-6,0
31,1,1.5,62,20,42,0,0.309568355121883,30,0
31,1,1.5,83,35,48,0,0.276848958746996,15,0
31,1,1.5,100,30,70,0,0.221543681342155,20,0
31,1,1.5,90,34,56,0,0.207383885193849,16,0
31,1,1.5,67,22,45,0,0.874846961727599,28,0
31,1,1.5,3,53,-50,0,0.315428529138444,-3,0
31,1,1.5,93,24,69,0,0.234118844178738,26,0
31,1,1.5,92,11,81,0,0.132090528262779,39,0
31,1,1.5,45,63,-18,0,0.250136359827593,-13,0
31,1,1.5,40,87,-47,0,0.170691725594224,-37,0
32,1,10,28,85,-57,0,2.59465966300922,-35,0
32,1,10,100,15,85,1,3.1822954028612,-35,0
32,1,10,53,0,53,1,3.45895557539188,-50,0
32,1,10,100,0,100,1,4.73280427255668,-50,0
32,1,10,48,100,-52,0,4.45150791481137,-50,0
32,1,10,30,100,-70,0,4.43735120166093,-50,0
32,1,10,48,60,-12,0,3.9840629301325,-10,0
32,1,10,25,55,-30,0,4.24454777216306,-5,0
32,1,10,50,43,7,1,4.0392206311808,-7,0
32,1,10,25,55,-30,0,3.76975739569752,-5,0
32,1,10,3,100,-97,0,4.22303283782094,-50,0
32,1,10,98,38,60,1,3.49838990799617,-12,0
32,1,10,30,100,-70,1,3.58634693315253,50,0
32,1,10,53,23,30,1,3.63090533539071,-27,0
32,1,10,75,0,75,1,3.61820824345341,-50,0
32,1,10,100,15,85,1,3.66156507906271,-35,0
32,1,10,0,68,-68,0,3.15152129408671,-18,0
32,1,10,53,40,13,1,3.08533579169307,-10,0
32,1,10,48,80,-32,0,3.08602344850078,-30,0
32,1,10,50,100,-50,0,2.95063203212339,-50,0
32,1,1.5,3,100,-97,0,1.06464377287193,-50,0
32,1,1.5,48,100,-52,0,0.802559652191121,-50,0
32,1,1.5,80,45,35,1,0.710552196484059,-5,0
32,1,1.5,53,40,13,1,0.982495908334386,-10,0
32,1,1.5,98,38,60,1,0.763174071384128,-12,0
32,1,1.5,50,100,-50,0,0.777125513850478,-50,0
32,1,1.5,48,80,-32,0,0.84634755627485,-30,0
32,1,1.5,0,68,-68,0,0.816979551746044,-18,0
32,1,1.5,85,15,70,1,0.748373321432155,-35,0
32,1,1.5,5,83,-78,0,0.682339939259691,-33,0
32,1,1.5,28,85,-57,0,0.802972392935771,-35,0
32,1,1.5,50,43,7,1,1.24694687337615,-7,0
32,1,1.5,75,0,75,1,0.777562080620555,-50,0
32,1,1.5,48,60,-12,0,0.734834253089502,-10,0
32,1,1.5,80,45,35,1,0.965436814207351,-5,0
32,1,1.5,53,0,53,0,0.722804290882777,50,0
32,1,1.5,53,23,30,1,1.35407031621435,-27,0
32,1,1.5,85,15,70,NaN,NaN,0,0
32,1,1.5,5,83,-78,0,0.911444757453864,-33,0
32,1,1.5,100,0,100,1,0.607298106217058,-50,0
32,1,10,49,97,-48,0,2.01248595639481,-47,0
32,1,10,49,99,-50,0,3.44692634631065,-49,0
32,1,10,89,15,74,1,3.07360017302562,-35,0
32,1,10,35,61,-26,0,2.8748482921219,-11,0
32,1,10,51,4,47,1,3.10818791796919,-46,0
32,1,10,19,62,-43,0,3.26003581241821,-12,0
32,1,10,29,94,-65,0,3.07798343538889,-44,0
32,1,10,32,89,-57,0,2.91127834154759,-39,0
32,1,10,56,21,35,1,2.91126221313607,-29,0
32,1,10,49,96,-47,0,2.87921029434074,-46,0
32,1,10,51,4,47,1,2.93583714702982,-46,0
32,1,10,42,90,-48,0,2.72643721557688,-40,0
32,1,10,77,14,63,1,2.86163839002256,-36,0
32,1,10,100,21,79,1,3.67969561289647,-29,0
32,1,10,49,98,-49,0,2.52096088675898,-48,0
32,1,10,54,7,47,1,2.71231349231675,-43,0
32,1,10,13,53,-40,0,2.58417436279706,-3,0
32,1,10,49,97,-48,0,2.96480414061807,-47,0
32,1,10,49,96,-47,0,2.66603228246095,-46,0
32,1,10,52,2,50,1,2.57936479718774,-48,0
32,1,1.5,51,4,47,1,0.809446117375046,-46,0
32,1,1.5,49,100,-51,0,0.821417430794099,-50,0
32,1,1.5,40,58,-18,0,0.864621413027635,-8,0
32,1,1.5,61,8,53,1,0.609917873400263,-42,0
32,1,1.5,8,76,-68,0,0.621925109182484,-26,0
32,1,1.5,51,2,49,1,0.681244306935696,-48,0
32,1,1.5,48,70,-22,0,0.817802467296133,-20,0
32,1,1.5,49,97,-48,0,0.957085596048273,-47,0
32,1,1.5,10,62,-52,0,0.707115745171905,-12,0
32,1,1.5,11,72,-61,0,0.611090115649858,-22,0
32,1,1.5,98,18,80,1,0.558515159791568,-32,0
32,1,1.5,7,62,-55,0,0.571771247807192,-12,0
32,1,1.5,50,26,24,0,0.793028494139435,24,0
32,1,1.5,51,1,50,1,0.901692566840211,-49,0
32,1,1.5,51,0,51,1,0.717582717654295,-50,0
32,1,1.5,1,60,-59,0,0.724322560883593,-10,0
32,1,1.5,49,99,-50,0,1.01962754366104,-49,0
32,1,1.5,49,97,-48,0,0.894932196504669,-47,0
32,1,1.5,12,81,-69,0,0.791511690360494,-31,0
32,1,1.5,45,66,-21,0,0.748155954381218,-16,0
32,1,10,51,0,51,1,2.48271565791219,-50,0
32,1,10,86,32,54,1,2.93129919853527,-18,0
32,1,10,46,68,-22,0,2.92198064224795,-18,0
32,1,10,48,72,-24,0,2.72126805971493,-22,0
32,1,10,49,99,-50,0,2.82452141688555,-49,0
32,1,10,93,2,91,1,2.4910426834831,-48,0
32,1,10,49,100,-51,0,2.58776403401862,-50,0
32,1,10,62,5,57,1,2.56043040865916,-45,0
32,1,10,26,59,-33,0,2.5663282754831,-9,0
32,1,10,51,4,47,1,2.56297319935402,-46,0
32,1,10,57,34,23,1,2.49628405066323,-16,0
32,1,10,51,3,48,1,2.32889643177623,-47,0
32,1,10,43,63,-20,0,2.00624939289992,-13,0
32,1,10,49,98,-49,0,1.84936540198396,-48,0
32,1,10,48,74,-26,0,2.2274245309527,-24,0
32,1,10,10,90,-80,0,2.31806913588662,-40,0
32,1,10,51,0,51,1,2.26929975204985,-50,0
32,1,10,49,96,-47,0,2.11799509183038,-46,0
32,1,10,53,19,34,1,2.44534136334551,-31,0
32,1,10,26,62,-36,0,2.23923529338208,-12,0
32,1,1.5,49,99,-50,0,0.85791272696224,-49,0
32,1,1.5,51,1,50,1,0.803202955896268,-49,0
32,1,1.5,10,59,-49,0,0.758331515826285,-9,0
32,1,1.5,49,98,-49,0,0.907765646843472,-48,0
32,1,1.5,17,62,-45,0,0.931077066314174,-12,0
32,1,1.5,63,13,50,0,1.16106674779439,37,0
32,1,1.5,11,67,-56,0,1.09426799922949,-17,0
32,1,1.5,30,89,-59,0,0.846342791046482,-39,0
32,1,1.5,51,0,51,1,0.616194757894846,-50,0
32,1,1.5,80,21,59,1,0.610847456380725,-29,0
32,1,1.5,49,97,-48,0,0.782255081809126,-47,0
32,1,1.5,51,2,49,1,0.642218682914972,-48,0
32,1,1.5,32,65,-33,0,1.14813029556535,-15,0
32,1,1.5,75,1,74,1,0.698179505532607,-49,0
32,1,1.5,97,41,56,1,0.7373436873022,-9,0
32,1,1.5,51,1,50,1,0.703381651372183,-49,0
32,1,1.5,51,0,51,1,0.726651283592219,-50,0
32,1,1.5,51,12,39,1,0.709374089346966,-38,0
32,1,1.5,47,54,-7,0,0.852625540428562,-4,0
32,1,1.5,5,69,-64,0,0.653988391219173,-19,0
32,1,10,30,81,-51,0,2.29922308708774,-31,0
32,1,10,63,31,32,1,2.57849276327761,-19,0
32,1,10,11,95,-84,0,2.00714561939822,-45,0
32,1,10,79,45,34,1,1.73843235505046,-5,0
32,1,10,49,96,-47,0,2.51238350430503,-46,0
32,1,10,45,89,-44,0,2.08771473239176,-39,0
32,1,10,49,97,-48,0,1.81564126015292,-47,0
32,1,10,15,82,-67,0,2.67284616976394,-32,0
32,1,10,51,1,50,1,2.42547812493285,-49,0
32,1,10,51,4,47,1,3.06011572133866,-46,0
32,1,10,0,58,-58,0,2.86867440951755,-8,0
32,1,10,51,4,47,1,4.32533461871208,-46,0
32,1,10,49,100,-51,0,2.71589693211718,-50,0
32,1,10,94,36,58,1,2.93058808220667,-14,0
32,1,10,5,71,-66,0,3.22513832862023,-21,0
32,1,10,24,75,-51,0,2.81976463514729,-25,0
32,1,10,6,53,-47,0,3.11041473844671,-3,0
32,1,10,40,69,-29,0,2.7816396363196,-19,0
32,1,10,49,99,-50,0,3.08959112645243,-49,0
32,1,10,51,0,51,1,2.16959977714578,-50,0
32,1,1.5,66,25,41,1,0.923594949621474,-25,0
32,1,1.5,25,59,-34,0,0.76221003223327,-9,0
32,1,1.5,77,9,68,1,0.59939628423308,-41,0
32,1,1.5,49,98,-49,0,0.650771506218007,-48,0
32,1,1.5,49,96,-47,0,0.772045430814615,-46,0
32,1,1.5,94,11,83,1,0.640716541354777,-39,0
32,1,1.5,51,0,51,1,0.994658196810633,-50,0
32,1,1.5,72,7,65,1,0.71868054929655,-43,0
32,1,1.5,36,62,-26,0,0.965218714089133,-12,0
32,1,1.5,51,4,47,1,0.681807335116901,-46,0
32,1,1.5,49,96,-47,0,0.769160277908668,-46,0
32,1,1.5,51,4,47,1,1.14192488926346,-46,0
32,1,1.5,17,56,-39,0,0.747871874424163,-6,0
32,1,1.5,43,63,-20,0,0.937874458642909,-13,0
32,1,1.5,97,27,70,1,0.583767853531754,-23,0
32,1,1.5,9,94,-85,0,0.731754459586227,-44,0
32,1,1.5,2,79,-77,0,0.497659730841406,-29,0
32,1,1.5,51,1,50,1,0.609762454172596,-49,0
32,1,1.5,49,97,-48,0,0.597078558203066,-47,0
32,1,1.5,81,46,35,1,0.713030106970109,-4,0
32,1,10,34,65,-31,0,2.35026291143731,-15,0
32,1,10,89,0,89,1,2.70748046721565,-50,0
32,1,10,18,97,-79,0,2.61081483302405,-47,0
32,1,10,2,61,-59,0,2.77416155170067,-11,0
32,1,10,49,100,-51,0,3.01067517561023,-50,0
32,1,10,51,2,49,1,3.16607571920031,-48,0
32,1,10,49,97,-48,0,3.29860727500636,-47,0
32,1,10,81,24,57,1,3.10588961935719,-26,0
32,1,10,51,1,50,1,2.57713431119919,-49,0
32,1,10,72,22,50,1,2.96584662245004,-28,0
32,1,10,100,33,67,1,2.67382670388906,-17,0
32,1,10,49,100,-51,0,2.57037907265476,-50,0
32,1,10,77,29,48,1,2.87096867605578,-21,0
32,1,10,51,1,50,1,3.04766018901137,-49,0
32,1,10,7,72,-65,0,3.16153997005313,-22,0
32,1,10,49,97,-48,0,3.48684306506766,-47,0
32,1,10,13,86,-73,0,3.08677231997717,-36,0
32,1,10,83,19,64,1,4.28679614604334,-31,0
32,1,10,49,98,-49,0,2.87059662293177,-48,0
32,1,10,89,49,40,1,2.51933558273595,-1,0
32,1,1.5,51,0,51,1,0.712516197148943,-50,0
32,1,1.5,78,6,72,1,0.55911814243882,-44,0
32,1,1.5,51,3,48,1,0.700474138633581,-47,0
32,1,1.5,51,1,50,1,0.515743712196127,-49,0
32,1,1.5,54,47,7,1,0.914391491533024,-3,0
32,1,1.5,92,48,44,1,0.697626740904525,-2,0
32,1,1.5,41,93,-52,0,0.66563676984515,-43,0
32,1,1.5,49,99,-50,0,0.634313561982708,-49,0
32,1,1.5,57,40,17,0,0.788198401452973,10,0
32,1,1.5,62,41,21,1,0.904194303380791,-9,0
32,1,1.5,50,86,-36,0,0.854913942079293,-36,0
32,1,1.5,49,100,-51,1,1.45618662040215,50,0
32,1,1.5,15,96,-81,1,0.977438551664818,46,0
32,1,1.5,49,97,-48,0,1.07807470753323,-47,0
32,1,1.5,51,4,47,NaN,NaN,0,0
32,1,1.5,90,35,55,NaN,NaN,0,0
32,1,1.5,94,7,87,1,0.614633967546979,-43,0
32,1,1.5,16,80,-64,0,0.561933649907587,-30,0
32,1,1.5,29,67,-38,0,1.04725917807082,-17,0
32,1,1.5,51,3,48,1,0.640614639094565,-47,0
33,1,10,50,100,-50,0,3.58032547481707,-50,0
33,1,10,28,85,-57,0,3.08902941120323,-35,0
33,1,10,100,15,85,0,3.12969506715308,35,0
33,1,10,85,15,70,0,4.50584514506045,35,0
33,1,10,75,0,75,0,1.85801275330596,50,0
33,1,10,50,43,7,1,1.78628967815894,-7,0
33,1,10,48,100,-52,0,3.56703405623557,-50,0
33,1,10,53,0,53,0,3.44436628598487,50,0
33,1,10,0,68,-68,0,1.8232017729606,-18,0
33,1,10,48,80,-32,0,3.9865447296761,-30,0
33,1,10,98,38,60,0,3.69526435481384,12,0
33,1,10,5,83,-78,0,4.05610364227323,-33,0
33,1,10,50,100,-50,0,2.48225672598346,-50,0
33,1,10,85,15,70,0,3.21102637905278,35,0
33,1,10,25,55,-30,0,2.52719059147057,-5,0
33,1,10,48,60,-12,1,2.49451664835215,10,0
33,1,10,100,15,85,1,1.91927864178433,-35,0
33,1,10,48,80,-32,1,2.21465494361473,30,0
33,1,10,25,55,-30,0,4.56953838531626,-5,0
33,1,10,75,0,75,0,3.23904282724834,50,0
33,1,1.5,30,100,-70,0,0.739333508303389,-50,0
33,1,1.5,48,100,-52,0,0.690035761479521,-50,0
33,1,1.5,80,45,35,1,0.978668116295012,-5,0
33,1,1.5,100,0,100,0,0.712024151813239,50,0
33,1,1.5,80,45,35,0,1.13605852623004,5,0
33,1,1.5,53,40,13,0,1.43886570609175,10,0
33,1,1.5,48,60,-12,0,1.3214833457605,-10,0
33,1,1.5,53,23,30,0,0.880975090141874,27,0
33,1,1.5,3,100,-97,0,0.746298123674933,-50,0
33,1,1.5,53,0,53,0,1.04102561660693,50,0
33,1,1.5,98,38,60,0,1.08374656719388,12,0
33,1,1.5,53,40,13,NaN,NaN,0,0
33,1,1.5,3,100,-97,0,0.835912562557496,-50,0
33,1,1.5,28,85,-57,0,0.598644979094388,-35,0
33,1,1.5,30,100,-70,0,0.635336405568523,-50,0
33,1,1.5,53,23,30,0,0.782071687164716,27,0
33,1,1.5,100,0,100,0,0.62673987087328,50,0
33,1,1.5,5,83,-78,0,1.16608041711152,-33,0
33,1,1.5,50,43,7,1,0.811500486073783,-7,0
33,1,1.5,0,68,-68,0,0.575492764881346,-18,0
33,1,10,37,68,-31,0,0.869105186226079,-18,0
33,1,10,98,38,60,1,3.71733192182728,-12,0
33,1,10,95,7,88,0,2.66882777458522,43,0
33,1,10,88,2,86,0,2.5181472217082,48,0
33,1,10,10,81,-71,0,3.27756778037292,-31,0
33,1,10,11,89,-78,0,2.45500455267029,-39,0
33,1,10,99,6,93,0,2.94506971215014,44,0
33,1,10,47,68,-21,1,2.73583287268411,18,0
33,1,10,29,93,-64,0,2.25452883276739,-43,0
33,1,10,99,18,81,1,2.40870965473005,-32,0
33,1,10,75,0,75,0,2.41949271209887,50,0
33,1,10,99,42,57,1,2.64563890447607,-8,0
33,1,10,68,44,24,1,3.40836508953362,-6,0
33,1,10,98,3,95,0,3.9805852182908,47,0
33,1,10,70,41,29,0,4.34603361491463,9,0
33,1,10,52,41,11,1,3.72080836456735,-9,0
33,1,10,90,18,72,0,3.38425395774539,32,0
33,1,10,34,83,-49,0,3.7009016610973,-33,0
33,1,10,40,99,-59,0,3.56506123728468,-49,0
33,1,10,96,8,88,0,3.5785091764119,42,0
33,1,1.5,20,58,-38,0,0.760679321247153,-8,0
33,1,1.5,95,9,86,0,0.606633759452961,41,0
33,1,1.5,96,12,84,0,0.618882685084827,38,0
33,1,1.5,38,70,-32,0,0.734093551640399,-20,0
33,1,1.5,75,0,75,0,0.65218527635443,50,0
33,1,1.5,84,10,74,0,0.726284751610365,40,0
33,1,1.5,98,6,92,0,0.661662651633378,44,0
33,1,1.5,19,92,-73,0,0.791721711575519,-42,0
33,1,1.5,59,0,59,0,0.924380039272364,50,0
33,1,1.5,100,26,74,0,0.835849881026661,24,0
33,1,1.5,30,61,-31,0,0.86918986128876,-11,0
33,1,1.5,88,41,47,0,1.34258466406027,9,0
33,1,1.5,25,64,-39,0,0.797290471382439,-14,0
33,1,1.5,4,96,-92,0,0.698046168778092,-46,0
33,1,1.5,88,13,75,0,0.714730454725213,37,0
33,1,1.5,82,1,81,0,0.914784632099327,49,0
33,1,1.5,50,96,-46,0,0.738811162154889,-46,0
33,1,1.5,91,12,79,0,0.84164040882024,38,0
33,1,1.5,27,61,-34,0,0.811547772143967,-11,0
33,1,1.5,75,0,75,0,0.69561441836413,50,0
33,1,10,73,50,23,1,4.26443911387469,0,0
33,1,10,76,0,76,0,3.626537897042,50,0
33,1,10,90,11,79,0,3.66197825866402,39,0
33,1,10,69,46,23,1,3.85607292465284,-4,0
33,1,10,88,13,75,0,4.33018801530125,37,0
33,1,10,21,97,-76,0,4.36161419254495,-47,0
33,1,10,9,63,-54,0,4.62372675832012,-13,0
33,1,10,27,63,-36,0,4.05852806154871,-13,0
33,1,10,19,71,-52,0,4.62063666849281,-21,0
33,1,10,96,7,89,1,4.21550462671439,-43,0
33,1,10,92,1,91,0,4.45752610996715,49,0
33,1,10,5,78,-73,0,4.26692328217905,-28,0
33,1,10,17,62,-45,0,4.21245815732982,-12,0
33,1,10,100,7,93,0,4.27995187815395,43,0
33,1,10,31,74,-43,0,4.36123627054621,-24,0
33,1,10,84,10,74,1,3.87879883110872,-40,0
33,1,10,52,14,38,0,4.41559765930288,36,0
33,1,10,80,48,32,0,4.22636539451196,2,0
33,1,10,0,75,-75,0,4.39779097063001,-25,0
33,1,10,92,11,81,0,4.15390003795619,39,0
33,1,1.5,22,53,-31,0,0.796197026764276,-3,0
33,1,1.5,20,71,-51,0,0.720809464226477,-21,0
33,1,1.5,92,1,91,0,0.615559830446728,49,0
33,1,1.5,23,59,-36,0,0.571616406581597,-9,0
33,1,1.5,7,60,-53,0,0.616311275778571,-10,0
33,1,1.5,71,36,35,0,0.659055686148349,14,0
33,1,1.5,93,8,85,0,0.636363869620254,42,0
33,1,1.5,16,56,-40,0,0.718466421007179,-6,0
33,1,1.5,80,4,76,0,0.525184049125528,46,0
33,1,1.5,96,9,87,0,0.619898785807891,41,0
33,1,1.5,40,89,-49,0,0.942622199654579,-39,0
33,1,1.5,82,27,55,1,1.2447175225243,-23,0
33,1,1.5,99,5,94,0,0.654787110019242,45,0
33,1,1.5,42,89,-47,0,1.41606172261527,-39,0
33,1,1.5,24,67,-43,0,1.39484273898415,-17,0
33,1,1.5,1,64,-63,0,0.750836120423628,-14,0
33,1,1.5,73,27,46,NaN,NaN,0,0
33,1,1.5,100,1,99,0,0.667715635470813,49,0
33,1,1.5,100,6,94,0,0.516454453609185,44,0
33,1,1.5,81,22,59,0,0.467132880468853,28,0
33,1,10,14,79,-65,0,0.660612460924312,-29,0
33,1,10,2,81,-79,0,4.34066682890989,-31,0
33,1,10,100,15,85,0,3.65888926849584,35,0
33,1,10,71,26,45,1,3.84439949618536,-24,0
33,1,10,63,46,17,1,3.54243100265739,-4,0
33,1,10,98,3,95,0,3.62042113195639,47,0
33,1,10,30,96,-66,0,4.46328181473655,-46,0
33,1,10,71,5,66,0,4.04073420242639,45,0
33,1,10,94,11,83,0,4.22689837086364,39,0
33,1,10,52,34,18,0,4.20561927161179,16,0
33,1,10,97,4,93,0,4.92835170280887,46,0
33,1,10,83,37,46,0,4.40723645527032,13,0
33,1,10,99,7,92,0,4.13870068136021,43,0
33,1,10,62,42,20,1,3.99282461337862,-8,0
33,1,10,98,11,87,0,4.98889730346855,39,0
33,1,10,50,77,-27,1,2.69707552134059,27,0
33,1,10,95,22,73,0,4.43308397565852,28,0
33,1,10,10,59,-49,0,3.17923840830917,-9,0
33,1,10,36,87,-51,1,4.34402597288135,37,0
33,1,10,19,65,-46,0,5.75814273502328,-15,0
33,1,1.5,90,45,45,0,0.746917974407552,5,0
33,1,1.5,90,29,61,0,0.75305709958775,21,0
33,1,1.5,5,67,-62,0,0.622361693735002,-17,0
33,1,1.5,84,23,61,1,0.785142349428497,-27,0
33,1,1.5,9,85,-76,0,0.485062732856022,-35,0
33,1,1.5,88,2,86,0,0.645252918155165,48,0
33,1,1.5,18,57,-39,0,0.455314661317971,-7,0
33,1,1.5,95,9,86,0,0.488589760701871,41,0
33,1,1.5,78,11,67,0,0.632718076754827,39,0
33,1,1.5,96,8,88,0,0.554686159768607,42,0
33,1,1.5,67,18,49,0,0.454823472653516,32,0
33,1,1.5,90,11,79,0,0.584130720701069,39,0
33,1,1.5,83,10,73,0,0.692236213362776,40,0
33,1,1.5,10,93,-83,0,0.516250646993285,-43,0
33,1,1.5,26,98,-72,0,0.482887206948362,-48,0
33,1,1.5,64,50,14,0,0.427105036680587,0,0
33,1,1.5,3,60,-57,0,1.14969524310436,-10,0
33,1,1.5,40,70,-30,0,0.435047997219954,-20,0
33,1,1.5,80,48,32,1,0.82116004099953,-2,0
33,1,1.5,48,60,-12,0,0.799892671609996,-10,0
33,1,10,96,5,91,0,0.837366700929124,45,0
33,1,10,30,95,-65,0,1.72615169078927,-45,0
33,1,10,97,8,89,0,4.41971191417542,42,0
33,1,10,85,43,42,1,4.25457685199217,-7,0
33,1,10,28,55,-27,0,4.45610166285769,-5,0
33,1,10,95,8,87,0,4.13749030450708,42,0
33,1,10,54,26,28,0,4.47165731451241,24,0
33,1,10,80,4,76,0,3.65637724168482,46,0
33,1,10,41,92,-51,1,3.70573840319412,42,0
33,1,10,56,6,50,0,4.60918904017308,44,0
33,1,10,93,4,89,0,4.22806622687494,46,0
33,1,10,98,11,87,0,4.59876704314956,39,0
33,1,10,14,97,-83,0,4.16229056668817,-47,0
33,1,10,98,35,63,1,4.05574001604691,-15,0
33,1,10,54,26,28,0,3.81717591447523,24,0
33,1,10,16,61,-45,0,3.73198180695181,-11,0
33,1,10,26,59,-33,0,3.56211740436265,-9,0
33,1,10,95,13,82,0,3.97544863118674,37,0
33,1,10,11,70,-59,0,4.30756804431439,-20,0
33,1,10,12,58,-46,0,4.3710391499626,-8,0
33,1,1.5,38,100,-62,0,0.638449588645017,-50,0
33,1,1.5,82,4,78,0,0.760628003044985,46,0
33,1,1.5,32,63,-31,0,0.605924834962934,-13,0
33,1,1.5,61,13,48,0,0.761434432177339,37,0
33,1,1.5,72,17,55,0,0.60671990076662,33,0
33,1,1.5,87,14,73,0,0.746162496943725,36,0
33,1,1.5,100,10,90,0,0.69549711959553,40,0
33,1,1.5,22,78,-56,0,0.693496808729833,-28,0
33,1,1.5,88,21,67,0,1.1095709943329,29,0
33,1,1.5,97,12,85,0,0.62100102781551,38,0
33,1,1.5,81,22,59,0,0.814399965398479,28,0
33,1,1.5,19,81,-62,0,0.689181313151494,-31,0
33,1,1.5,90,15,75,0,0.697134903864935,35,0
33,1,1.5,90,48,42,0,0.984509962348966,2,0
33,1,1.5,92,11,81,0,0.836553673725575,39,0
33,1,1.5,73,35,38,1,1.27069663748262,-15,0
33,1,1.5,18,69,-51,NaN,NaN,0,0
33,1,1.5,25,76,-51,0,0.726707027235534,-26,0
33,1,1.5,99,44,55,0,0.685494099161588,6,0
33,1,1.5,12,63,-51,0,1.0135667041468,-13,0
34,1,10,80,45,35,1,3.47972387825939,-5,0
34,1,10,5,83,-78,0,3.26099026683551,-33,0
34,1,10,48,80,-32,0,2.54029340139414,-30,0
34,1,10,25,55,-30,0,2.22428571104638,-5,0
34,1,10,75,0,75,1,3.6648608604678,-50,0
34,1,10,48,100,-52,NaN,NaN,0,0
34,1,10,85,15,70,1,1.95472278326088,-35,0
34,1,10,100,0,100,1,0.74203490966238,-50,0
34,1,10,75,0,75,1,1.22400131396307,-50,0
34,1,10,50,43,7,1,2.69514468040006,-7,0
34,1,10,50,100,-50,1,2.23711559334106,50,0
34,1,10,25,55,-30,0,4.45967214405346,-5,0
34,1,10,85,15,70,1,4.19492168147235,-35,0
34,1,10,50,100,-50,1,3.50890556482682,50,0
34,1,10,48,80,-32,0,4.97013945230583,-30,0
34,1,10,53,0,53,1,1.54078495319118,-50,0
34,1,10,48,100,-52,0,4.29531397885285,-50,0
34,1,10,100,15,85,1,3.46133642308587,-35,0
34,1,10,100,0,100,1,2.70854707291255,-50,0
34,1,10,48,60,-12,0,1.26587893836313,-10,0
34,1,1.5,3,100,-97,1,0.658444396040068,50,0
34,1,1.5,3,100,-97,0,0.609733747958671,-50,0
34,1,1.5,100,15,85,1,0.762376993695398,-35,0
34,1,1.5,53,0,53,1,0.549745051721402,-50,0
34,1,1.5,30,100,-70,0,0.68099859594895,-50,0
34,1,1.5,50,43,7,1,0.687713803638871,-7,0
34,1,1.5,98,38,60,1,0.949637284213622,-12,0
34,1,1.5,48,60,-12,0,1.01692159799268,-10,0
34,1,1.5,0,68,-68,0,0.817564904035862,-18,0
34,1,1.5,80,45,35,1,0.882269711699337,-5,0
34,1,1.5,53,40,13,1,0.648889743434665,-10,0
34,1,1.5,53,23,30,1,0.616902221006058,-27,0
34,1,1.5,0,68,-68,0,0.72945501866252,-18,0
34,1,1.5,28,85,-57,1,0.766178547527034,35,0
34,1,1.5,28,85,-57,0,0.952819042084684,-35,0
34,1,1.5,53,23,30,1,1.06812692625272,-27,0
34,1,1.5,98,38,60,1,0.55471985081158,-12,0
34,1,1.5,53,40,13,1,0.51801956645113,-10,0
34,1,1.5,30,100,-70,0,0.786655739311755,-50,0
34,1,1.5,5,83,-78,0,0.788650954924833,-33,0
34,1,10,49,96,-47,0,2.5378879458267,-46,0
34,1,10,85,6,79,1,1.74985575167921,-44,0
34,1,10,51,0,51,0,3.21573364000005,50,0
34,1,10,37,65,-28,0,3.48904413688524,-15,0
34,1,10,49,100,-51,0,3.80699594007501,-50,0
34,1,10,20,51,-31,0,3.12028859950851,-1,0
34,1,10,93,33,60,1,2.55689064682065,-17,0
34,1,10,81,38,43,1,2.24017890308642,-12,0
34,1,10,51,4,47,1,3.52813499947752,-46,0
34,1,10,80,21,59,1,4.74077578928745,-29,0
34,1,10,51,2,49,1,2.12803659782912,-48,0
34,1,10,98,19,79,1,1.83669028722898,-31,0
34,1,10,51,4,47,1,4.38061158182109,-46,0
34,1,10,90,38,52,1,4.40808254351896,-12,0
34,1,10,49,96,-47,0,2.3692373071317,-46,0
34,1,10,51,0,51,1,3.38782547047504,-50,0
34,1,10,19,80,-61,0,0.829849502246816,-30,0
34,1,10,10,73,-63,0,3.54911461249958,-23,0
34,1,10,73,35,38,1,2.32834082629961,-15,0
34,1,10,0,57,-57,0,4.05295228524528,-7,0
34,1,1.5,23,99,-76,1,0.572900239116279,49,0
34,1,1.5,49,97,-48,0,1.12756044138996,-47,0
34,1,1.5,24,76,-52,0,1.18016151449137,-26,0
34,1,1.5,1,95,-94,0,0.646803571406963,-45,0
34,1,1.5,34,74,-40,0,0.606782970951826,-24,0
34,1,1.5,35,89,-54,0,0.488112717708191,-39,0
34,1,1.5,51,0,51,1,0.470125440871925,-50,0
34,1,1.5,49,98,-49,0,0.740804431156448,-48,0
34,1,1.5,42,65,-23,0,0.944069713340468,-15,0
34,1,1.5,49,96,-47,0,1.44399318540536,-46,0
34,1,1.5,51,3,48,1,0.803378447919386,-47,0
34,1,1.5,49,99,-50,1,0.949492664950867,49,0
34,1,1.5,49,96,-47,0,1.21658803189621,-46,0
34,1,1.5,79,23,56,1,0.993232540243753,-27,0
34,1,1.5,90,47,43,1,0.619209224435963,-3,0
34,1,1.5,46,57,-11,NaN,NaN,0,0
34,1,1.5,49,100,-51,NaN,NaN,0,0
34,1,1.5,48,62,-14,0,0.704436966646881,-12,0
34,1,1.5,33,82,-49,0,0.557753254419822,-32,0
34,1,1.5,57,1,56,1,0.513070742359105,-49,0
34,1,10,85,32,53,0,1.73820240051464,18,0
34,1,10,70,17,53,1,0.918114554982822,-33,0
34,1,10,29,59,-30,0,3.85729849102609,-9,0
34,1,10,49,99,-50,0,1.96864541992727,-49,0
34,1,10,49,100,-51,0,1.49861005175353,-50,0
34,1,10,49,98,-49,0,1.62454319806375,-48,0
34,1,10,65,17,48,1,1.07318361883154,-33,0
34,1,10,28,89,-61,1,1.43045065433262,39,0
34,1,10,51,0,51,1,1.03038740471857,-50,0
34,1,10,22,87,-65,0,1.73368762939299,-37,0
34,1,10,51,2,49,1,1.16092543134164,-48,0
34,1,10,36,69,-33,0,3.90752323109655,-19,0
34,1,10,24,63,-39,0,9.10475336822674,-13,0
34,1,10,95,14,81,1,1.1254360970338,-36,0
34,1,10,51,3,48,1,2.5040123562917,-47,0
34,1,10,44,75,-31,0,4.37261883810424,-25,0
34,1,10,28,59,-31,0,3.3665974707169,-9,0
34,1,10,49,100,-51,0,3.16051520452038,-50,0
34,1,10,49,99,-50,0,2.80317904137382,-49,0
34,1,10,94,20,74,1,1.69173492460413,-30,0
34,1,1.5,92,46,46,1,0.665219244086984,-4,0
34,1,1.5,51,3,48,1,0.519723685992631,-47,0
34,1,1.5,51,2,49,1,0.355673313846637,-48,0
34,1,1.5,16,51,-35,0,0.526370916194537,-1,0
34,1,1.5,49,96,-47,0,0.578337164532968,-46,0
34,1,1.5,86,46,40,1,0.356334682118813,-4,0
34,1,1.5,55,38,17,1,0.526908287510196,-12,0
34,1,1.5,49,60,-11,0,0.618940538778133,-10,0
34,1,1.5,25,77,-52,0,0.522882034759277,-27,0
34,1,1.5,51,0,51,1,0.542864843275765,-50,0
34,1,1.5,51,0,51,1,0.569506725902102,-50,0
34,1,1.5,15,84,-69,0,0.436187473168957,-34,0
34,1,1.5,51,3,48,1,0.355442699539253,-47,0
34,1,1.5,59,30,29,0,0.574926290662461,20,0
34,1,1.5,22,100,-78,0,0.552809928669376,-50,0
34,1,1.5,63,21,42,1,0.427471134478765,-29,0
34,1,1.5,68,5,63,1,0.451383007878121,-45,0
34,1,1.5,51,4,47,1,0.650923883438281,-46,0
34,1,1.5,49,99,-50,0,0.56933046288259,-49,0
34,1,1.5,3,75,-72,0,0.507350583150128,-25,0
34,1,10,0,87,-87,0,1.83028973618275,-37,0
34,1,10,18,91,-73,0,1.97427273945277,-41,0
34,1,10,49,98,-49,0,1.6722220915608,-48,0
34,1,10,13,66,-53,0,3.30081215650216,-16,0
34,1,10,51,1,50,1,2.52936337962501,-49,0
34,1,10,78,30,48,1,2.93332851847708,-20,0
34,1,10,51,3,48,1,1.95264414431222,-47,0
34,1,10,49,97,-48,0,3.82728120790352,-47,0
34,1,10,70,8,62,1,3.7392637451685,-42,0
34,1,10,40,51,-11,0,4.37457226631614,-1,0
34,1,10,52,44,8,1,2.94384742884677,-6,0
34,1,10,64,27,37,1,1.80310457998621,-23,0
34,1,10,51,4,47,1,5.69025183842132,-46,0
34,1,10,51,3,48,1,3.43152765992363,-47,0
34,1,10,51,2,49,1,2.63152267960459,-48,0
34,1,10,38,70,-32,0,2.31955847014706,-20,0
34,1,10,83,5,78,1,9.38594068924112,-45,0
34,1,10,21,52,-31,0,6.72319722255861,-2,0
34,1,10,49,100,-51,0,7.55119373211573,-50,0
34,1,10,13,81,-68,0,4.33774143747769,-31,0
34,1,1.5,12,63,-51,0,0.585794218247884,-13,0
34,1,1.5,28,75,-47,0,0.467069095693205,-25,0
34,1,1.5,49,98,-49,0,0.385064885620977,-48,0
34,1,1.5,51,1,50,1,0.490387097640905,-49,0
34,1,1.5,38,89,-51,0,0.695695298226383,-39,0
34,1,1.5,21,72,-51,0,0.428929610910018,-22,0
34,1,1.5,84,19,65,1,0.500967740910255,-31,0
34,1,1.5,51,4,47,1,0.489563496460505,-46,0
34,1,1.5,6,81,-75,0,0.398875255127678,-31,0
34,1,1.5,51,0,51,1,0.432201124548556,-50,0
34,1,1.5,8,62,-54,0,0.463504969269252,-12,0
34,1,1.5,49,97,-48,0,0.52705849145832,-47,0
34,1,1.5,51,2,49,1,0.442800146115133,-48,0
34,1,1.5,32,51,-19,0,0.514107628730017,-1,0
34,1,1.5,42,98,-56,0,0.606752698258333,-48,0
34,1,1.5,56,7,49,1,0.47940774225799,-43,0
34,1,1.5,68,31,37,1,0.72537524871268,-19,0
34,1,1.5,49,99,-50,0,0.633348394809673,-49,0
34,1,1.5,25,68,-43,0,0.544732712437963,-18,0
34,1,1.5,51,4,47,1,0.467963442210021,-46,0
34,1,10,37,55,-18,0,2.78525543119667,-5,0
34,1,10,6,96,-90,0,2.25046546734529,-46,0
34,1,10,58,6,52,1,3.22509464998029,-44,0
34,1,10,51,2,49,1,2.23307384425334,-48,0
34,1,10,49,100,-51,0,2.72835388398835,-50,0
34,1,10,48,91,-43,0,2.04433633245026,-41,0
34,1,10,52,1,51,1,3.51568067263634,-49,0
34,1,10,51,0,51,1,2.71157665949158,-50,0
34,1,10,34,81,-47,0,3.04418526082782,-31,0
34,1,10,49,97,-48,0,5.35635134551694,-47,0
34,1,10,69,35,34,1,4.71810539107946,-15,0
34,1,10,92,48,44,1,1.3380563597002,-2,0
34,1,10,76,5,71,1,3.05333455282016,-45,0
34,1,10,58,38,20,1,2.26799146507801,-12,0
34,1,10,2,60,-58,0,2.00199396534072,-10,0
34,1,10,49,96,-47,0,3.68257165298883,-46,0
34,1,10,51,0,51,1,1.34386879008116,-50,0
34,1,10,49,98,-49,1,5.85767551270465,48,0
34,1,10,51,2,49,1,1.29635693207729,-48,0
34,1,10,1,92,-91,0,9.81954236035426,-42,0
34,1,1.5,49,100,-51,1,0.705463488467103,50,0
34,1,1.5,22,56,-34,0,0.487013711430336,-6,0
34,1,1.5,37,55,-18,0,0.516074404430128,-5,0
34,1,1.5,13,61,-48,0,0.568912278620701,-11,0
34,1,1.5,51,3,48,1,0.794917532015461,-47,0
34,1,1.5,28,70,-42,0,0.524015691952627,-20,0
34,1,1.5,51,0,51,1,0.624822471222615,-50,0
34,1,1.5,49,97,-48,0,0.736645434589718,-47,0
34,1,1.5,46,77,-31,0,0.643949982268623,-27,0
34,1,1.5,57,17,40,1,0.46726258685112,-33,0
34,1,1.5,50,69,-19,1,0.944567762170209,19,0
34,1,1.5,2,90,-88,0,0.691215147983712,-40,0
34,1,1.5,51,4,47,1,0.712530122527369,-46,0
34,1,1.5,37,64,-27,0,0.64517281358485,-14,0
34,1,1.5,42,53,-11,1,1.1246592189018,3,0
34,1,1.5,51,2,49,0,0.847793740546422,48,0
34,1,1.5,10,74,-64,0,0.935110512522442,-24,0
34,1,1.5,25,97,-72,0,0.594659421907181,-47,0
34,1,1.5,49,100,-51,1,0.604554089197791,50,0
34,1,1.5,49,96,-47,1,0.80437113246262,46,0
35,1,10,3,100,-97,0,1.4277961156331,-50,0
35,1,10,5,83,-78,0,1.13108868211202,-33,0
35,1,10,85,15,70,0,1.18163640462353,35,0
35,1,10,53,0,53,0,1.38283173546597,50,0
35,1,10,75,0,75,0,0.888814071254274,50,0
35,1,10,48,100,-52,1,1.01333741429517,50,0
35,1,10,25,55,-30,0,1.41398108217572,-5,0
35,1,10,50,100,-50,1,1.26185186474913,50,0
35,1,10,98,38,60,1,2.11572312750786,-12,0
35,1,10,25,55,-30,0,1.23230948842001,-5,0
35,1,10,50,100,-50,1,1.12832340278919,50,0
35,1,10,28,85,-57,0,2.0434530802404,-35,0
35,1,10,50,43,7,0,1.45943920985746,7,0
35,1,10,48,60,-12,1,1.25736635002568,10,0
35,1,10,100,0,100,0,0.928633140465081,50,0
35,1,10,53,0,53,0,1.01187230010464,50,0
35,1,10,50,43,7,0,1.52516334538677,7,0
35,1,10,53,23,30,0,1.15376294621001,27,0
35,1,10,100,0,100,0,1.00367653123112,50,0
35,1,10,53,40,13,0,1.10757134504956,10,0
35,1,1.5,53,40,13,0,0.704741918870695,10,0
35,1,1.5,48,100,-52,1,0.86204503842373,50,0
35,1,1.5,75,0,75,0,0.685361137635027,50,0
35,1,1.5,3,100,-97,0,0.73932403875915,-50,0
35,1,1.5,100,15,85,0,0.951293842085306,35,0
35,1,1.5,100,15,85,0,1.32256411478284,35,0
35,1,1.5,53,23,30,0,0.967211426204813,27,0
35,1,1.5,0,68,-68,0,0.84186700340706,-18,0
35,1,1.5,80,45,35,1,0.913836476834604,-5,0
35,1,1.5,80,45,35,1,0.879149156102358,-5,0
35,1,1.5,0,68,-68,0,0.749782175604651,-18,0
35,1,1.5,98,38,60,0,1.12906237456991,12,0
35,1,1.5,48,80,-32,NaN,NaN,0,0
35,1,1.5,48,80,-32,1,1.24499810308589,30,0
35,1,1.5,30,100,-70,0,0.796933780284235,-50,0
35,1,1.5,5,83,-78,0,0.790948695344923,-33,0
35,1,1.5,28,85,-57,0,0.792895460785076,-35,0
35,1,1.5,48,60,-12,1,0.794866052201087,10,0
35,1,1.5,85,15,70,0,0.964860352294636,35,0
35,1,1.5,30,100,-70,0,0.775499566550479,-50,0
35,1,10,37,71,-34,0,1.01329562720048,-21,0
35,1,10,76,35,41,1,1.71712592760923,-15,0
35,1,10,68,16,52,0,0.817464439732248,34,0
35,1,10,48,76,-28,1,1.26497233437749,26,0
35,1,10,88,27,61,0,1.13420365343836,23,0
35,1,10,50,33,17,0,1.13672444160193,17,0
35,1,10,74,40,34,1,1.40324143227099,-10,0
35,1,10,31,91,-60,0,1.34709680493688,-41,0
35,1,10,78,35,43,0,1.42166917450322,15,0
35,1,10,36,70,-34,0,1.05429939720261,-20,0
35,1,10,38,55,-17,0,1.03484823770259,-5,0
35,1,10,26,92,-66,0,1.14535860841625,-42,0
35,1,10,97,13,84,0,1.33992005468963,37,0
35,1,10,46,55,-9,0,1.30313421538312,-5,0
35,1,10,84,50,34,1,0.9950104742652,0,0
35,1,10,44,59,-15,0,1.20351708047474,-9,0
35,1,10,63,22,41,0,1.00348372411008,28,0
35,1,10,14,56,-42,0,0.89131030033559,-6,0
35,1,10,34,70,-36,0,1.13578936371823,-20,0
35,1,10,45,80,-35,1,1.31505196811713,30,0
35,1,1.5,28,67,-39,0,0.848898965036369,-17,0
35,1,1.5,83,23,60,0,0.896222116736226,27,0
35,1,1.5,13,94,-81,0,0.750180985772204,-44,0
35,1,1.5,46,84,-38,1,1.03344287172649,34,0
35,1,1.5,50,100,-50,1,0.649415072311967,50,0
35,1,1.5,12,51,-39,0,0.512739748874083,-1,0
35,1,1.5,64,44,20,1,0.686072251352925,-6,0
35,1,1.5,90,13,77,0,0.764044037733129,37,0
35,1,1.5,53,15,38,0,1.13534583402816,35,0
35,1,1.5,94,25,69,0,0.963268044052256,25,0
35,1,1.5,93,9,84,0,0.805246113158773,41,0
35,1,1.5,78,1,77,0,0.582592742608085,49,0
35,1,1.5,38,56,-18,0,0.704564140441107,-6,0
35,1,1.5,73,23,50,0,0.709875133562946,27,0
35,1,1.5,15,100,-85,0,0.547178179805542,-50,0
35,1,1.5,21,51,-30,0,0.455175826532013,-1,0
35,1,1.5,93,19,74,0,0.758383719161429,31,0
35,1,1.5,40,95,-55,0,0.785032889009472,-45,0
35,1,1.5,68,0,68,0,0.778412566919087,50,0
35,1,1.5,41,80,-39,0,1.06903557951182,-30,0
35,1,10,50,100,-50,1,0.860229865676502,50,0
35,1,10,52,14,38,0,0.706874526916636,36,0
35,1,10,12,54,-42,0,0.727366698250989,-4,0
35,1,10,24,83,-59,0,1.56399418646197,-33,0
35,1,10,85,29,56,0,1.65530925199255,21,0
35,1,10,64,16,48,0,1.57459271328389,34,0
35,1,10,47,80,-33,1,1.4391314149143,30,0
35,1,10,97,7,90,0,0.925710976260234,43,0
35,1,10,50,17,33,0,0.936839905942634,33,0
35,1,10,80,31,49,0,1.84343072047932,19,0
35,1,10,99,24,75,0,1.55404116028831,26,0
35,1,10,49,79,-30,1,1.10658128414661,29,0
35,1,10,81,50,31,1,0.997785283977919,0,0
35,1,10,45,100,-55,1,0.950349966918566,50,0
35,1,10,60,7,53,0,1.37757939089806,43,0
35,1,10,99,27,72,0,1.35627127155567,23,0
35,1,10,75,1,74,0,1.19959679119074,49,0
35,1,10,28,55,-27,0,0.894728044821932,-5,0
35,1,10,57,5,52,0,0.963346486493265,45,0
35,1,10,41,54,-13,0,1.11059541111717,-4,0
35,1,1.5,88,21,67,0,0.690470159799133,29,0
35,1,1.5,65,10,55,0,0.735743911088775,40,0
35,1,1.5,31,93,-62,0,0.747715913735192,-43,0
35,1,1.5,94,23,71,0,0.863061857729917,27,0
35,1,1.5,31,85,-54,0,0.813695537028252,-35,0
35,1,1.5,97,12,85,0,0.92633411714678,38,0
35,1,1.5,45,99,-54,1,0.962324168885971,49,0
35,1,1.5,5,65,-60,0,0.700908136203907,-15,0
35,1,1.5,6,79,-73,0,0.537526094024543,-29,0
35,1,1.5,97,4,93,0,0.564880146181622,46,0
35,1,1.5,11,53,-42,0,0.549494431136281,-3,0
35,1,1.5,46,76,-30,0,0.944168409322629,-26,0
35,1,1.5,47,62,-15,0,1.15548574748527,-12,0
35,1,1.5,23,98,-75,0,0.814124404579616,-48,0
35,1,1.5,37,68,-31,0,0.638713177413592,-18,0
35,1,1.5,50,21,29,1,1.06201021584502,-29,0
35,1,1.5,85,25,60,0,0.989330728360073,25,0
35,1,1.5,49,86,-37,1,1.32664532103627,36,0
35,1,1.5,69,35,34,1,1.27461379010811,-15,0
35,1,1.5,15,64,-49,0,0.688565548006864,-14,0
35,1,10,44,62,-18,0,1.35115675109,-12,0
35,1,10,86,23,63,0,1.40836731589388,27,0
35,1,10,53,30,23,0,2.90489807064569,20,0
35,1,10,72,20,52,0,1.2055353238411,30,0
35,1,10,56,3,53,0,1.13342216145566,47,0
35,1,10,37,65,-28,0,2.2893913929579,-15,0
35,1,10,45,52,-7,0,1.8225884905878,-2,0
35,1,10,45,93,-48,1,1.5986199262129,43,0
35,1,10,6,66,-60,0,1.26326896043611,-16,0
35,1,10,86,20,66,0,2.50041035660161,30,0
35,1,10,8,52,-44,0,1.1604305536971,-2,0
35,1,10,85,24,61,1,1.18771642691036,-26,0
35,1,10,35,85,-50,0,1.03557767909342,-35,0
35,1,10,2,97,-95,0,1.33747184411232,-47,0
35,1,10,83,25,58,1,1.41271427340871,-25,0
35,1,10,36,78,-42,0,1.11598557978687,-28,0
35,1,10,37,58,-21,0,1.06320444702669,-8,0
35,1,10,77,25,52,0,2.14037384787662,25,0
35,1,10,87,21,66,0,1.55170181608901,29,0
35,1,10,85,48,37,1,1.36231977024454,-2,0
35,1,1.5,67,38,29,0,0.96750503552812,12,0
35,1,1.5,43,87,-44,1,0.945498265285551,37,0
35,1,1.5,93,20,73,0,0.804782056474778,30,0
35,1,1.5,13,58,-45,0,0.614095080302832,-8,0
35,1,1.5,48,89,-41,1,0.910662123847032,39,0
35,1,1.5,68,0,68,0,0.723346706425673,50,0
35,1,1.5,58,20,38,0,0.855337843162488,30,0
35,1,1.5,48,83,-35,1,0.9579764782643,33,0
35,1,1.5,79,23,56,0,1.09660259923066,27,0
35,1,1.5,88,10,78,0,0.646579048170679,40,0
35,1,1.5,30,56,-26,0,0.700491364916616,-6,0
35,1,1.5,57,5,52,0,0.689153499761233,45,0
35,1,1.5,46,51,-5,0,1.08715908237036,-1,0
35,1,1.5,86,34,52,0,0.868464122663681,16,0
35,1,1.5,45,94,-49,1,1.07445470590483,44,0
35,1,1.5,63,23,40,0,0.792396581522553,27,0
35,1,1.5,95,10,85,0,0.75371346149268,40,0
35,1,1.5,52,3,49,0,0.660291080104798,47,0
35,1,1.5,24,94,-70,0,1.25097842283049,-44,0
35,1,1.5,97,19,78,0,0.793636998440434,31,0
35,1,10,37,90,-53,0,3.07742745448786,-40,0
35,1,10,45,98,-53,1,1.23545415057652,48,0
35,1,10,11,88,-77,0,0.858827432128237,-38,0
35,1,10,3,70,-67,0,2.20061471015697,-20,0
35,1,10,20,97,-77,0,2.16126702869951,-47,0
35,1,10,96,19,77,0,2.55441027962524,31,0
35,1,10,96,17,79,0,2.35709491718671,33,0
35,1,10,83,23,60,0,2.34371644890371,27,0
35,1,10,93,17,76,0,2.33901686695754,33,0
35,1,10,90,5,85,0,2.45422205442219,45,0
35,1,10,31,96,-65,0,2.38023213830775,-46,0
35,1,10,34,58,-24,0,2.04622422441889,-8,0
35,1,10,70,48,22,1,2.39751220164862,-2,0
35,1,10,6,61,-55,0,1.73475385018583,-11,0
35,1,10,47,74,-27,1,2.45803091145308,24,0
35,1,10,80,12,68,0,1.77672898686478,38,0
35,1,10,21,76,-55,0,1.26518676815294,-26,0
35,1,10,97,10,87,0,1.72578721937998,40,0
35,1,10,89,13,76,0,2.20168834524929,37,0
35,1,10,97,38,59,1,2.70702224796241,-12,0
35,1,1.5,19,85,-66,0,0.670986010487013,-35,0
35,1,1.5,99,21,78,0,0.996948075869113,29,0
35,1,1.5,6,57,-51,0,0.685571905876259,-7,0
35,1,1.5,53,21,32,0,0.882861976126605,29,0
35,1,1.5,49,63,-14,1,1.10351506443067,13,0
35,1,1.5,65,36,29,0,0.916168123411353,14,0
35,1,1.5,6,98,-92,0,0.847495798380805,-48,0
35,1,1.5,48,87,-39,1,0.982781517641342,37,0
35,1,1.5,87,14,73,0,0.912099746528384,36,0
35,1,1.5,38,60,-22,0,0.884661753628279,-10,0
35,1,1.5,45,69,-24,1,1.08865278773055,19,0
35,1,1.5,93,36,57,1,1.37397946934061,-14,0
35,1,1.5,12,78,-66,0,1.05666733257203,-28,0
35,1,1.5,35,99,-64,0,1.303257010793,-49,0
35,1,1.5,60,21,39,0,0.803898296076113,29,0
35,1,1.5,92,21,71,0,0.859803197445672,29,0
35,1,1.5,31,96,-65,NaN,NaN,0,0
35,1,1.5,46,86,-40,1,1.06908029903434,36,0
35,1,1.5,37,94,-57,0,1.49907463578347,-44,0
35,1,1.5,45,100,-55,1,1.13571935200707,50,0
36,1,10,50,100,-50,0,4.19519811443752,-50,0
36,1,10,75,0,75,0,4.491792991088,50,0
36,1,10,53,0,53,0,6.4576937386737,50,0
36,1,10,100,15,85,0,5.60100106484606,35,0
36,1,10,5,83,-78,0,9.85820251861878,-33,0
36,1,10,30,100,-70,NaN,NaN,0,0
36,1,10,0,68,-68,0,3.6527404654189,-18,0
36,1,10,98,38,60,1,3.73202326166211,-12,0
36,1,10,48,60,-12,1,3.759936512477,10,0
36,1,10,50,100,-50,0,4.60321359777299,-50,0
36,1,10,48,80,-32,1,3.7324884214031,30,0
36,1,10,100,0,100,0,4.42393675359199,50,0
36,1,10,98,38,60,0,3.00909975642571,12,0
36,1,10,53,40,13,1,3.63434447847249,-10,0
36,1,10,100,15,85,0,4.99423370520526,35,0
36,1,10,50,43,7,0,4.14826499808987,7,0
36,1,10,5,83,-78,0,4.64020644442644,-33,0
36,1,10,53,0,53,0,4.46409490871883,50,0
36,1,10,28,85,-57,0,4.41543091424683,-35,0
36,1,10,80,45,35,0,4.15271169076732,5,0
36,1,1.5,3,100,-97,1,0.662611822524923,50,0
36,1,1.5,48,100,-52,1,0.933991301630158,50,0
36,1,1.5,48,100,-52,0,0.873934742019628,-50,0
36,1,1.5,85,15,70,0,0.800578792157467,35,0
36,1,1.5,75,0,75,0,0.569914537423756,50,0
36,1,1.5,48,80,-32,1,0.844530340778874,30,0
36,1,1.5,25,55,-30,1,0.98047282078187,5,0
36,1,1.5,53,40,13,1,0.999163518863497,-10,0
36,1,1.5,25,55,-30,0,0.712488018194563,-5,0
36,1,1.5,85,15,70,1,0.893786323431414,-35,0
36,1,1.5,30,100,-70,1,0.747716263547773,50,0
36,1,1.5,28,85,-57,0,0.751730786490953,-35,0
36,1,1.5,100,0,100,0,0.891000496674678,50,0
36,1,1.5,53,23,30,1,0.712994598798105,-27,0
36,1,1.5,53,23,30,0,0.590336480221595,27,0
36,1,1.5,50,43,7,1,0.816281691077165,-7,0
36,1,1.5,0,68,-68,0,0.664952650113264,-18,0
36,1,1.5,48,60,-12,0,0.77623066646629,-10,0
36,1,1.5,80,45,35,0,0.706865046857274,5,0
36,1,1.5,3,100,-97,0,0.632178864747402,-50,0
36,1,10,98,34,64,0,3.47144142707111,16,0
36,1,10,57,33,24,0,4.9580227228289,17,0
36,1,10,100,5,95,0,5.01731464630575,45,0
36,1,10,99,5,94,0,6.82650824109442,45,0
36,1,10,100,13,87,0,6.32315883428964,37,0
36,1,10,45,97,-52,1,4.80777245659556,47,0
36,1,10,91,13,78,0,4.74507742581773,37,0
36,1,10,44,92,-48,0,5.18098343349993,-42,0
36,1,10,40,80,-40,0,5.51153937088384,-30,0
36,1,10,0,98,-98,0,4.65286582760746,-48,0
36,1,10,87,48,39,0,6.13877779182803,2,0
36,1,10,0,98,-98,0,4.19873464817647,-48,0
36,1,10,79,35,44,1,3.91201919286686,-15,0
36,1,10,87,47,40,0,5.75727531482698,3,0
36,1,10,88,13,75,0,6.40053297264967,37,0
36,1,10,99,3,96,0,5.48177647772536,47,0
36,1,10,11,52,-41,0,4.08843167117448,-2,0
36,1,10,20,70,-50,0,4.96637360502791,-20,0
36,1,10,99,9,90,0,4.14496086096915,41,0
36,1,10,25,52,-27,0,5.56493927081465,-2,0
36,1,1.5,98,22,76,0,0.800811555309338,28,0
36,1,1.5,56,48,8,1,1.08210381236859,-2,0
36,1,1.5,53,36,17,0,1.17611336849222,14,0
36,1,1.5,36,100,-64,0,0.778629043343244,-50,0
36,1,1.5,90,48,42,1,0.773443006939488,-2,0
36,1,1.5,24,59,-35,0,0.664017565373797,-9,0
36,1,1.5,97,13,84,0,0.758715147385374,37,0
36,1,1.5,94,21,73,0,0.793982247691019,29,0
36,1,1.5,0,62,-62,0,0.555951314003323,-12,0
36,1,1.5,3,80,-77,0,0.719314393369132,-30,0
36,1,1.5,76,43,33,0,0.594646080877283,7,0
36,1,1.5,25,66,-41,0,1.06058806604415,-16,0
36,1,1.5,55,22,33,0,1.00390822168265,28,0
36,1,1.5,100,20,80,1,0.901151902711717,-30,0
36,1,1.5,87,48,39,1,0.8264624215808,-2,0
36,1,1.5,92,15,77,0,0.819167221081443,35,0
36,1,1.5,19,94,-75,0,0.659800336856279,-44,0
36,1,1.5,3,66,-63,0,0.619118469112436,-16,0
36,1,1.5,97,15,82,0,0.747761349950451,35,0
36,1,1.5,71,14,57,0,0.663733850917197,36,0
36,1,10,97,11,86,0,4.86692618842062,39,0
36,1,10,94,10,84,0,6.24147766115493,40,0
36,1,10,38,78,-40,0,8.00873210059945,-28,0
36,1,10,15,99,-84,NaN,NaN,0,0
36,1,10,55,11,44,0,4.78193354704126,39,0
36,1,10,3,65,-62,0,3.67251616971043,-15,0
36,1,10,81,5,76,0,4.18316920781217,45,0
36,1,10,59,5,54,0,4.27245422171836,45,0
36,1,10,100,15,85,0,4.16704806833877,35,0
36,1,10,83,35,48,1,4.53768765383575,-15,0
36,1,10,54,37,17,0,4.55625042381871,13,0
36,1,10,44,90,-46,0,5.29490102067939,-40,0
36,1,10,58,20,38,0,4.62080939262523,30,0
36,1,10,100,15,85,0,4.82870757799537,35,0
36,1,10,62,38,24,0,5.70136083971011,12,0
36,1,10,100,3,97,0,4.48247403408459,47,0
36,1,10,99,6,93,0,4.76858503828407,44,0
36,1,10,81,10,71,0,4.83454571779293,40,0
36,1,10,1,70,-69,0,4.29764945869101,-20,0
36,1,10,30,89,-59,0,4.84776703157695,-39,0
36,1,1.5,26,93,-67,0,0.740332356464933,-43,0
36,1,1.5,69,12,57,0,0.903614426919376,38,0
36,1,1.5,62,38,24,1,0.644948214787291,-12,0
36,1,1.5,17,84,-67,0,0.604299337079283,-34,0
36,1,1.5,83,45,38,0,0.452917878588778,5,0
36,1,1.5,95,16,79,0,0.467583057048614,34,0
36,1,1.5,98,18,80,0,0.505560473524383,32,0
36,1,1.5,0,77,-77,0,0.734205370405107,-27,0
36,1,1.5,11,76,-65,0,0.569461107486859,-26,0
36,1,1.5,32,69,-37,0,0.747457108343951,-19,0
36,1,1.5,83,8,75,0,0.758137088341755,42,0
36,1,1.5,3,81,-78,0,0.624770031834487,-31,0
36,1,1.5,97,17,80,1,0.704763580448343,-33,0
36,1,1.5,100,6,94,1,0.597334403675632,-44,0
36,1,1.5,64,20,44,0,0.534674928843742,30,0
36,1,1.5,14,91,-77,0,0.570016073485021,-41,0
36,1,1.5,91,19,72,0,0.827973732579267,31,0
36,1,1.5,4,77,-73,0,0.611977222200949,-27,0
36,1,1.5,96,11,85,0,0.956604883627733,39,0
36,1,1.5,19,58,-39,0,0.455200057185721,-8,0
36,1,10,59,5,54,0,3.85314404373639,45,0
36,1,10,61,38,23,0,3.9637798537151,12,0
36,1,10,69,12,57,0,4.70236007176572,38,0
36,1,10,46,79,-33,1,5.5550023001415,29,0
36,1,10,98,37,61,0,5.54892259984626,13,0
36,1,10,94,9,85,0,5.22349148397916,41,0
36,1,10,65,37,28,0,5.09612898378691,13,0
36,1,10,28,97,-69,0,5.14934120695398,-47,0
36,1,10,10,52,-42,0,6.11999838714837,-2,0
36,1,10,24,94,-70,0,6.93991154999821,-44,0
36,1,10,97,5,92,0,6.3425031019724,45,0
36,1,10,90,1,89,0,5.28166577777301,49,0
36,1,10,39,99,-60,0,5.06374081547256,-49,0
36,1,10,50,64,-14,0,5.70298981523956,-14,0
36,1,10,98,11,87,0,6.76353022897092,39,0
36,1,10,98,18,80,0,6.12617889040848,32,0
36,1,10,1,75,-74,0,4.97808763991634,-25,0
36,1,10,98,7,91,0,4.96406173538708,43,0
36,1,10,10,92,-82,0,4.78262047327007,-42,0
36,1,10,62,36,26,0,5.16856084557367,14,0
36,1,1.5,92,5,87,0,0.556576292248792,45,0
36,1,1.5,43,83,-40,0,0.863230202769046,-33,0
36,1,1.5,35,75,-40,0,0.92653408330807,-25,0
36,1,1.5,31,88,-57,0,0.578513944710721,-38,0
36,1,1.5,30,100,-70,0,0.700435285427375,-50,0
36,1,1.5,96,11,85,1,0.713115928883781,-39,0
36,1,1.5,10,55,-45,0,0.525625390611822,-5,0
36,1,1.5,93,10,83,0,0.601229075953597,40,0
36,1,1.5,51,2,49,0,0.538421499251854,48,0
36,1,1.5,25,95,-70,0,0.829714507737663,-45,0
36,1,1.5,4,62,-58,0,0.428335890057497,-12,0
36,1,1.5,18,70,-52,0,0.428301800333429,-20,0
36,1,1.5,12,67,-55,0,0.5403055978677,-17,0
36,1,1.5,21,64,-43,0,0.343651155839325,-14,0
36,1,1.5,82,40,42,0,0.498939003227861,10,0
36,1,1.5,49,72,-23,0,0.360087900160579,-22,0
36,1,1.5,97,15,82,0,0.411566679322277,35,0
36,1,1.5,96,12,84,0,0.524224046443123,38,0
36,1,1.5,91,19,72,0,0.600121330091497,31,0
36,1,1.5,1,76,-75,0,0.520822771941312,-26,0
36,1,10,53,23,30,0,4.42474400634819,27,0
36,1,10,45,60,-15,0,5.44864530010091,-10,0
36,1,10,69,36,33,0,6.11126885242993,14,0
36,1,10,66,41,25,0,5.35584354649473,9,0
36,1,10,99,8,91,0,5.55849667990697,42,0
36,1,10,11,89,-78,0,5.18438360834261,-39,0
36,1,10,35,64,-29,0,5.72164239149424,-14,0
36,1,10,38,72,-34,0,5.39828891589423,-22,0
36,1,10,39,76,-37,0,4.92750179154973,-26,0
36,1,10,94,9,85,0,4.62750454072375,41,0
36,1,10,91,19,72,0,5.53877229348291,31,0
36,1,10,98,30,68,0,4.55803408606153,20,0
36,1,10,1,85,-84,0,3.80868811385881,-35,0
36,1,10,16,81,-65,0,4.1286439805117,-31,0
36,1,10,37,60,-23,0,3.59656097019615,-10,0
36,1,10,21,89,-68,0,3.67783783189952,-39,0
36,1,10,52,35,17,0,4.33980341593269,15,0
36,1,10,95,8,87,0,3.67106937259086,42,0
36,1,10,95,12,83,0,4.53302799205994,38,0
36,1,10,93,25,68,0,3.63233941631916,25,0
36,1,1.5,50,88,-38,1,0.824238525412511,38,0
36,1,1.5,13,50,-37,0,0.624216165495454,0,0
36,1,1.5,7,92,-85,0,0.560243686515605,-42,0
36,1,1.5,58,19,39,0,1.05088239228644,31,0
36,1,1.5,99,5,94,0,0.6255299027398,45,0
36,1,1.5,9,89,-80,0,0.544776116672438,-39,0
36,1,1.5,95,10,85,0,0.50006176471652,40,0
36,1,1.5,74,23,51,0,0.54475888851448,27,0
36,1,1.5,95,11,84,0,0.5080955758458,39,0
36,1,1.5,69,5,64,0,0.560701148599037,45,0
36,1,1.5,98,5,93,0,0.458741356138489,45,0
36,1,1.5,84,40,44,0,0.448668759694556,10,0
36,1,1.5,6,53,-47,1,0.775335536338389,3,0
36,1,1.5,23,90,-67,0,0.601298341876827,-40,0
36,1,1.5,96,8,88,1,0.841259560242179,-42,0
36,1,1.5,73,44,29,1,0.639960851796786,-6,0
36,1,1.5,27,61,-34,0,0.631265406816965,-11,0
36,1,1.5,94,14,80,1,0.631239747875952,-36,0
36,1,1.5,42,99,-57,0,0.49523971855524,-49,0
36,1,1.5,33,84,-51,0,0.643829485401511,-34,0
37,1,10,75,0,75,1,2.71650681880419,-50,0
37,1,10,30,100,-70,0,6.12042894086335,-50,0
37,1,10,25,55,-30,1,5.81299761922855,5,0
37,1,10,50,100,-50,1,6.10222149726178,50,0
37,1,10,53,23,30,1,8.36338864013669,-27,0
37,1,10,53,40,13,1,7.46271069950308,-10,0
37,1,10,0,68,-68,0,7.06187202519504,-18,0
37,1,10,3,100,-97,1,8.83721140788111,50,0
37,1,10,98,38,60,1,6.02904862881405,-12,0
37,1,10,48,80,-32,1,7.45365389656217,30,0
37,1,10,75,0,75,1,9.46084934103419,-50,0
37,1,10,80,45,35,NaN,NaN,0,0
37,1,10,48,100,-52,1,3.23469905043021,50,0
37,1,10,98,38,60,1,5.93855940824142,-12,0
37,1,10,53,0,53,0,6.35052884501056,50,0
37,1,10,48,60,-12,1,6.19376932425075,10,0
37,1,10,85,15,70,1,4.3317088905751,-35,0
37,1,10,50,43,7,1,7.29559860928566,-7,0
37,1,10,53,23,30,1,9.26946664639399,-27,0
37,1,10,0,68,-68,1,6.34804141320637,18,0
37,1,1.5,100,0,100,1,0.411091541231144,-50,0
37,1,1.5,30,100,-70,1,0.764474004943622,50,0
37,1,1.5,85,15,70,1,0.807722548343008,-35,0
37,1,1.5,48,60,-12,0,0.849054383710609,-10,0
37,1,1.5,28,85,-57,1,1.29631485477148,35,0
37,1,1.5,100,0,100,0,0.75026895859628,50,0
37,1,1.5,80,45,35,NaN,NaN,0,0
37,1,1.5,100,15,85,1,0.749609162361594,-35,0
37,1,1.5,50,43,7,1,0.528902190708322,-7,0
37,1,1.5,100,15,85,1,1.08550262727658,-35,0
37,1,1.5,5,83,-78,0,0.683367453355459,-33,0
37,1,1.5,28,85,-57,1,0.409387434177916,35,0
37,1,1.5,48,100,-52,1,0.658759253186872,50,0
37,1,1.5,53,40,13,1,0.722094559794641,-10,0
37,1,1.5,5,83,-78,0,0.614708690802217,-33,0
37,1,1.5,53,0,53,1,0.527993871219223,-50,0
37,1,1.5,3,100,-97,0,0.80464899756771,-50,0
37,1,1.5,25,55,-30,1,0.533952930869418,5,0
37,1,1.5,48,80,-32,1,1.01792922952154,30,0
37,1,1.5,50,100,-50,1,0.946582163887797,50,0
37,1,10,70,49,21,1,3.15673349547433,-1,0
37,1,10,49,79,-30,1,4.41597696578538,29,0
37,1,10,48,58,-10,1,3.16060246726556,8,0
37,1,10,49,53,-4,1,6.32452004405786,3,0
37,1,10,4,82,-78,0,3.97704312317364,-32,0
37,1,10,13,52,-39,0,4.73968656013312,-2,0
37,1,10,36,51,-15,0,4.3843569644232,-1,0
37,1,10,50,49,1,1,3.24226508046559,-1,0
37,1,10,52,36,16,1,4.85817496696836,-14,0
37,1,10,59,46,13,0,3.97745402960572,4,0
37,1,10,49,98,-49,0,5.8506884790404,-48,0
37,1,10,91,47,44,1,5.78595000578207,-3,0
37,1,10,47,85,-38,0,4.54786473444256,-35,0
37,1,10,49,66,-17,1,4.83980367396725,16,0
37,1,10,52,28,24,0,5.31175738558522,22,0
37,1,10,95,45,50,1,6.31698333831446,-5,0
37,1,10,44,98,-54,1,5.88956697206595,48,0
37,1,10,2,64,-62,0,3.65554787829751,-14,0
37,1,10,26,70,-44,0,6.39137426391244,-20,0
37,1,10,23,89,-66,1,3.97737522060925,39,0
37,1,1.5,7,99,-92,1,0.712567102193134,49,0
37,1,1.5,36,59,-23,1,0.654544254910434,9,0
37,1,1.5,48,80,-32,0,0.653839372607763,-30,0
37,1,1.5,28,88,-60,1,0.773168286526925,38,0
37,1,1.5,59,46,13,1,0.992400980176171,-4,0
37,1,1.5,44,98,-54,0,1.2350483758928,-48,0
37,1,1.5,95,5,90,0,1.41973120634793,45,0
37,1,1.5,79,37,42,0,1.42832945092232,13,0
37,1,1.5,55,43,12,1,1.29294182980084,-7,0
37,1,1.5,50,1,49,NaN,NaN,0,0
37,1,1.5,9,54,-45,1,0.849563526455313,4,0
37,1,1.5,97,41,56,1,0.248876238722005,-9,0
37,1,1.5,48,100,-52,1,0.944173174517346,50,0
37,1,1.5,100,0,100,1,0.908140236017061,-50,0
37,1,1.5,82,18,64,1,1.07344411801023,-32,0
37,1,1.5,0,88,-88,0,0.656735511525767,-38,0
37,1,1.5,49,79,-30,1,0.400015028688358,29,0
37,1,1.5,100,47,53,1,0.425357435437036,-3,0
37,1,1.5,15,77,-62,1,0.746676734677749,27,0
37,1,1.5,10,69,-59,0,0.68665287202748,-19,0
37,1,10,53,43,10,1,6.12144869258918,-7,0
37,1,10,100,0,100,1,5.95806701696711,-50,0
37,1,10,87,11,76,0,3.85737917940423,39,0
37,1,10,94,42,52,1,2.52061991521623,-8,0
37,1,10,12,94,-82,0,3.07727166927361,-44,0
37,1,10,7,99,-92,0,3.43587825293071,-49,0
37,1,10,97,50,47,1,2.93182838699431,0,0
37,1,10,89,23,66,0,2.72706942338846,27,0
37,1,10,28,88,-60,0,3.50773885998933,-38,0
37,1,10,12,76,-64,0,3.96969922455901,-26,0
37,1,10,23,52,-29,0,3.65090731145756,-2,0
37,1,10,98,15,83,1,3.49020734097576,-35,0
37,1,10,79,37,42,1,5.92745723696135,-13,0
37,1,10,9,54,-45,1,5.18002356938086,4,0
37,1,10,38,90,-52,1,7.0146089882619,40,0
37,1,10,84,41,43,1,4.42315078359388,-9,0
37,1,10,28,85,-57,0,6.23176369031717,-35,0
37,1,10,55,44,11,1,2.82441979167925,-6,0
37,1,10,94,47,47,1,4.88031662888534,-3,0
37,1,10,53,39,14,1,4.04628507228335,-11,0
37,1,1.5,9,54,-45,0,0.614827454119222,-4,0
37,1,1.5,83,21,62,1,0.439432355313329,-29,0
37,1,1.5,10,80,-70,0,0.598713397339452,-30,0
37,1,1.5,44,98,-54,1,0.463369762641378,48,0
37,1,1.5,50,80,-30,1,0.405965291050961,30,0
37,1,1.5,86,50,36,1,0.734682738810079,0,0
37,1,1.5,98,48,50,1,0.729970327491174,-2,0
37,1,1.5,53,0,53,0,0.725941538388724,50,0
37,1,1.5,75,8,67,0,0.705918555497192,42,0
37,1,1.5,70,37,33,1,0.51855255367991,-13,0
37,1,1.5,12,75,-63,0,0.841843543981668,-25,0
37,1,1.5,59,46,13,1,0.482462066298467,-4,0
37,1,1.5,49,53,-4,1,0.655817661638139,3,0
37,1,1.5,55,44,11,1,0.710448056619498,-6,0
37,1,1.5,57,39,18,0,1.15574490078143,11,0
37,1,1.5,73,43,30,1,0.542362400417915,-7,0
37,1,1.5,95,20,75,1,0.649679723908775,-30,0
37,1,1.5,14,58,-44,0,0.912306116122636,-8,0
37,1,1.5,87,11,76,1,1.1329500405991,-39,0
37,1,1.5,3,51,-48,0,0.920208275681944,-1,0
37,1,10,54,0,54,0,1.66456289416237,50,0
37,1,10,67,20,47,1,3.77512055027182,-30,0
37,1,10,7,99,-92,1,3.84103639326349,49,0
37,1,10,53,0,53,0,2.92835859193292,50,0
37,1,10,26,66,-40,0,4.47629590393626,-16,0
37,1,10,65,23,42,1,3.53819468754227,-27,0
37,1,10,78,18,60,0,3.83749108816846,32,0
37,1,10,63,49,14,1,4.90873881783045,-1,0
37,1,10,9,54,-45,0,3.67334918065171,-4,0
37,1,10,72,11,61,0,4.34330187692831,39,0
37,1,10,7,99,-92,0,5.92917783890152,-49,0
37,1,10,49,53,-4,1,4.03783968051721,3,0
37,1,10,9,84,-75,0,2.82175751388422,-34,0
37,1,10,95,48,47,1,1.22976304151234,-2,0
37,1,10,42,61,-19,1,2.03767986320599,11,0
37,1,10,64,44,20,1,7.0114353683748,-6,0
37,1,10,19,77,-58,0,6.75605573812209,-27,0
37,1,10,41,95,-54,0,5.55863480828702,-45,0
37,1,10,28,85,-57,1,6.40922871652583,35,0
37,1,10,83,24,59,1,8.96971718568238,-26,0
37,1,1.5,72,11,61,1,0.492276535267592,-39,0
37,1,1.5,56,32,24,0,0.482266326740501,18,0
37,1,1.5,15,77,-62,0,1.15960177632223,-27,0
37,1,1.5,97,44,53,0,1.49087666759442,6,0
37,1,1.5,94,7,87,0,0.88885036004649,43,0
37,1,1.5,65,49,16,1,0.262193859132822,-1,0
37,1,1.5,20,95,-75,1,0.948781118087936,45,0
37,1,1.5,90,36,54,0,1.27140937974036,14,0
37,1,1.5,13,91,-78,1,0.749404625530588,41,0
37,1,1.5,52,28,24,1,1.00869977987895,-22,0
37,1,1.5,30,60,-30,NaN,NaN,0,0
37,1,1.5,24,96,-72,1,1.16793573585164,46,0
37,1,1.5,13,91,-78,1,0.929930739715928,41,0
37,1,1.5,7,60,-53,1,0.862618328028475,10,0
37,1,1.5,3,100,-97,0,0.869204194110353,-50,0
37,1,1.5,50,19,31,1,0.955128357862122,-31,0
37,1,1.5,50,100,-50,0,0.845811485211016,-50,0
37,1,1.5,89,44,45,1,0.853120927815326,-6,0
37,1,1.5,42,61,-19,1,0.972381296247477,11,0
37,1,1.5,46,96,-50,0,0.398382399580441,-46,0
37,1,10,78,16,62,0,4.61002853618993,34,0
37,1,10,72,48,24,1,4.01065607572673,-2,0
37,1,10,50,80,-30,1,6.53920894097246,30,0
37,1,10,12,88,-76,0,7.0791055362497,-38,0
37,1,10,23,70,-47,0,3.88508035767882,-20,0
37,1,10,48,80,-32,0,4.70631443323509,-30,0
37,1,10,43,82,-39,1,4.71092127714655,32,0
37,1,10,53,0,53,1,4.65955357454368,-50,0
37,1,10,80,0,80,0,3.24214191851206,50,0
37,1,10,64,23,41,0,5.08940238956711,27,0
37,1,10,4,77,-73,1,2.8780370329041,27,0
37,1,10,50,100,-50,0,4.13992152090941,-50,0
37,1,10,44,64,-20,1,4.47922796508647,14,0
37,1,10,7,100,-93,0,3.10919151136477,-50,0
37,1,10,64,27,37,1,5.10571878384508,-23,0
37,1,10,7,99,-92,0,4.95035546521831,-49,0
37,1,10,94,21,73,0,4.78494198375847,29,0
37,1,10,20,95,-75,0,4.66621201818634,-45,0
37,1,10,4,94,-90,0,3.70488744060276,-44,0
37,1,10,87,48,39,1,3.25345595768886,-2,0
37,1,1.5,24,53,-29,1,0.686643708206248,3,0
37,1,1.5,49,53,-4,1,0.643928866644274,3,0
37,1,1.5,32,50,-18,1,0.715217650285922,0,0
37,1,1.5,74,39,35,0,0.983224680778221,11,0
37,1,1.5,13,91,-78,1,0.952544889063574,41,0
37,1,1.5,16,58,-42,0,0.883212401240598,-8,0
37,1,1.5,27,94,-67,0,0.641174583914108,-44,0
37,1,1.5,25,55,-30,0,0.672428031801246,-5,0
37,1,1.5,84,48,36,1,0.27111430419609,-2,0
37,1,1.5,94,29,65,1,0.717037954775151,-21,0
37,1,1.5,19,73,-54,0,0.671719117410248,-23,0
37,1,1.5,89,49,40,1,0.798335114173824,-1,0
37,1,1.5,88,13,75,NaN,NaN,0,0
37,1,1.5,42,61,-19,0,0.683603513782145,-11,0
37,1,1.5,48,80,-32,1,0.425551342224935,30,0
37,1,1.5,81,17,64,0,0.873537222592859,33,0
37,1,1.5,49,79,-30,1,0.823511838767445,29,0
37,1,1.5,34,95,-61,0,0.816144480719231,-45,0
37,1,1.5,53,11,42,1,0.73611926184094,-39,0
37,1,1.5,39,70,-31,1,1.02744715672452,20,0
38,1,10,28,85,-57,0,1.20276384349563,-35,0
38,1,10,3,100,-97,0,2.44962125449092,-50,0
38,1,10,0,68,-68,0,2.68903938110452,-18,0
38,1,10,75,0,75,0,2.33515524625545,50,0
38,1,10,50,100,-50,0,2.92319887393387,-50,0
38,1,10,100,0,100,0,3.52796412137104,50,0
38,1,10,48,80,-32,0,3.04469618797884,-30,0
38,1,10,0,68,-68,0,2.75681732789963,-18,0
38,1,10,48,100,-52,0,3.2315855261113,-50,0
38,1,10,48,80,-32,0,2.34432688131346,-30,0
38,1,10,100,15,85,0,1.78046468493994,35,0
38,1,10,85,15,70,0,2.23115885318839,35,0
38,1,10,53,0,53,0,2.67995828573476,50,0
38,1,10,48,60,-12,0,2.83067133172881,-10,0
38,1,10,48,60,-12,0,2.87143179189297,-10,0
38,1,10,75,0,75,0,3.12618191883666,50,0
38,1,10,5,83,-78,0,3.51493776770076,-33,0
38,1,10,98,38,60,1,2.74440385840717,-12,0
38,1,10,53,23,30,1,2.98844794058823,-27,0
38,1,10,3,100,-97,0,3.60656247881707,-50,0
38,1,1.5,100,15,85,0,1.04941085044993,35,0
38,1,1.5,50,100,-50,0,1.0568090803572,-50,0
38,1,1.5,80,45,35,1,0.744187222910114,-5,0
38,1,1.5,28,85,-57,0,0.604208813136211,-35,0
38,1,1.5,5,83,-78,0,0.613649134844309,-33,0
38,1,1.5,80,45,35,1,0.743009107129183,-5,0
38,1,1.5,98,38,60,0,0.843077836645534,12,0
38,1,1.5,25,55,-30,1,0.875120093405712,5,0
38,1,1.5,50,43,7,1,1.2258690619783,-7,0
38,1,1.5,100,0,100,0,1.06655401134049,50,0
38,1,1.5,30,100,-70,0,1.3692700190586,-50,0
38,1,1.5,50,43,7,NaN,NaN,0,0
38,1,1.5,30,100,-70,0,0.608105319290189,-50,0
38,1,1.5,25,55,-30,0,0.409504102688516,-5,0
38,1,1.5,85,15,70,0,0.370861978270113,35,0
38,1,1.5,53,40,13,0,0.325594327150611,10,0
38,1,1.5,48,100,-52,0,0.314978455571691,-50,0
38,1,1.5,53,40,13,0,0.17638160099159,10,0
38,1,1.5,53,0,53,0,0.227084933198057,50,0
38,1,1.5,53,23,30,0,0.211784090322908,27,0
38,1,10,85,16,69,0,0.895935060660122,34,0
38,1,10,97,2,95,1,1.78883649155614,-48,0
38,1,10,27,87,-60,0,1.09486911148997,-37,0
38,1,10,91,14,77,1,1.73978083528345,-36,0
38,1,10,9,85,-76,0,2.46270039238152,-35,0
38,1,10,82,45,37,1,2.35012105561327,-5,0
38,1,10,35,85,-50,0,1.88146520359442,-35,0
38,1,10,93,16,77,0,1.94421618094202,34,0
38,1,10,16,100,-84,0,1.60318648430984,-50,0
38,1,10,67,32,35,0,1.26055126581923,18,0
38,1,10,53,0,53,0,2.80145816568984,50,0
38,1,10,19,92,-73,0,2.83486071732477,-42,0
38,1,10,93,16,77,0,2.84294770873385,34,0
38,1,10,88,28,60,0,2.82706550564035,22,0
38,1,10,100,0,100,0,2.47587153626955,50,0
38,1,10,62,30,32,0,2.95454907012754,20,0
38,1,10,68,22,46,0,3.60596022484242,28,0
38,1,10,85,6,79,0,3.26340234998497,44,0
38,1,10,74,17,57,0,3.00683483103057,33,0
38,1,10,66,35,31,1,2.22430642740801,-15,0
38,1,1.5,93,16,77,0,0.536450660438277,34,0
38,1,1.5,74,29,45,0,0.348516266909428,21,0
38,1,1.5,40,55,-15,0,0.37654288628255,-5,0
38,1,1.5,14,84,-70,0,0.355222069687443,-34,0
38,1,1.5,13,57,-44,0,0.65461450064322,-7,0
38,1,1.5,100,4,96,0,0.48599805359845,46,0
38,1,1.5,2,51,-49,0,0.268106382311089,-1,0
38,1,1.5,30,51,-21,0,0.218774341716198,-1,0
38,1,1.5,40,75,-35,0,0.387464833387639,-25,0
38,1,1.5,85,16,69,0,0.429541234974749,34,0
38,1,1.5,2,54,-52,0,0.413540633831872,-4,0
38,1,1.5,78,26,52,0,0.422897746961098,24,0
38,1,1.5,37,90,-53,0,0.439638794254279,-40,0
38,1,1.5,63,15,48,0,0.391672546858899,35,0
38,1,1.5,96,9,87,0,0.474406405963236,41,0
38,1,1.5,100,7,93,0,0.449142163823126,43,0
38,1,1.5,27,66,-39,0,0.489186737220734,-16,0
38,1,1.5,98,13,85,0,0.471257310506189,37,0
38,1,1.5,93,8,85,0,0.597908789495705,42,0
38,1,1.5,23,100,-77,0,0.495959620020585,-50,0
38,1,10,10,85,-75,0,3.22811166074825,-35,0
38,1,10,98,5,93,0,3.23683756188257,45,0
38,1,10,77,17,60,0,3.8929230577487,33,0
38,1,10,93,11,82,1,3.32308780701715,-39,0
38,1,10,19,100,-81,0,4.13514498263248,-50,0
38,1,10,33,51,-18,0,3.72329674477805,-1,0
38,1,10,27,71,-44,0,2.93604451476131,-21,0
38,1,10,5,59,-54,0,3.14818636517157,-9,0
38,1,10,98,7,91,1,3.40754521943745,-43,0
38,1,10,82,46,36,1,2.91172049258603,-4,0
38,1,10,16,81,-65,0,3.22778909016051,-31,0
38,1,10,75,14,61,0,3.46851619359222,36,0
38,1,10,75,0,75,0,3.14731652423507,50,0
38,1,10,99,3,96,0,3.35147548557143,47,0
38,1,10,53,40,13,1,2.86623510631034,-10,0
38,1,10,51,38,13,0,2.42495523416437,12,0
38,1,10,36,99,-63,0,3.10502861897112,-49,0
38,1,10,65,17,48,0,2.51049362466438,33,0
38,1,10,18,61,-43,0,2.89919558959082,-11,0
38,1,10,82,13,69,0,3.15262867545243,37,0
38,1,1.5,30,55,-25,0,0.693475826439681,-5,0
38,1,1.5,75,46,29,0,0.354847814509412,4,0
38,1,1.5,43,95,-52,0,0.653565046552103,-45,0
38,1,1.5,53,23,30,0,0.78023595304694,27,0
38,1,1.5,84,34,50,0,0.7343143633625,16,0
38,1,1.5,97,4,93,0,0.642391641013091,46,0
38,1,1.5,49,66,-17,1,0.545782114553731,16,0
38,1,1.5,100,2,98,0,0.349144546460593,48,0
38,1,1.5,41,86,-45,0,0.544559645320987,-36,0
38,1,1.5,6,63,-57,0,0.451873750280356,-13,0
38,1,1.5,2,93,-91,0,0.441948839550605,-43,0
38,1,1.5,38,95,-57,0,0.481299886188935,-45,0
38,1,1.5,51,6,45,0,0.775363304303028,44,0
38,1,1.5,42,86,-44,0,0.394062501727603,-36,0
38,1,1.5,100,5,95,0,0.539465962385293,45,0
38,1,1.5,85,46,39,0,0.414845945022535,4,0
38,1,1.5,62,4,58,0,0.511563605978154,46,0
38,1,1.5,68,22,46,0,0.740258826263016,28,0
38,1,1.5,97,6,91,0,0.471630099491449,44,0
38,1,1.5,43,53,-10,0,0.445746375218732,-3,0
38,1,10,11,68,-57,0,1.89713846895029,-18,0
38,1,10,20,62,-42,0,2.09338492018287,-12,0
38,1,10,97,22,75,0,2.22679608588805,28,0
38,1,10,74,29,45,0,2.59487515967339,21,0
38,1,10,82,14,68,0,2.58828922119574,36,0
38,1,10,30,85,-55,0,2.49373021736392,-35,0
38,1,10,20,73,-53,0,2.44248951185727,-23,0
38,1,10,100,0,100,0,2.46585205371957,50,0
38,1,10,54,44,10,1,1.93593454748043,-6,0
38,1,10,94,8,86,0,2.22734445589595,42,0
38,1,10,48,72,-24,0,2.69880080717849,-22,0
38,1,10,94,7,87,0,2.8562075595255,43,0
38,1,10,100,6,94,0,2.75093224734883,44,0
38,1,10,54,44,10,1,2.28239479340846,-6,0
38,1,10,14,95,-81,0,2.18449461800628,-45,0
38,1,10,5,55,-50,0,1.98586590960622,-5,0
38,1,10,43,82,-39,0,2.10727341705933,-32,0
38,1,10,66,46,20,1,2.03202612820314,-4,0
38,1,10,88,33,55,1,1.84693475460517,-17,0
38,1,10,99,7,92,0,1.0623627929599,43,0
38,1,1.5,94,46,48,0,0.361303625046276,4,0
38,1,1.5,31,72,-41,0,0.668653652654029,-22,0
38,1,1.5,29,94,-65,0,0.426757597364485,-44,0
38,1,1.5,11,85,-74,0,0.434778974973597,-35,0
38,1,1.5,51,2,49,0,0.642183436342748,48,0
38,1,1.5,99,6,93,0,0.521515275351703,44,0
38,1,1.5,36,62,-26,0,0.349566087592393,-12,0
38,1,1.5,94,7,87,0,0.416290181572549,43,0
38,1,1.5,97,6,91,0,0.360332614276558,44,0
38,1,1.5,50,82,-32,0,0.22642806218937,-32,0
38,1,1.5,25,55,-30,0,0.369102868862683,-5,0
38,1,1.5,23,63,-40,0,0.371168053767178,-13,0
38,1,1.5,51,2,49,0,0.365185102360556,48,0
38,1,1.5,3,85,-82,0,0.312584468571004,-35,0
38,1,1.5,7,54,-47,0,0.165262079448439,-4,0
38,1,1.5,19,94,-75,0,0.239973461255431,-44,0
38,1,1.5,90,11,79,0,0.295381558855297,39,0
38,1,1.5,6,74,-68,0,0.372737286408665,-24,0
38,1,1.5,81,5,76,0,0.262752810114762,45,0
38,1,1.5,37,95,-58,0,0.285549753753003,-45,0
38,1,10,15,65,-50,0,1.32221576673328,-15,0
38,1,10,100,12,88,0,1.63827373413369,38,0
38,1,10,53,40,13,0,2.09387977281585,10,0
38,1,10,95,10,85,0,2.62791445280891,40,0
38,1,10,52,29,23,0,2.76401505083777,21,0
38,1,10,98,7,91,0,3.07878053653985,43,0
38,1,10,24,77,-53,0,2.93351783393882,-27,0
38,1,10,41,64,-23,0,3.57698422152316,-14,0
38,1,10,62,32,30,1,3.28303187031997,-18,0
38,1,10,52,28,24,0,2.72848463300033,22,0
38,1,10,41,67,-26,0,2.95590240039746,-17,0
38,1,10,89,26,63,0,3.22271630098112,24,0
38,1,10,91,13,78,0,3.16677926093689,37,0
38,1,10,14,59,-45,0,2.99287595512578,-9,0
38,1,10,30,51,-21,0,2.46629742108053,-1,0
38,1,10,19,77,-58,0,2.96040702544269,-27,0
38,1,10,98,3,95,0,3.691108598141,47,0
38,1,10,29,88,-59,0,3.54456257779384,-38,0
38,1,10,82,0,82,0,2.45136533502955,50,0
38,1,10,93,10,83,0,3.21012651731144,40,0
38,1,1.5,73,10,63,0,0.334262678778032,40,0
38,1,1.5,35,93,-58,0,0.361354210006539,-43,0
38,1,1.5,67,32,35,0,0.372330407612026,18,0
38,1,1.5,2,53,-51,0,0.429736976657296,-3,0
38,1,1.5,97,14,83,0,0.453750158078037,36,0
38,1,1.5,1,53,-52,0,0.420481399953132,-3,0
38,1,1.5,89,14,75,0,0.324539008142892,36,0
38,1,1.5,16,78,-62,0,0.400613250676543,-28,0
38,1,1.5,65,3,62,0,0.489290472993162,47,0
38,1,1.5,37,74,-37,0,0.47000515012769,-24,0
38,1,1.5,94,8,86,0,0.370720487087965,42,0
38,1,1.5,86,44,42,0,0.348777622421039,6,0
38,1,1.5,94,15,79,0,0.640136212779908,35,0
38,1,1.5,43,80,-37,0,0.68685029973858,-30,0
38,1,1.5,45,81,-36,0,0.436237140704179,-31,0
38,1,1.5,48,99,-51,0,0.346934571309248,-49,0
38,1,1.5,75,49,26,0,0.33431399683468,1,0
38,1,1.5,16,50,-34,0,0.425093426340027,0,0
38,1,1.5,88,28,60,0,0.825083529285621,22,0
38,1,1.5,92,21,71,0,0.480458270176314,29,0
39,1,10,80,45,35,1,0.812672579209902,-5,0
39,1,10,53,0,53,0,1.61854737463,50,0
39,1,10,25,55,-30,0,0.731200709662517,-5,0
39,1,10,30,100,-70,0,1.32642521613161,-50,0
39,1,10,85,15,70,0,1.09907132999797,35,0
39,1,10,3,100,-97,0,1.5035733726254,-50,0
39,1,10,100,0,100,1,1.65293107461184,-50,0
39,1,10,50,43,7,0,1.38820458964619,7,0
39,1,10,100,0,100,1,1.70219548806199,-50,0
39,1,10,85,15,70,0,1.22609586543695,35,0
39,1,10,5,83,-78,0,1.84128815162694,-33,0
39,1,10,50,43,7,0,1.88129262361326,7,0
39,1,10,75,0,75,1,1.79844983403746,-50,0
39,1,10,5,83,-78,0,1.48636172860279,-33,0
39,1,10,25,55,-30,0,2.06694488278299,-5,0
39,1,10,30,100,-70,0,1.9041836886172,-50,0
39,1,10,48,100,-52,0,1.61349623088608,-50,0
39,1,10,0,68,-68,0,1.52534680793178,-18,0
39,1,10,53,40,13,0,1.32201591219928,10,0
39,1,10,50,100,-50,0,1.97318788386474,-50,0
39,1,1.5,75,0,75,0,0.750526649557287,50,0
39,1,1.5,48,60,-12,0,0.721161103254417,-10,0
39,1,1.5,53,40,13,0,0.629814944128157,10,0
39,1,1.5,100,15,85,1,0.542453983449377,-35,0
39,1,1.5,98,38,60,1,0.586369609562098,-12,0
39,1,1.5,0,68,-68,0,0.388375404814724,-18,0
39,1,1.5,53,0,53,0,0.366400363622233,50,0
39,1,1.5,98,38,60,0,0.40104725092533,12,0
39,1,1.5,53,23,30,1,0.578358524900977,-27,0
39,1,1.5,28,85,-57,0,0.452998520951951,-35,0
39,1,1.5,28,85,-57,0,0.340301932301372,-35,0
39,1,1.5,80,45,35,1,0.536236091473256,-5,0
39,1,1.5,48,80,-32,0,0.332220468859305,-30,0
39,1,1.5,50,100,-50,0,0.544220784096979,-50,0
39,1,1.5,53,23,30,0,0.43622747741756,27,0
39,1,1.5,48,100,-52,0,0.220211906111217,-50,0
39,1,1.5,100,15,85,0,0.204859801437124,35,0
39,1,1.5,48,80,-32,0,0.558175210171612,-30,0
39,1,1.5,3,100,-97,0,0.233487103643711,-50,0
39,1,1.5,48,60,-12,0,0.241402150582871,-10,0
39,1,10,98,38,60,1,0.87801341227896,-12,0
39,1,10,1,73,-72,1,0.61268504212785,23,0
39,1,10,11,58,-47,0,0.444598520203726,-8,0
39,1,10,53,40,13,0,1.30053242279973,10,0
39,1,10,14,60,-46,0,1.35239461968013,-10,0
39,1,10,75,0,75,1,2.22625458423863,-50,0
39,1,10,60,26,34,0,1.51495897320274,24,0
39,1,10,70,2,68,0,1.1908316975896,48,0
39,1,10,64,47,17,0,1.38345842061972,3,0
39,1,10,52,43,9,0,1.64798769836489,7,0
39,1,10,53,0,53,0,1.87064123500022,50,0
39,1,10,38,66,-28,0,1.301242442074,-16,0
39,1,10,77,29,48,1,1.36116447558743,-21,0
39,1,10,78,31,47,0,1.48303596465848,19,0
39,1,10,53,23,30,0,1.81627912516706,27,0
39,1,10,98,38,60,1,1.95145367004443,-12,0
39,1,10,87,40,47,1,2.19479270334705,-10,0
39,1,10,75,39,36,1,1.68470636103302,-11,0
39,1,10,4,75,-71,0,1.83474622401991,-25,0
39,1,10,45,67,-22,0,1.58590335014742,-17,0
39,1,1.5,57,3,54,0,0.539223157553351,47,0
39,1,1.5,97,42,55,1,0.53522146405885,-8,0
39,1,1.5,70,2,68,1,0.851207527593942,-48,0
39,1,1.5,38,97,-59,0,0.346482435546932,-47,0
39,1,1.5,53,23,30,0,0.518502104940126,27,0
39,1,1.5,37,58,-21,0,0.323119246211718,-8,0
39,1,1.5,52,43,9,0,0.928396921663079,7,0
39,1,1.5,53,42,11,0,0.229085863946239,8,0
39,1,1.5,39,67,-28,0,0.277772218338214,-17,0
39,1,1.5,58,16,42,0,0.292394876276376,34,0
39,1,1.5,78,38,40,0,0.297039509256138,12,0
39,1,1.5,58,16,42,0,0.455018611886771,34,0
39,1,1.5,75,0,75,1,0.630252978735371,-50,0
39,1,1.5,85,15,70,0,0.542939670354826,35,0
39,1,1.5,49,93,-44,0,0.426940044242656,-43,0
39,1,1.5,10,68,-58,0,0.435602499172091,-18,0
39,1,1.5,81,29,52,0,0.363599508069456,21,0
39,1,1.5,65,2,63,0,0.246895361051429,48,0
39,1,1.5,40,72,-32,0,0.286874540659483,-22,0
39,1,1.5,76,45,31,0,0.388725832497585,5,0
39,1,10,65,2,63,0,1.09347218480252,48,0
39,1,10,53,42,11,0,1.40998498951376,8,0
39,1,10,56,47,9,0,1.6339167074475,3,0
39,1,10,5,98,-93,0,0.951867145384313,-48,0
39,1,10,45,66,-21,0,2.29765569014126,-16,0
39,1,10,33,96,-63,0,1.98364536424924,-46,0
39,1,10,87,31,56,1,1.96162633632775,-19,0
39,1,10,43,60,-17,0,1.36493523868558,-10,0
39,1,10,13,89,-76,0,1.65480747555557,-39,0
39,1,10,48,64,-16,0,2.2286903498607,-14,0
39,1,10,54,47,7,0,2.82801551999,3,0
39,1,10,85,15,70,1,2.39596898201853,-35,0
39,1,10,60,26,34,0,2.43651888954628,24,0
39,1,10,62,37,25,0,3.98703417586512,13,0
39,1,10,76,38,38,1,2.92501617429662,-12,0
39,1,10,59,15,44,0,2.47295200497319,35,0
39,1,10,55,3,52,0,3.11155183379014,47,0
39,1,10,3,67,-64,0,2.39691762933217,-17,0
39,1,10,48,96,-48,0,2.23087062584818,-46,0
39,1,10,25,61,-36,0,1.72683575902192,-11,0
39,1,1.5,7,57,-50,0,0.446679459477309,-7,0
39,1,1.5,28,93,-65,0,0.44599839815055,-43,0
39,1,1.5,85,15,70,1,0.701271400001133,-35,0
39,1,1.5,95,50,45,0,0.577939551236341,0,0
39,1,1.5,34,85,-51,0,0.324596100937924,-35,0
39,1,1.5,51,4,47,0,0.577204239583807,46,0
39,1,1.5,0,96,-96,0,0.491935581434518,-46,0
39,1,1.5,55,48,7,0,0.617853117291816,2,0
39,1,1.5,34,72,-38,0,0.513180442765588,-22,0
39,1,1.5,59,15,44,0,0.565761089703301,35,0
39,1,1.5,23,78,-55,0,0.343778350827051,-28,0
39,1,1.5,86,19,67,0,0.427121122978861,31,0
39,1,1.5,60,46,14,0,0.491103498963639,4,0
39,1,1.5,20,57,-37,0,0.384430160978809,-7,0
39,1,1.5,75,0,75,0,0.833681744945352,50,0
39,1,1.5,17,50,-33,0,0.449034582750755,0,0
39,1,1.5,55,46,9,0,0.383624103997136,4,0
39,1,1.5,99,21,78,0,0.712950612054556,29,0
39,1,1.5,92,17,75,0,0.277638791900245,33,0
39,1,1.5,58,50,8,0,0.579648069440736,0,0
39,1,10,14,89,-75,0,1.40555919056351,-39,0
39,1,10,11,87,-76,0,1.62210663485166,-37,0
39,1,10,55,46,9,0,1.99802316268324,4,0
39,1,10,52,43,9,1,2.58345365538844,-7,0
39,1,10,42,82,-40,0,2.47206677186477,-32,0
39,1,10,38,95,-57,0,2.85327893639624,-45,0
39,1,10,76,45,31,1,2.76397412846563,-5,0
39,1,10,79,32,47,0,3.59863274556119,18,0
39,1,10,81,8,73,0,2.5279116013262,42,0
39,1,10,32,75,-43,0,2.09979967707477,-25,0
39,1,10,21,65,-44,0,2.07987185196544,-15,0
39,1,10,88,18,70,0,5.36434435017873,32,0
39,1,10,16,84,-68,0,3.41498848097399,-34,0
39,1,10,35,63,-28,0,5.14340483010164,-13,0
39,1,10,84,11,73,0,5.26687853613112,39,0
39,1,10,53,49,4,0,1.22553100240475,1,0
39,1,10,96,40,56,1,3.05604753500666,-10,0
39,1,10,78,38,40,0,2.80668415139371,12,0
39,1,10,64,47,17,1,2.24733412875503,-3,0
39,1,10,25,70,-45,0,1.99123417622468,-20,0
39,1,1.5,68,17,51,0,0.541842201244435,33,0
39,1,1.5,71,39,32,1,0.593125239407527,-11,0
39,1,1.5,56,47,9,0,0.266423273380497,3,0
39,1,1.5,22,51,-29,0,0.248425366415177,-1,0
39,1,1.5,76,45,31,0,0.191779978340492,5,0
39,1,1.5,18,62,-44,0,0.49705930329219,-12,0
39,1,1.5,53,42,11,0,0.318409366242122,8,0
39,1,1.5,74,40,34,0,0.282375063921791,10,0
39,1,1.5,98,14,84,1,0.511592521521379,-36,0
39,1,1.5,97,29,68,0,0.276268605011865,21,0
39,1,1.5,70,2,68,0,0.577581059304066,48,0
39,1,1.5,46,57,-11,0,0.29960540230968,-7,0
39,1,1.5,70,33,37,0,0.248260416148696,17,0
39,1,1.5,84,36,48,0,0.551586729940027,14,0
39,1,1.5,1,73,-72,0,0.370225010483409,-23,0
39,1,1.5,52,43,9,0,0.388213753554737,7,0
39,1,1.5,32,60,-28,0,0.365503767287009,-10,0
39,1,1.5,61,20,41,0,0.247417336999206,30,0
39,1,1.5,64,50,14,0,0.35078507164144,0,0
39,1,1.5,1,71,-70,0,0.417457603194634,-21,0
39,1,10,20,78,-58,0,0.950737052771728,-28,0
39,1,10,18,56,-38,0,2.55184845102485,-6,0
39,1,10,68,17,51,0,2.25055139209144,33,0
39,1,10,78,38,40,1,2.26517075102311,-12,0
39,1,10,6,98,-92,0,1.77578933285258,-48,0
39,1,10,44,64,-20,0,1.5378482054366,-14,0
39,1,10,29,82,-53,0,2.48363711673301,-32,0
39,1,10,53,0,53,0,1.54499971591576,50,0
39,1,10,4,96,-92,0,1.71633062631008,-46,0
39,1,10,81,20,61,0,2.08098141744267,30,0
39,1,10,100,26,74,0,2.63752545275202,24,0
39,1,10,31,85,-54,0,1.74086862811237,-35,0
39,1,10,81,40,41,1,1.90415949591261,-10,0
39,1,10,53,23,30,0,1.93278973056294,27,0
39,1,10,15,77,-62,0,1.2000667132088,-27,0
39,1,10,71,46,25,0,1.03932780933974,4,0
39,1,10,99,21,78,0,2.2058997212298,29,0
39,1,10,68,16,52,0,2.29238168026495,34,0
39,1,10,53,0,53,0,1.89037368565914,50,0
39,1,10,27,68,-41,0,1.77572591863282,-18,0
39,1,1.5,83,3,80,0,0.484892571548698,47,0
39,1,1.5,26,68,-42,0,0.289593654189957,-18,0
39,1,1.5,53,42,11,0,0.486855846291292,8,0
39,1,1.5,60,49,11,0,0.260195117836702,1,0
39,1,1.5,41,59,-18,0,0.394834857288515,-9,0
39,1,1.5,70,33,37,1,0.579477987383143,-17,0
39,1,1.5,16,58,-42,0,0.317384841793682,-8,0
39,1,1.5,52,43,9,0,0.264763507133466,7,0
39,1,1.5,14,70,-56,0,0.27141173601558,-20,0
39,1,1.5,85,25,60,0,0.245408242742997,25,0
39,1,1.5,70,34,36,1,0.572070254158461,-16,0
39,1,1.5,62,37,25,0,0.630026080470998,13,0
39,1,1.5,16,89,-73,0,0.38198559799639,-39,0
39,1,1.5,70,2,68,0,0.215939327623346,48,0
39,1,1.5,68,16,52,0,0.383927612492698,34,0
39,1,1.5,2,73,-71,0,0.345888614581781,-23,0
39,1,1.5,70,40,30,1,0.765224818038405,-10,0
39,1,1.5,50,74,-24,0,0.462592028503423,-24,0
39,1,1.5,97,15,82,0,0.229190332451253,35,0
39,1,1.5,28,76,-48,0,0.244531440432183,-26,0
40,1,10,100,0,100,0,0.989537831075722,50,0
40,1,10,75,0,75,0,5.35730421921471,50,0
40,1,10,53,40,13,1,4.60067812391208,-10,0
40,1,10,80,45,35,0,6.51388412878441,5,0
40,1,10,50,100,-50,0,5.84713254390226,-50,0
40,1,10,5,83,-78,0,7.37504687302862,-33,0
40,1,10,85,15,70,0,6.27362262955285,35,0
40,1,10,53,0,53,0,7.80018767538422,50,0
40,1,10,5,83,-78,0,7.45740813712473,-33,0
40,1,10,48,80,-32,0,6.6726714233082,-30,0
40,1,10,53,23,30,0,6.69525918079307,27,0
40,1,10,28,85,-57,0,8.21311674910248,-35,0
40,1,10,50,43,7,1,6.68637172553281,-7,0
40,1,10,3,100,-97,0,6.83630125562195,-50,0
40,1,10,48,60,-12,0,7.21218606986804,-10,0
40,1,10,98,38,60,0,6.9494200207846,12,0
40,1,10,53,0,53,0,6.68067181918013,50,0
40,1,10,0,68,-68,0,6.11129809409613,-18,0
40,1,10,50,43,7,1,5.94851243442099,-7,0
40,1,10,30,100,-70,0,8.43971496802988,-50,0
40,1,1.5,48,100,-52,0,0.961746847184259,-50,0
40,1,1.5,80,45,35,0,0.637052323669195,5,0
40,1,1.5,25,55,-30,0,0.749012413332821,-5,0
40,1,1.5,48,100,-52,0,0.648327508184593,-50,0
40,1,1.5,30,100,-70,0,0.728294078508043,-50,0
40,1,1.5,85,15,70,0,1.21292724098021,35,0
40,1,1.5,48,60,-12,0,1.00622004570323,-10,0
40,1,1.5,98,38,60,NaN,NaN,0,0
40,1,1.5,100,15,85,0,0.862819199333899,35,0
40,1,1.5,100,15,85,0,0.486136398205417,35,0
40,1,1.5,28,85,-57,0,0.604106131897424,-35,0
40,1,1.5,3,100,-97,0,0.509368923230795,-50,0
40,1,1.5,50,100,-50,0,0.994709900420276,-50,0
40,1,1.5,48,80,-32,0,0.676665023289388,-30,0
40,1,1.5,0,68,-68,0,0.595307749128551,-18,0
40,1,1.5,53,40,13,1,1.07731602223066,-10,0
40,1,1.5,53,23,30,0,0.715946725118556,27,0
40,1,1.5,100,0,100,0,0.496541384796728,50,0
40,1,1.5,75,0,75,0,0.550514915972599,50,0
40,1,1.5,25,55,-30,0,0.673846593708731,-5,0
40,1,10,92,18,74,0,5.05360734426358,32,0
40,1,10,75,16,59,0,5.16487684719323,34,0
40,1,10,93,19,74,0,4.3201151710964,31,0
40,1,10,24,56,-32,0,4.06873903775704,-6,0
40,1,10,79,15,64,0,5.68336378781532,35,0
40,1,10,99,41,58,0,4.84127282023837,9,0
40,1,10,68,5,63,0,6.50517628471425,45,0
40,1,10,37,97,-60,0,5.19041682626994,-47,0
40,1,10,26,71,-45,0,5.05637628912518,-21,0
40,1,10,17,98,-81,0,4.20763274274941,-48,0
40,1,10,2,82,-80,0,5.49490325737861,-32,0
40,1,10,51,35,16,0,5.02082866740238,15,0
40,1,10,1,90,-89,0,4.69335017034609,-40,0
40,1,10,95,22,73,0,5.02733719069511,28,0
40,1,10,34,94,-60,0,4.70066804367525,-44,0
40,1,10,78,23,55,0,5.40985405673564,27,0
40,1,10,39,84,-45,0,4.90712341670587,-34,0
40,1,10,70,41,29,0,5.4403476393054,9,0
40,1,10,74,36,38,0,4.98432287495234,14,0
40,1,10,99,1,98,0,5.02625255900784,49,0
40,1,1.5,26,66,-40,0,0.910871792424587,-16,0
40,1,1.5,81,26,55,0,0.684191465537879,24,0
40,1,1.5,99,43,56,0,0.474181623576442,7,0
40,1,1.5,56,49,7,0,0.600822179418174,1,0
40,1,1.5,75,27,48,0,0.594110218953574,23,0
40,1,1.5,91,32,59,0,0.54010919627035,18,0
40,1,1.5,82,38,44,0,0.680071038063033,12,0
40,1,1.5,50,26,24,0,0.814688163809478,24,0
40,1,1.5,41,85,-44,0,0.575379703572253,-35,0
40,1,1.5,68,42,26,0,0.545996411441592,8,0
40,1,1.5,100,22,78,0,0.508627385584987,28,0
40,1,1.5,12,80,-68,0,0.593904215915245,-30,0
40,1,1.5,97,35,62,0,0.451922297987039,15,0
40,1,1.5,45,52,-7,1,0.651169397184276,2,0
40,1,1.5,53,27,26,0,0.762489117943915,23,0
40,1,1.5,69,40,29,0,0.845847774020513,10,0
40,1,1.5,62,24,38,0,0.477807570438017,26,0
40,1,1.5,9,81,-72,0,0.532470955222379,-31,0
40,1,1.5,85,40,45,0,0.512441374361515,10,0
40,1,1.5,24,71,-47,0,0.525723072525579,-21,0
40,1,10,23,64,-41,0,1.09264785393316,-14,0
40,1,10,95,21,74,0,5.58509446999233,29,0
40,1,10,83,37,46,0,5.16300265934842,13,0
40,1,10,99,16,83,0,5.1342846617481,34,0
40,1,10,90,29,61,0,6.41012603940908,21,0
40,1,10,99,2,97,0,3.77952652289241,48,0
40,1,10,15,60,-45,0,3.91811085675727,-10,0
40,1,10,43,76,-33,0,4.1626826581778,-26,0
40,1,10,98,8,90,0,3.88598464507959,42,0
40,1,10,81,33,48,0,4.49189275378012,17,0
40,1,10,39,59,-20,1,4.50385082740104,9,0
40,1,10,15,62,-47,0,4.42909224866889,-12,0
40,1,10,97,26,71,0,3.86103518363961,24,0
40,1,10,80,39,41,0,4.9076453888556,11,0
40,1,10,61,29,32,0,3.94426188046054,21,0
40,1,10,29,66,-37,0,4.29217463340319,-16,0
40,1,10,42,100,-58,0,3.98546322276525,-50,0
40,1,10,47,58,-11,1,2.69007244928798,8,0
40,1,10,86,28,58,0,5.26326199591858,22,0
40,1,10,63,45,18,0,3.31863246233843,5,0
40,1,1.5,97,37,60,0,0.661242286339984,13,0
40,1,1.5,56,49,7,1,0.620532858767547,-1,0
40,1,1.5,98,3,95,0,0.396497581663425,47,0
40,1,1.5,70,34,36,0,0.558508347341558,16,0
40,1,1.5,31,80,-49,0,0.697123838253901,-30,0
40,1,1.5,77,30,47,0,0.877792175189825,20,0
40,1,1.5,56,33,23,1,0.939740443485789,-17,0
40,1,1.5,35,93,-58,0,0.879719146731077,-43,0
40,1,1.5,14,79,-65,0,0.597651125412085,-29,0
40,1,1.5,86,40,46,0,0.662978650099831,10,0
40,1,1.5,75,8,67,0,0.492953559514717,42,0
40,1,1.5,73,4,69,0,0.482285020974814,46,0
40,1,1.5,7,79,-72,0,0.583594533221913,-29,0
40,1,1.5,49,90,-41,0,0.600895490104449,-40,0
40,1,1.5,73,42,31,0,0.881531753606396,8,0
40,1,1.5,24,67,-43,0,0.639484039347735,-17,0
40,1,1.5,19,63,-44,0,0.894770198472543,-13,0
40,1,1.5,43,99,-56,0,0.652113638905575,-49,0
40,1,1.5,74,27,47,0,0.570720075949794,23,0
40,1,1.5,93,46,47,0,0.540733070272836,4,0
40,1,10,7,94,-87,0,3.76655896104057,-44,0
40,1,10,95,7,88,0,5.24847449612571,43,0
40,1,10,98,26,72,0,4.27909234030813,24,0
40,1,10,17,88,-71,0,4.62099398302962,-38,0
40,1,10,95,9,86,0,4.41294960073719,41,0
40,1,10,100,12,88,0,4.4615270983777,38,0
40,1,10,13,86,-73,0,4.61215564594022,-36,0
40,1,10,67,41,26,0,4.21275752672227,9,0
40,1,10,24,87,-63,0,4.65335112340108,-37,0
40,1,10,15,83,-68,0,3.58796678291401,-33,0
40,1,10,20,65,-45,0,3.2845818449714,-15,0
40,1,10,65,18,47,0,4.18584627115342,32,0
40,1,10,76,38,38,0,3.28319480667415,12,0
40,1,10,0,59,-59,0,4.5524063318444,-9,0
40,1,10,70,12,58,0,4.41098707349738,38,0
40,1,10,90,23,67,0,3.8436026340496,27,0
40,1,10,52,35,17,0,3.53088194596057,15,0
40,1,10,90,20,70,0,3.55083271783951,30,0
40,1,10,69,40,29,0,3.68140859164123,10,0
40,1,10,69,18,51,0,4.28736508541624,32,0
40,1,1.5,21,68,-47,0,0.585961735487217,-18,0
40,1,1.5,75,23,52,0,0.563263278847444,27,0
40,1,1.5,32,63,-31,0,0.549919266602956,-13,0
40,1,1.5,47,75,-28,0,0.680556721388712,-25,0
40,1,1.5,18,63,-45,0,0.590511030502967,-13,0
40,1,1.5,85,32,53,0,0.527809861378046,18,0
40,1,1.5,73,32,41,0,0.531812991757761,18,0
40,1,1.5,64,34,30,0,0.703116254269844,16,0
40,1,1.5,34,84,-50,0,0.459737950921408,-34,0
40,1,1.5,98,39,59,0,0.64242159879359,11,0
40,1,1.5,36,52,-16,0,1.17702479549916,-2,0
40,1,1.5,20,69,-49,0,0.619002131512389,-19,0
40,1,1.5,81,39,42,0,0.546960447056335,11,0
40,1,1.5,9,69,-60,0,0.550269325147383,-19,0
40,1,1.5,65,21,44,0,0.568882543433574,29,0
40,1,1.5,34,71,-37,0,0.546900698827812,-21,0
40,1,1.5,39,55,-16,1,0.838199636011268,5,0
40,1,1.5,20,85,-65,0,0.733456984031363,-35,0
40,1,1.5,89,30,59,0,1.12876619937015,20,0
40,1,1.5,99,31,68,0,0.524802656786051,19,0
40,1,10,48,99,-51,0,4.77980840251257,-49,0
40,1,10,27,92,-65,0,4.70170722274634,-42,0
40,1,10,65,42,23,0,4.44238714277162,8,0
40,1,10,43,95,-52,0,4.59365789199364,-45,0
40,1,10,6,53,-47,0,4.2188917989115,-3,0
40,1,10,90,6,84,0,3.88285867715604,44,0
40,1,10,96,9,87,0,3.77613480370201,41,0
40,1,10,36,86,-50,0,3.69805708336935,-36,0
40,1,10,66,41,25,0,3.65533967592637,9,0
40,1,10,99,12,87,0,3.62991626086296,38,0
40,1,10,72,6,66,0,4.57321813779708,44,0
40,1,10,93,41,52,0,4.47113813017495,9,0
40,1,10,74,39,35,0,3.47709938912885,11,0
40,1,10,91,32,59,0,4.20299144281307,18,0
40,1,10,16,77,-61,0,3.80297604756197,-27,0
40,1,10,41,56,-15,1,3.03561543409887,6,0
40,1,10,26,65,-39,0,4.0348607005144,-15,0
40,1,10,38,96,-58,0,4.29009920770477,-46,0
40,1,10,13,71,-58,0,5.45468464489386,-21,0
40,1,10,76,43,33,0,4.38929004092643,7,0
40,1,1.5,96,25,71,0,0.673885814932873,25,0
40,1,1.5,79,28,51,0,0.599906162315165,22,0
40,1,1.5,83,12,71,0,0.535861941301846,38,0
40,1,1.5,37,53,-16,1,0.811124164480134,3,0
40,1,1.5,62,17,45,0,0.636445311130956,33,0
40,1,1.5,25,63,-38,0,0.707800807518652,-13,0
40,1,1.5,90,43,47,0,0.520407680756762,7,0
40,1,1.5,11,91,-80,0,0.676413201057585,-41,0
40,1,1.5,92,42,50,0,0.514370911783772,8,0
40,1,1.5,62,43,19,0,0.494320437370334,7,0
40,1,1.5,2,69,-67,0,0.474968613867532,-19,0
40,1,1.5,93,47,46,0,0.608914946773439,3,0
40,1,1.5,16,78,-62,0,0.449582220680895,-28,0
40,1,1.5,68,42,26,0,0.472241456096526,8,0
40,1,1.5,91,20,71,0,0.486215207216446,30,0
40,1,1.5,86,45,41,0,0.595467566425214,5,0
40,1,1.5,1,75,-74,0,0.476184471684974,-25,0
40,1,1.5,12,56,-44,0,0.506105131207732,-6,0
40,1,1.5,42,78,-36,0,0.782090930908453,-28,0
40,1,1.5,6,52,-46,0,0.440097649843665,-2,0
41,1,10,3,100,-97,NaN,NaN,0,0
41,1,10,30,100,-70,1,1.196898557042,50,0
41,1,10,25,55,-30,0,1.19822036338155,-5,0
41,1,10,98,38,60,1,1.84653337416239,-12,0
41,1,10,80,45,35,1,2.23858090932481,-5,0
41,1,10,50,43,7,0,1.91859637803282,7,0
41,1,10,50,43,7,0,2.23423060498317,7,0
41,1,10,100,0,100,0,4.13826438691467,50,0
41,1,10,48,80,-32,1,3.32642054776079,30,0
41,1,10,50,100,-50,1,3.46715333283646,50,0
41,1,10,75,0,75,0,3.0578534026572,50,0
41,1,10,53,40,13,0,2.89735657061101,10,0
41,1,10,53,0,53,0,2.1914716733736,50,0
41,1,10,53,0,53,0,2.32956157892477,50,0
41,1,10,48,80,-32,1,2.99024920412921,30,0
41,1,10,48,100,-52,1,2.10441096959403,50,0
41,1,10,100,0,100,0,2.76580531764193,50,0
41,1,10,50,100,-50,1,2.28920249917428,50,0
41,1,10,98,38,60,1,3.05525854218286,-12,0
41,1,10,5,83,-78,0,2.09476134355646,-33,0
41,1,1.5,75,0,75,0,0.802883341239067,50,0
41,1,1.5,0,68,-68,0,0.612295804545283,-18,0
41,1,1.5,100,15,85,1,1.30092867341591,-35,0
41,1,1.5,0,68,-68,0,0.474352888559224,-18,0
41,1,1.5,48,60,-12,1,1.15309310378507,10,0
41,1,1.5,53,40,13,0,0.86043799953768,10,0
41,1,1.5,48,100,-52,1,0.739877972984686,50,0
41,1,1.5,28,85,-57,1,0.967925119650317,35,0
41,1,1.5,5,83,-78,0,0.666604596248362,-33,0
41,1,1.5,48,60,-12,1,1.14529532621964,10,0
41,1,1.5,53,23,30,0,0.677405212831218,27,0
41,1,1.5,80,45,35,1,0.75611023849342,-5,0
41,1,1.5,30,100,-70,0,0.935541231301613,-50,0
41,1,1.5,25,55,-30,0,0.891574859298998,-5,0
41,1,1.5,3,100,-97,0,0.641620037495159,-50,0
41,1,1.5,85,15,70,0,0.83365620940458,35,0
41,1,1.5,28,85,-57,1,0.905722145747859,35,0
41,1,1.5,53,23,30,0,0.863113502709894,27,0
41,1,1.5,100,15,85,0,0.750524635397596,35,0
41,1,1.5,85,15,70,0,1.48190360638546,35,0
41,1,10,31,93,-62,1,1.48139335835003,43,0
41,1,10,66,42,24,1,2.69497138101724,-8,0
41,1,10,14,55,-41,0,2.56501941836905,-5,0
41,1,10,86,16,70,0,2.89650505757891,34,0
41,1,10,14,70,-56,0,3.18320800122456,-20,0
41,1,10,48,56,-8,1,3.4333431692794,6,0
41,1,10,45,61,-16,1,2.9134832675918,11,0
41,1,10,42,74,-32,1,2.29415542405332,24,0
41,1,10,58,16,42,0,2.78822873919853,34,0
41,1,10,23,52,-29,0,1.98240670654923,-2,0
41,1,10,88,50,38,1,2.67113781280932,0,0
41,1,10,44,82,-38,1,2.47784544836031,32,0
41,1,10,42,97,-55,1,2.14127272428595,47,0
41,1,10,100,49,51,1,2.19337190740043,-1,0
41,1,10,8,71,-63,0,2.25946478938567,-21,0
41,1,10,0,57,-57,0,2.17888408902218,-7,0
41,1,10,81,27,54,0,2.97359906308702,23,0
41,1,10,77,15,62,0,1.93703495309455,35,0
41,1,10,94,8,86,0,2.19712032433017,42,0
41,1,10,40,83,-43,1,2.43920479016379,33,0
41,1,1.5,41,100,-59,1,1.09863292382215,50,0
41,1,1.5,25,91,-66,0,1.37672543196823,-41,0
41,1,1.5,5,55,-50,0,0.732117584324442,-5,0
41,1,1.5,79,31,48,NaN,NaN,0,0
41,1,1.5,45,67,-22,1,0.856242382491473,17,0
41,1,1.5,66,48,18,1,0.631663236301392,-2,0
41,1,1.5,38,69,-31,1,0.584336631756742,19,0
41,1,1.5,46,57,-11,1,0.57036016107304,7,0
41,1,1.5,76,43,33,1,0.669123579369625,-7,0
41,1,1.5,46,80,-34,1,0.715832534537185,30,0
41,1,1.5,49,79,-30,1,0.535841075325152,29,0
41,1,1.5,46,72,-26,1,0.652621894114418,22,0
41,1,1.5,53,23,30,0,0.859946812532144,27,0
41,1,1.5,41,53,-12,0,0.643347622943111,-3,0
41,1,1.5,44,72,-28,1,0.891413573990576,22,0
41,1,1.5,16,91,-75,0,0.993480774981435,-41,0
41,1,1.5,98,28,70,0,0.835541781154461,22,0
41,1,1.5,97,39,58,1,1.04357268926105,-11,0
41,1,1.5,5,83,-78,0,0.667604931659298,-33,0
41,1,1.5,91,36,55,1,0.706304239050951,-14,0
41,1,10,35,91,-56,1,1.45908540239907,41,0
41,1,10,75,17,58,0,2.76137437066063,33,0
41,1,10,21,64,-43,0,2.03678184514865,-14,0
41,1,10,94,20,74,0,1.80488547828281,30,0
41,1,10,46,69,-23,1,2.12629188605933,19,0
41,1,10,5,98,-93,0,1.25721485950635,-48,0
41,1,10,95,36,59,1,2.08740710056736,-14,0
41,1,10,67,3,64,0,2.7329778947751,47,0
41,1,10,19,80,-61,0,3.08978129347088,-30,0
41,1,10,47,73,-26,1,3.30383584089577,23,0
41,1,10,91,5,86,0,2.84532483408111,45,0
41,1,10,43,100,-57,1,2.81336688558804,50,0
41,1,10,84,31,53,1,2.76678879142855,-19,0
41,1,10,28,85,-57,1,2.29755451169331,35,0
41,1,10,11,59,-48,0,2.55959729995811,-9,0
41,1,10,47,81,-34,1,1.97839473476051,31,0
41,1,10,86,31,55,1,2.44584314638632,-19,0
41,1,10,67,39,28,1,2.19724568701349,-11,0
41,1,10,92,17,75,0,2.75814499912667,33,0
41,1,10,45,82,-37,1,3.58489343256224,32,0
41,1,1.5,12,64,-52,0,0.811002589704003,-14,0
41,1,1.5,81,21,60,0,0.764410932955798,29,0
41,1,1.5,97,37,60,1,0.807150803593686,-13,0
41,1,1.5,41,91,-50,1,0.608617766672978,41,0
41,1,1.5,47,100,-53,1,0.673279608221492,50,0
41,1,1.5,35,59,-24,1,0.655289699556306,9,0
41,1,1.5,4,65,-61,0,0.894654675357742,-15,0
41,1,1.5,38,69,-31,1,0.596770628471859,19,0
41,1,1.5,37,86,-49,1,0.902115586592117,36,0
41,1,1.5,18,58,-40,0,0.555540974717587,-8,0
41,1,1.5,5,53,-48,0,0.574969988112571,-3,0
41,1,1.5,63,12,51,0,0.488948108279146,38,0
41,1,1.5,37,69,-32,1,0.918310096632922,19,0
41,1,1.5,9,85,-76,0,0.506354457407724,-35,0
41,1,1.5,45,74,-29,1,0.615741811576299,24,0
41,1,1.5,67,49,18,1,0.767840444867034,-1,0
41,1,1.5,43,75,-32,1,0.705808286758838,25,0
41,1,1.5,97,16,81,0,0.71128942098585,34,0
41,1,1.5,96,8,88,0,0.524650441599078,42,0
41,1,1.5,43,97,-54,1,0.520654231804656,47,0
41,1,10,43,89,-46,1,5.92610640797648,39,0
41,1,10,92,42,50,1,4.9375287060393,-8,0
41,1,10,49,85,-36,1,3.53302811313188,35,0
41,1,10,83,28,55,1,3.0325165821414,-22,0
41,1,10,17,87,-70,0,3.5845257753972,-37,0
41,1,10,87,3,84,0,2.85005342576187,47,0
41,1,10,57,27,30,0,2.60081632353831,23,0
41,1,10,15,54,-39,0,3.03354550900985,-4,0
41,1,10,55,23,32,0,2.73693854847807,27,0
41,1,10,99,9,90,0,2.78901940371725,41,0
41,1,10,44,94,-50,1,2.60580407135421,44,0
41,1,10,97,10,87,0,3.59859131954727,40,0
41,1,10,34,84,-50,1,2.60866285325028,34,0
41,1,10,77,23,54,0,2.84137371086399,27,0
41,1,10,2,58,-56,0,2.92886511966935,-8,0
41,1,10,17,77,-60,0,2.47693601922947,-27,0
41,1,10,61,0,61,0,3.47500499433954,50,0
41,1,10,55,12,43,0,3.61707351493533,38,0
41,1,10,71,26,45,0,2.96992872288683,24,0
41,1,10,23,64,-41,0,3.89193921742844,-14,0
41,1,1.5,33,87,-54,1,0.919519736373331,37,0
41,1,1.5,14,58,-44,0,0.76357994711725,-8,0
41,1,1.5,75,18,57,0,0.750304700894048,32,0
41,1,1.5,83,9,74,0,0.769021493120817,41,0
41,1,1.5,58,21,37,0,0.755699327564798,29,0
41,1,1.5,86,46,40,1,0.606432350905379,-4,0
41,1,1.5,89,8,81,0,0.591193089669105,42,0
41,1,1.5,14,63,-49,0,0.521147251653019,-13,0
41,1,1.5,42,81,-39,1,0.661934287229087,31,0
41,1,1.5,98,8,90,0,0.548654092504876,42,0
41,1,1.5,61,17,44,0,0.591313320503104,33,0
41,1,1.5,66,40,26,1,1.31268050664221,-10,0
41,1,1.5,19,80,-61,0,0.773431546316715,-30,0
41,1,1.5,66,4,62,0,0.519526334421244,46,0
41,1,1.5,37,90,-53,1,0.700238079094561,40,0
41,1,1.5,82,21,61,0,0.84890536768944,29,0
41,1,1.5,14,54,-40,0,0.752336162549909,-4,0
41,1,1.5,58,5,53,0,0.49106351158116,45,0
41,1,1.5,84,38,46,1,0.73638797912281,-12,0
41,1,1.5,84,20,64,1,1.00382429431193,-30,0
41,1,10,91,43,48,1,0.975945397600299,-7,0
41,1,10,82,46,36,1,2.70597836942761,-4,0
41,1,10,39,91,-52,1,2.99073489281,41,0
41,1,10,99,47,52,1,3.10345022240654,-3,0
41,1,10,31,95,-64,1,3.82029372252873,45,0
41,1,10,58,20,38,0,4.23635663843015,30,0
41,1,10,45,74,-29,1,3.42849727923749,24,0
41,1,10,91,11,80,0,2.98054826003499,39,0
41,1,10,46,56,-10,1,3.05462586390786,6,0
41,1,10,42,56,-14,0,3.06145922871656,-6,0
41,1,10,27,58,-31,0,3.53884794644546,-8,0
41,1,10,76,20,56,0,2.88633528648643,30,0
41,1,10,46,73,-27,1,2.30774334375747,23,0
41,1,10,31,68,-37,0,2.18452687509125,-18,0
41,1,10,39,85,-46,1,2.16992102516815,35,0
41,1,10,15,87,-72,0,2.37878035323229,-37,0
41,1,10,12,69,-57,0,3.46083681410528,-19,0
41,1,10,87,18,69,0,3.06698728227639,32,0
41,1,10,15,59,-44,0,2.67308459963533,-9,0
41,1,10,33,98,-65,1,3.56714032005402,48,0
41,1,1.5,61,17,44,NaN,NaN,0,0
41,1,1.5,83,38,45,1,0.658046578464564,-12,0
41,1,1.5,47,59,-12,1,0.672181401954731,9,0
41,1,1.5,36,91,-55,1,0.830174279777566,41,0
41,1,1.5,17,51,-34,0,0.598307970591122,-1,0
41,1,1.5,32,100,-68,1,0.57567927686614,50,0
41,1,1.5,41,93,-52,1,0.578314825252164,43,0
41,1,1.5,19,80,-61,0,0.524416211381322,-30,0
41,1,1.5,32,53,-21,0,0.848455601633759,-3,0
41,1,1.5,21,58,-37,0,0.528558677615365,-8,0
41,1,1.5,35,82,-47,1,0.699913675693097,32,0
41,1,1.5,34,83,-49,1,0.665314313897397,33,0
41,1,1.5,6,77,-71,0,0.487352483527502,-27,0
41,1,1.5,15,67,-52,0,0.484700806613546,-17,0
41,1,1.5,10,78,-68,0,0.490735809173202,-28,0
41,1,1.5,26,97,-71,1,0.552142253640341,47,0
41,1,1.5,41,72,-31,1,0.698859089810867,22,0
41,1,1.5,96,14,82,0,0.663581963162869,36,0
41,1,1.5,25,68,-43,0,1.29357809599605,-18,0
41,1,1.5,2,70,-68,0,0.539698359847534,-20,0
42,1,10,53,0,53,0,4.53930050089548,50,0
42,1,10,75,0,75,0,3.76638680104224,50,0
42,1,10,5,83,-78,0,2.37716281875328,-33,0
42,1,10,28,85,-57,0,2.31580205235514,-35,0
42,1,10,53,40,13,1,1.95307678068639,-10,0
42,1,10,30,100,-70,1,3.40233312989585,50,0
42,1,10,85,15,70,1,3.4916438027285,-35,0
42,1,10,28,85,-57,0,2.67356525341165,-35,0
42,1,10,98,38,60,1,3.86422247024893,-12,0
42,1,10,53,0,53,0,5.09547834661498,50,0
42,1,10,0,68,-68,0,3.23740962099691,-18,0
42,1,10,85,15,70,0,5.66939311131136,35,0
42,1,10,25,55,-30,0,3.82799059415993,-5,0
42,1,10,25,55,-30,0,2.53261451673461,-5,0
42,1,10,5,83,-78,0,2.79258420252881,-33,0
42,1,10,48,100,-52,0,2.58654738930636,-50,0
42,1,10,100,0,100,0,3.54045735210821,50,0
42,1,10,98,38,60,1,2.32840535245487,-12,0
42,1,10,53,23,30,1,2.67712121461227,-27,0
42,1,10,80,45,35,1,2.7397374358261,-5,0
42,1,1.5,48,60,-12,1,0.563669520313852,10,0
42,1,1.5,53,40,13,1,0.71099393532495,-10,0
42,1,1.5,50,100,-50,0,0.740303031969233,-50,0
42,1,1.5,100,0,100,1,0.568283362561488,-50,0
42,1,1.5,30,100,-70,0,0.634896512026899,-50,0
42,1,1.5,100,15,85,1,0.810906145125045,-35,0
42,1,1.5,48,80,-32,0,0.852108522623894,-30,0
42,1,1.5,75,0,75,1,0.539487811096478,-50,0
42,1,1.5,50,43,7,1,1.12678334147495,-7,0
42,1,1.5,80,45,35,1,1.2674529296055,-5,0
42,1,1.5,53,23,30,1,1.23413480835734,-27,0
42,1,1.5,100,15,85,1,0.842083211915451,-35,0
42,1,1.5,3,100,-97,0,0.570073622802738,-50,0
42,1,1.5,48,100,-52,0,0.628698047541548,-50,0
42,1,1.5,50,43,7,0,1.05331522546476,7,0
42,1,1.5,48,80,-32,0,0.772685701929731,-30,0
42,1,1.5,3,100,-97,0,0.823314070803463,-50,0
42,1,1.5,48,60,-12,0,0.831949767147307,-10,0
42,1,1.5,0,68,-68,0,0.60061141566257,-18,0
42,1,1.5,50,100,-50,0,0.945860756313778,-50,0
42,1,10,51,1,50,1,3.30831734230742,-49,0
42,1,10,16,56,-40,0,1.38563063235779,-6,0
42,1,10,78,40,38,1,2.79417212377302,-10,0
42,1,10,59,47,12,1,3.15612029639306,-3,0
42,1,10,49,100,-51,0,2.79138409769803,-50,0
42,1,10,51,0,51,1,5.46537089068443,-50,0
42,1,10,79,2,77,1,4.01663651742274,-48,0
42,1,10,51,2,49,1,5.06524809436814,-48,0
42,1,10,82,9,73,1,2.85586755593249,-41,0
42,1,10,95,34,61,1,3.15918470581528,-16,0
42,1,10,51,0,51,0,3.66576237263507,50,0
42,1,10,49,98,-49,0,3.80039881309494,-48,0
42,1,10,10,70,-60,0,3.09769197920104,-20,0
42,1,10,66,26,40,1,3.68756219999341,-24,0
42,1,10,12,75,-63,0,2.97361895388167,-25,0
42,1,10,49,99,-50,0,2.32826166244922,-49,0
42,1,10,52,33,19,1,3.15685634114197,-17,0
42,1,10,62,11,51,1,4.47212138872419,-39,0
42,1,10,49,100,-51,0,3.24673627567245,-50,0
42,1,10,50,31,19,1,2.3824005395727,-19,0
42,1,1.5,44,62,-18,0,0.898575746075949,-12,0
42,1,1.5,49,96,-47,0,0.872554291549022,-46,0
42,1,1.5,20,76,-56,0,0.903182990339701,-26,0
42,1,1.5,1,60,-59,0,0.652472512869281,-10,0
42,1,1.5,39,85,-46,0,0.883870246456354,-35,0
42,1,1.5,30,62,-32,0,0.60179429234995,-12,0
42,1,1.5,51,3,48,1,0.747129407158354,-47,0
42,1,1.5,49,97,-48,0,0.823104400682496,-47,0
42,1,1.5,53,39,14,0,0.879768483137013,11,0
42,1,1.5,51,2,49,0,0.958326964420849,48,0
42,1,1.5,25,93,-68,0,0.625018923470634,-43,0
42,1,1.5,92,21,71,1,0.865698958426947,-29,0
42,1,1.5,80,3,77,1,0.528342304794933,-47,0
42,1,1.5,49,98,-49,0,0.548966220027069,-48,0
42,1,1.5,51,3,48,1,0.648921316897031,-47,0
42,1,1.5,11,88,-77,0,0.616221942414995,-38,0
42,1,1.5,98,28,70,1,0.585531662203721,-22,0
42,1,1.5,49,96,-47,0,0.483535580686294,-46,0
42,1,1.5,6,62,-56,0,0.561509404913522,-12,0
42,1,1.5,51,4,47,1,0.764198827382643,-46,0
42,1,10,3,53,-50,0,3.28799546936352,-3,0
42,1,10,50,34,16,1,2.82198603787401,-16,0
42,1,10,12,90,-78,0,3.0626503109379,-40,0
42,1,10,18,72,-54,0,2.87789464810339,-22,0
42,1,10,50,84,-34,0,2.93254890317621,-34,0
42,1,10,49,100,-51,0,2.58447598048951,-50,0
42,1,10,49,99,-50,0,2.99443677731324,-49,0
42,1,10,49,97,-48,0,3.11640650343907,-47,0
42,1,10,2,97,-95,0,2.76103874681576,-47,0
42,1,10,51,1,50,1,3.07638333708746,-49,0
42,1,10,16,96,-80,0,2.65026437862252,-46,0
42,1,10,49,98,-49,0,3.09764286068093,-48,0
42,1,10,87,38,49,1,3.07888105070742,-12,0
42,1,10,90,46,44,1,3.56545611498586,-4,0
42,1,10,49,100,-51,0,3.54344881685392,-50,0
42,1,10,51,3,48,0,3.72342898616625,47,0
42,1,10,66,40,26,1,3.66338269010885,-10,0
42,1,10,51,2,49,0,3.67858157432056,48,0
42,1,10,100,23,77,0,3.58061651079333,27,0
42,1,10,6,57,-51,0,3.23120639126864,-7,0
42,1,1.5,49,100,-51,0,0.591831296187593,-50,0
42,1,1.5,49,96,-47,1,0.713173844764242,46,0
42,1,1.5,11,74,-63,0,0.70982498775993,-24,0
42,1,1.5,66,16,50,0,0.786472245279583,34,0
42,1,1.5,61,5,56,0,0.67575982506969,45,0
42,1,1.5,51,4,47,1,1.07371260898071,-46,0
42,1,1.5,51,2,49,1,0.575696960702771,-48,0
42,1,1.5,89,42,47,1,0.802303072283394,-8,0
42,1,1.5,4,51,-47,0,0.5230144111556,-1,0
42,1,1.5,62,38,24,1,0.950979346394888,-12,0
42,1,1.5,51,4,47,1,0.617636849157861,-46,0
42,1,1.5,21,99,-78,0,0.592932430867222,-49,0
42,1,1.5,55,27,28,1,0.562210626827436,-23,0
42,1,1.5,25,66,-41,0,0.588881618852611,-16,0
42,1,1.5,22,52,-30,0,0.606183802257874,-2,0
42,1,1.5,49,100,-51,0,0.790836096246494,-50,0
42,1,1.5,51,1,50,1,0.600159085355699,-49,0
42,1,1.5,49,97,-48,0,0.840799165714998,-47,0
42,1,1.5,12,62,-50,0,0.640138631541049,-12,0
42,1,1.5,88,46,42,1,0.743403363885591,-4,0
42,1,10,65,4,61,1,3.78994829725707,-46,0
42,1,10,13,53,-40,0,3.47105690967874,-3,0
42,1,10,57,50,7,1,4.30918388105056,0,0
42,1,10,51,3,48,0,3.56177772401134,47,0
42,1,10,51,42,9,1,2.86039892306144,-8,0
42,1,10,49,98,-49,0,3.03505523085187,-48,0
42,1,10,50,24,26,1,3.54634497698862,-26,0
42,1,10,51,1,50,1,3.89360561122885,-49,0
42,1,10,65,18,47,1,3.1709427274327,-32,0
42,1,10,51,0,51,0,2.5008582912269,50,0
42,1,10,71,39,32,1,3.25683489760559,-11,0
42,1,10,80,16,64,1,4.39139032915409,-34,0
42,1,10,97,33,64,1,3.78475089759741,-17,0
42,1,10,73,37,36,1,3.42604528069205,-13,0
42,1,10,32,99,-67,0,2.89797276121681,-49,0
42,1,10,49,96,-47,0,2.97529814761947,-46,0
42,1,10,24,56,-32,0,2.23321805143496,-6,0
42,1,10,49,97,-48,0,2.36853775253985,-47,0
42,1,10,49,98,-49,0,3.75442387453222,-48,0
42,1,10,51,3,48,1,3.42912545202125,-47,0
42,1,1.5,36,96,-60,0,0.62306737851759,-46,0
42,1,1.5,78,13,65,1,0.551062188096694,-37,0
42,1,1.5,77,5,72,1,0.593656379263848,-45,0
42,1,1.5,49,100,-51,0,0.451015452170395,-50,0
42,1,1.5,15,89,-74,0,0.529642479450558,-39,0
42,1,1.5,97,9,88,1,0.56564635761606,-41,0
42,1,1.5,49,96,-47,0,0.608291500117048,-46,0
42,1,1.5,49,98,-49,0,0.568760252106586,-48,0
42,1,1.5,51,1,50,1,0.578872803176637,-49,0
42,1,1.5,83,45,38,1,0.964848364892532,-5,0
42,1,1.5,18,53,-35,0,0.486849248292856,-3,0
42,1,1.5,49,100,-51,0,0.524058363080258,-50,0
42,1,1.5,13,89,-76,0,0.511998299174593,-39,0
42,1,1.5,78,28,50,1,0.50877370472881,-22,0
42,1,1.5,24,70,-46,0,0.633397297380725,-20,0
42,1,1.5,51,2,49,1,0.808703509232146,-48,0
42,1,1.5,51,0,51,1,0.481354938150616,-50,0
42,1,1.5,49,98,-49,0,0.839369596724282,-48,0
42,1,1.5,47,65,-18,0,0.583392807078781,-15,0
42,1,1.5,10,81,-71,0,0.936638936691452,-31,0
42,1,10,49,97,-48,0,2.64147106313612,-47,0
42,1,10,89,1,88,1,2.58540043511312,-49,0
42,1,10,100,25,75,1,2.33068423203076,-25,0
42,1,10,51,2,49,1,2.51859630987747,-48,0
42,1,10,74,31,43,1,2.19458889811358,-19,0
42,1,10,49,98,-49,0,2.80248158513859,-48,0
42,1,10,81,24,57,1,2.84310553701653,-26,0
42,1,10,66,47,19,1,2.7544073795143,-3,0
42,1,10,51,1,50,1,1.61304866582213,-49,0
42,1,10,40,99,-59,0,2.70827628804545,-49,0
42,1,10,57,20,37,1,2.68023840812384,-30,0
42,1,10,7,79,-72,0,2.85410478741687,-29,0
42,1,10,62,24,38,1,1.51682327777962,-26,0
42,1,10,89,43,46,1,4.2887897965411,-7,0
42,1,10,49,100,-51,0,1.5260564606433,-50,0
42,1,10,51,2,49,1,1.94607262578211,-48,0
42,1,10,49,99,-50,0,2.24533126594906,-49,0
42,1,10,5,93,-88,0,2.38864665637084,-43,0
42,1,10,42,55,-13,0,2.46192782875733,-5,0
42,1,10,51,3,48,1,3.07652849331498,-47,0
42,1,1.5,49,100,-51,0,0.788384568717447,-50,0
42,1,1.5,49,97,-48,0,0.54971032901085,-47,0
42,1,1.5,47,54,-7,0,0.67301248673175,-4,0
42,1,1.5,49,98,-49,0,0.558952309205779,-48,0
42,1,1.5,57,38,19,1,0.809646658206475,-12,0
42,1,1.5,5,63,-58,0,0.53025206233724,-13,0
42,1,1.5,21,75,-54,0,1.25418872876617,-25,0
42,1,1.5,96,10,86,1,0.612862088746624,-40,0
42,1,1.5,33,59,-26,0,0.49357701986446,-9,0
42,1,1.5,51,4,47,1,0.530831221054541,-46,0
42,1,1.5,81,16,65,1,0.702156266546808,-34,0
42,1,1.5,49,96,-47,0,0.570805268886033,-46,0
42,1,1.5,51,3,48,1,0.652063436195021,-47,0
42,1,1.5,33,70,-37,0,1.15479482935916,-20,0
42,1,1.5,49,99,-50,0,0.565401498111896,-49,0
42,1,1.5,66,45,21,1,0.919404932748876,-5,0
42,1,1.5,49,97,-48,0,1.18738533665601,-47,0
42,1,1.5,52,38,14,0,0.82799755873566,12,0
42,1,1.5,89,41,48,1,0.571248068721616,-9,0
42,1,1.5,69,28,41,1,0.709255726062111,-22,0
43,1,10,53,23,30,NaN,NaN,0,0
43,1,10,48,80,-32,0,1.45222030596187,-30,0
43,1,10,85,15,70,1,3.06610608423807,-35,0
43,1,10,50,100,-50,0,4.81668661328467,-50,0
43,1,10,75,0,75,1,4.35331025268351,-50,0
43,1,10,28,85,-57,0,3.93254903110756,-35,0
43,1,10,5,83,-78,0,3.15249210535467,-33,0
43,1,10,3,100,-97,0,3.01981697985593,-50,0
43,1,10,25,55,-30,0,3.04442774589779,-5,0
43,1,10,75,0,75,1,3.75633101977019,-50,0
43,1,10,53,0,53,1,3.95161017772307,-50,0
43,1,10,85,15,70,1,5.70687819245131,-35,0
43,1,10,100,0,100,1,2.85538072991812,-50,0
43,1,10,48,100,-52,0,3.54278870208918,-50,0
43,1,10,28,85,-57,0,3.13067227737838,-35,0
43,1,10,50,43,7,0,4.58328846108043,7,0
43,1,10,53,40,13,1,3.28128579623672,-10,0
43,1,10,48,100,-52,0,2.93590812703997,-50,0
43,1,10,100,0,100,1,2.88379778711669,-50,0
43,1,10,0,68,-68,0,1.94581899956574,-18,0
43,1,1.5,0,68,-68,0,0.797696944593554,-18,0
43,1,1.5,100,15,85,1,0.767686846045763,-35,0
43,1,1.5,48,60,-12,0,0.978365281522201,-10,0
43,1,1.5,80,45,35,1,0.853008762460377,-5,0
43,1,1.5,50,43,7,0,0.980261462585077,7,0
43,1,1.5,53,23,30,NaN,NaN,0,0
43,1,1.5,53,40,13,1,0.614212377410695,-10,0
43,1,1.5,48,80,-32,0,0.743546001543109,-30,0
43,1,1.5,5,83,-78,0,0.7394919202452,-33,0
43,1,1.5,50,100,-50,0,1.02346125438225,-50,0
43,1,1.5,3,100,-97,0,1.45610137402582,-50,0
43,1,1.5,30,100,-70,0,1.07939218104775,-50,0
43,1,1.5,30,100,-70,0,0.958024863321498,-50,0
43,1,1.5,80,45,35,1,0.737329254814995,-5,0
43,1,1.5,100,15,85,1,1.02125350287633,-35,0
43,1,1.5,25,55,-30,0,0.797927873275057,-5,0
43,1,1.5,98,38,60,1,0.783256570929098,-12,0
43,1,1.5,53,0,53,1,1.01722911240904,-50,0
43,1,1.5,48,60,-12,0,0.970536432665085,-10,0
43,1,1.5,98,38,60,1,0.829173990099662,-12,0
43,1,10,51,4,47,0,3.55764438082679,46,0
43,1,10,52,7,45,1,3.05689422916566,-43,0
43,1,10,51,1,50,1,2.42418556402481,-49,0
43,1,10,53,29,24,1,2.40087459656206,-21,0
43,1,10,94,20,74,1,3.12210079120587,-30,0
43,1,10,68,24,44,1,3.26268650698375,-26,0
43,1,10,49,98,-49,0,3.15799407283021,-48,0
43,1,10,33,66,-33,0,2.44129627966549,-16,0
43,1,10,91,49,42,1,2.00127633915736,-1,0
43,1,10,51,2,49,1,2.02653920380908,-48,0
43,1,10,51,2,49,1,1.97049757799823,-48,0
43,1,10,85,47,38,1,2.14909415475495,-3,0
43,1,10,33,98,-65,0,2.87243096423708,-48,0
43,1,10,49,98,-49,0,2.11101254895766,-48,0
43,1,10,2,87,-85,0,2.57231055142483,-37,0
43,1,10,74,7,67,1,2.5749427718406,-43,0
43,1,10,65,15,50,1,4.04157082820939,-35,0
43,1,10,78,7,71,1,2.09751751667363,-43,0
43,1,10,49,97,-48,0,1.72749572507018,-47,0
43,1,10,49,99,-50,0,2.55605647122638,-49,0
43,1,1.5,84,24,60,1,1.10930880846263,-26,0
43,1,1.5,51,1,50,1,0.90660547667494,-49,0
43,1,1.5,52,9,43,1,0.935937451317386,-41,0
43,1,1.5,84,35,49,1,0.475934115680502,-15,0
43,1,1.5,51,4,47,1,0.674550376358638,-46,0
43,1,1.5,49,96,-47,0,0.641183747752621,-46,0
43,1,1.5,29,58,-29,0,0.561153763679158,-8,0
43,1,1.5,73,20,53,1,0.700440413985689,-30,0
43,1,1.5,49,97,-48,0,0.529779719696762,-47,0
43,1,1.5,86,26,60,1,0.622444801630536,-24,0
43,1,1.5,51,1,50,0,0.502418336470328,49,0
43,1,1.5,60,7,53,1,0.907713934346702,-43,0
43,1,1.5,51,2,49,1,0.929667187783252,-48,0
43,1,1.5,51,0,51,1,0.910283107567011,-50,0
43,1,1.5,19,63,-44,0,1.00360725262681,-13,0
43,1,1.5,30,51,-21,0,0.836911933697593,-1,0
43,1,1.5,64,5,59,1,0.988836980845917,-45,0
43,1,1.5,78,48,30,1,1.31086776033999,-2,0
43,1,1.5,47,97,-50,0,1.38012913678494,-47,0
43,1,1.5,49,96,-47,0,1.01477320420872,-46,0
43,1,10,80,12,68,1,2.05071047224919,-38,0
43,1,10,49,97,-48,0,2.13802387362693,-47,0
43,1,10,49,96,-47,0,2.02193822474464,-46,0
43,1,10,93,16,77,1,3.22110211629661,-34,0
43,1,10,1,62,-61,0,3.3977079411975,-12,0
43,1,10,32,91,-59,0,2.89635151010862,-41,0
43,1,10,25,86,-61,0,3.32564279731605,-36,0
43,1,10,67,10,57,1,2.4022341433556,-40,0
43,1,10,49,100,-51,0,4.09885873579378,-50,0
43,1,10,49,98,-49,0,3.36809701937045,-48,0
43,1,10,96,23,73,1,3.16944007125812,-27,0
43,1,10,48,76,-28,0,2.13202925829728,-26,0
43,1,10,51,2,49,1,1.71933954397082,-48,0
43,1,10,49,97,-48,0,2.85194978950676,-47,0
43,1,10,41,77,-36,0,3.0265765922627,-27,0
43,1,10,49,99,-50,0,2.115174396974,-49,0
43,1,10,12,74,-62,0,2.83040194419982,-24,0
43,1,10,13,53,-40,0,3.32696532220962,-3,0
43,1,10,40,70,-30,0,3.76294401079122,-20,0
43,1,10,51,0,51,1,4.02953651147436,-50,0
43,1,1.5,95,25,70,1,0.516794196725641,-25,0
43,1,1.5,10,98,-88,0,0.56079307507207,-48,0
43,1,1.5,51,4,47,1,0.531440206882962,-46,0
43,1,1.5,6,66,-60,0,0.662748821072455,-16,0
43,1,1.5,74,35,39,1,0.677361474864483,-15,0
43,1,1.5,51,3,48,1,0.627350386622311,-47,0
43,1,1.5,86,8,78,1,0.843335050025416,-42,0
43,1,1.5,18,83,-65,0,0.730639287566646,-33,0
43,1,1.5,49,96,-47,0,0.702544430861963,-46,0
43,1,1.5,51,0,51,1,0.931270126076015,-50,0
43,1,1.5,41,55,-14,0,1.08655940090512,-5,0
43,1,1.5,92,25,67,1,1.07583551279913,-25,0
43,1,1.5,94,26,68,1,1.13779587737326,-24,0
43,1,1.5,80,8,72,1,1.09312034133472,-42,0
43,1,1.5,51,0,51,1,1.00246873757123,-50,0
43,1,1.5,49,98,-49,0,1.05107409328411,-48,0
43,1,1.5,12,94,-82,0,1.19365495956026,-44,0
43,1,1.5,90,39,51,1,0.564400327698877,-11,0
43,1,1.5,49,96,-47,0,0.894953841755068,-46,0
43,1,1.5,49,99,-50,0,1.45222763703123,-49,0
43,1,10,49,100,-51,1,3.7828016780818,50,0
43,1,10,21,59,-38,0,2.76807759203712,-9,0
43,1,10,18,73,-55,0,2.8660346063125,-23,0
43,1,10,51,0,51,1,3.3279583155404,-50,0
43,1,10,27,98,-71,0,2.37195572767314,-48,0
43,1,10,51,1,50,1,4.05385513440615,-49,0
43,1,10,22,55,-33,0,3.60448368195648,-5,0
43,1,10,69,41,28,1,2.75706119426786,-9,0
43,1,10,51,2,49,1,2.95099730033371,-48,0
43,1,10,53,44,9,1,2.46570397508913,-6,0
43,1,10,87,50,37,1,2.87094495649899,0,0
43,1,10,38,89,-51,0,2.82086715552714,-39,0
43,1,10,49,98,-49,0,3.78152277305026,-48,0
43,1,10,59,50,9,1,3.22274757479045,0,0
43,1,10,0,61,-61,0,3.03072084571249,-11,0
43,1,10,51,2,49,1,2.13468787056263,-48,0
43,1,10,26,87,-61,0,3.68196795223048,-37,0
43,1,10,49,97,-48,0,3.0072412636564,-47,0
43,1,10,77,39,38,1,3.50385046084921,-11,0
43,1,10,51,4,47,1,3.18849022127006,-46,0
43,1,1.5,51,2,49,1,1.21911026477983,-48,0
43,1,1.5,56,2,54,1,0.51509815385316,-48,0
43,1,1.5,49,100,-51,0,0.551072077239951,-50,0
43,1,1.5,49,99,-50,0,0.61769280253975,-49,0
43,1,1.5,92,24,68,1,0.570309169518168,-26,0
43,1,1.5,43,76,-33,0,0.5803226770131,-26,0
43,1,1.5,17,63,-46,0,0.718261143683321,-13,0
43,1,1.5,51,4,47,1,0.714216959328951,-46,0
43,1,1.5,9,77,-68,0,0.710886454566662,-27,0
43,1,1.5,35,74,-39,0,0.763538560508096,-24,0
43,1,1.5,66,21,45,NaN,NaN,0,0
43,1,1.5,51,1,50,1,0.692113785525635,-49,0
43,1,1.5,19,95,-76,0,0.609441317539677,-45,0
43,1,1.5,49,100,-51,0,0.722059004110633,-50,0
43,1,1.5,29,88,-59,0,0.590028646152859,-38,0
43,1,1.5,37,71,-34,0,0.695332124928427,-21,0
43,1,1.5,27,71,-44,0,0.956605568313535,-21,0
43,1,1.5,98,31,67,1,0.823261482745238,-19,0
43,1,1.5,51,3,48,1,1.11993226092,-47,0
43,1,1.5,51,4,47,1,0.515891008993549,-46,0
43,1,10,77,24,53,1,2.8637586758623,-26,0
43,1,10,23,94,-71,0,4.30236958485966,-44,0
43,1,10,58,37,21,1,2.8349959587481,-13,0
43,1,10,51,4,47,1,3.33894538903223,-46,0
43,1,10,50,67,-17,1,4.79820828667425,17,0
43,1,10,51,3,48,1,3.39882996134702,-47,0
43,1,10,60,1,59,1,4.46337855992124,-49,0
43,1,10,80,4,76,1,2.39805983252154,-46,0
43,1,10,49,98,-49,0,3.87865100994622,-48,0
43,1,10,49,99,-50,0,3.18060125764487,-49,0
43,1,10,96,31,65,1,3.03718758190189,-19,0
43,1,10,8,54,-46,0,2.59651590933663,-4,0
43,1,10,14,94,-80,0,3.36578296736025,-44,0
43,1,10,58,12,46,1,3.22367862058582,-38,0
43,1,10,12,70,-58,0,2.60763567518234,-20,0
43,1,10,63,48,15,1,2.36026780395969,-2,0
43,1,10,51,4,47,0,5.52284489473504,46,0
43,1,10,51,3,48,1,1.99086438804807,-47,0
43,1,10,49,100,-51,0,2.53470033337999,-50,0
43,1,10,49,98,-49,0,3.00995815792248,-48,0
43,1,1.5,88,5,83,1,0.539300945891227,-45,0
43,1,1.5,51,3,48,1,0.630590352679519,-47,0
43,1,1.5,34,77,-43,0,0.734557010976459,-27,0
43,1,1.5,36,95,-59,0,0.689204450692159,-45,0
43,1,1.5,55,45,10,1,0.878485694334813,-5,0
43,1,1.5,14,82,-68,0,1.0364984613916,-32,0
43,1,1.5,51,4,47,0,0.731157227609856,46,0
43,1,1.5,49,97,-48,NaN,NaN,0,0
43,1,1.5,49,98,-49,0,0.737029780636021,-48,0
43,1,1.5,75,34,41,1,0.652344934139819,-16,0
43,1,1.5,82,35,47,1,0.666294126163848,-15,0
43,1,1.5,88,27,61,1,0.480261645861901,-23,0
43,1,1.5,39,76,-37,0,0.518268841306508,-26,0
43,1,1.5,51,3,48,1,0.393598143773488,-47,0
43,1,1.5,49,99,-50,0,0.506903484640588,-49,0
43,1,1.5,51,1,50,1,0.463508686400473,-49,0
43,1,1.5,22,72,-50,0,0.6381530837225,-22,0
43,1,1.5,51,0,51,1,0.948793580916117,-50,0
43,1,1.5,34,100,-66,0,0.638785021892545,-50,0
43,1,1.5,34,78,-44,0,0.726032077093805,-28,0
45,1,10,100,0,100,1,3.57855829800246,-50,0
45,1,10,50,43,7,1,3.73991191656387,-7,0
45,1,10,28,85,-57,0,3.51985139813041,-35,0
45,1,10,100,15,85,1,3.16441252961522,-35,0
45,1,10,98,38,60,1,2.96777311639744,-12,0
45,1,10,80,45,35,1,2.93040308346099,-5,0
45,1,10,75,0,75,1,4.75895304232836,-50,0
45,1,10,48,80,-32,0,3.1302791874914,-30,0
45,1,10,75,0,75,1,2.36690694422578,-50,0
45,1,10,85,15,70,1,3.1295420430688,-35,0
45,1,10,5,83,-78,0,3.72613123808696,-33,0
45,1,10,50,100,-50,0,5.76264976109087,-50,0
45,1,10,25,55,-30,0,4.27805153412919,-5,0
45,1,10,100,15,85,1,4.24462747815414,-35,0
45,1,10,80,45,35,1,4.47662416448293,-5,0
45,1,10,53,40,13,1,3.64322979954886,-10,0
45,1,10,0,68,-68,0,2.65115291073744,-18,0
45,1,10,53,0,53,0,3.06643500318751,50,0
45,1,10,25,55,-30,0,3.12911097303731,-5,0
45,1,10,48,60,-12,0,3.24567179661244,-10,0
45,1,1.5,53,23,30,1,0.812345611135243,-27,0
45,1,1.5,28,85,-57,0,0.613625258658431,-35,0
45,1,1.5,48,100,-52,0,0.558957074448699,-50,0
45,1,1.5,50,100,-50,0,0.530295315969852,-50,0
45,1,1.5,30,100,-70,0,0.582864599651657,-50,0
45,1,1.5,3,100,-97,0,0.536848606803687,-50,0
45,1,1.5,3,100,-97,0,0.436910004966194,-50,0
45,1,1.5,85,15,70,1,1.22882414286141,-35,0
45,1,1.5,48,100,-52,0,0.765520262313657,-50,0
45,1,1.5,53,0,53,1,0.952809561262256,-50,0
45,1,1.5,53,40,13,1,0.812100385068334,-10,0
45,1,1.5,30,100,-70,0,1.23737626438378,-50,0
45,1,1.5,53,23,30,1,1.109386953176,-27,0
45,1,1.5,5,83,-78,0,1.11471448023804,-33,0
45,1,1.5,100,0,100,0,0.872015087443287,50,0
45,1,1.5,0,68,-68,0,0.518657158201677,-18,0
45,1,1.5,50,43,7,1,0.843281483961619,-7,0
45,1,1.5,48,60,-12,0,1.00322019576561,-10,0
45,1,1.5,98,38,60,1,0.580555295906379,-12,0
45,1,1.5,48,80,-32,0,0.639213443821063,-30,0
45,1,10,68,40,28,1,1.70769346374436,-10,0
45,1,10,49,96,-47,1,2.78357608514489,46,0
45,1,10,51,1,50,0,1.24159422601224,49,0
45,1,10,48,53,-5,1,3.05738289906003,3,0
45,1,10,49,99,-50,1,3.39276051602792,49,0
45,1,10,6,61,-55,0,3.37079170630022,-11,0
45,1,10,81,44,37,1,3.44541557387856,-6,0
45,1,10,50,25,25,1,2.99732597288676,-25,0
45,1,10,58,5,53,1,2.79932003833528,-45,0
45,1,10,51,4,47,1,2.8886358429736,-46,0
45,1,10,58,29,29,1,4.30185825639637,-21,0
45,1,10,62,13,49,1,3.98715000761149,-37,0
45,1,10,49,96,-47,0,4.04511206538882,-46,0
45,1,10,77,0,77,1,2.70104083618207,-50,0
45,1,10,51,2,49,0,3.17831087259401,48,0
45,1,10,49,97,-48,1,5.41296032580431,47,0
45,1,10,51,3,48,0,2.36614743988321,47,0
45,1,10,86,1,85,0,4.05683343138662,49,0
45,1,10,40,51,-11,0,3.95212886646914,-1,0
45,1,10,78,39,39,1,4.59546276797482,-11,0
45,1,1.5,80,44,36,1,0.717977929656627,-6,0
45,1,1.5,59,4,55,1,0.474740432429826,-46,0
45,1,1.5,49,66,-17,0,0.913364453954273,-16,0
45,1,1.5,7,98,-91,0,0.670671292595216,-48,0
45,1,1.5,49,98,-49,1,0.637323480303166,48,0
45,1,1.5,51,2,49,1,0.605297469490324,-48,0
45,1,1.5,50,67,-17,1,0.83054659019399,17,0
45,1,1.5,51,3,48,0,0.815221244134591,47,0
45,1,1.5,29,92,-63,1,0.959889959849534,42,0
45,1,1.5,49,96,-47,NaN,NaN,0,0
45,1,1.5,76,0,76,1,0.402478652686113,-50,0
45,1,1.5,51,0,51,0,0.811718067008769,50,0
45,1,1.5,31,50,-19,1,0.71703404757136,0,0
45,1,1.5,44,69,-25,1,0.553769938371261,19,0
45,1,1.5,25,53,-28,0,0.701076025579823,-3,0
45,1,1.5,51,4,47,0,0.618390122035635,46,0
45,1,1.5,100,12,88,0,0.7710435303743,38,0
45,1,1.5,34,52,-18,0,1.26966179696319,-2,0
45,1,1.5,49,98,-49,1,0.780256186088081,48,0
45,1,1.5,51,3,48,0,0.838924597555888,47,0
45,1,10,49,99,-50,1,2.38158275280148,49,0
45,1,10,0,78,-78,0,3.38415084518783,-28,0
45,1,10,81,5,76,0,1.65004041281645,45,0
45,1,10,100,33,67,1,3.39343278000888,-17,0
45,1,10,79,7,72,0,3.2914073740103,43,0
45,1,10,92,31,61,1,3.23328513119486,-19,0
45,1,10,27,98,-71,0,4.25727146599093,-48,0
45,1,10,31,50,-19,0,3.01655770784419,0,0
45,1,10,48,53,-5,1,3.44914161713677,3,0
45,1,10,18,64,-46,0,2.8884833556076,-14,0
45,1,10,51,2,49,0,2.48512863372162,48,0
45,1,10,72,40,32,1,2.84244756872067,-10,0
45,1,10,99,41,58,1,2.60167919372907,-9,0
45,1,10,22,74,-52,1,3.18697589343356,24,0
45,1,10,51,0,51,0,3.1882984280237,50,0
45,1,10,68,38,30,1,2.82228478114121,-12,0
45,1,10,69,28,41,1,2.01416666209116,-22,0
45,1,10,19,84,-65,0,3.51086197511177,-34,0
45,1,10,81,46,35,1,3.26011520859902,-4,0
45,1,10,81,5,76,1,2.20339724239602,-45,0
45,1,1.5,79,7,72,1,0.453385970788077,-43,0
45,1,1.5,50,67,-17,1,0.716031516494695,17,0
45,1,1.5,87,21,66,1,0.624003196367994,-29,0
45,1,1.5,49,50,-1,1,1.19997837318806,0,0
45,1,1.5,17,95,-78,NaN,NaN,0,0
45,1,1.5,11,78,-67,0,0.439856749857427,-28,0
45,1,1.5,68,12,56,1,0.487906762777129,-38,0
45,1,1.5,33,84,-51,0,0.845226064338931,-34,0
45,1,1.5,15,73,-58,0,0.436544915050035,-23,0
45,1,1.5,51,4,47,1,0.523830365142203,-46,0
45,1,1.5,30,52,-22,0,0.551810695731547,-2,0
45,1,1.5,79,7,72,1,0.466398714124807,-43,0
45,1,1.5,31,76,-45,0,0.824402009471669,-26,0
45,1,1.5,14,75,-61,0,0.592386628763052,-25,0
45,1,1.5,13,55,-42,0,0.617582232283894,-5,0
45,1,1.5,37,58,-21,0,0.649702081500436,-8,0
45,1,1.5,98,4,94,1,0.584362714638701,-46,0
45,1,1.5,50,67,-17,1,1.26561648328789,17,0
45,1,1.5,100,12,88,1,0.471575953182764,-38,0
45,1,1.5,62,47,15,1,0.645095026964555,-3,0
45,1,10,29,79,-50,1,4.23686051988625,29,0
45,1,10,51,1,50,0,2.81211064863601,49,0
45,1,10,100,12,88,0,4.39677577209659,38,0
45,1,10,24,83,-59,0,2.53407707576116,-33,0
45,1,10,80,32,48,1,2.2893982797541,-18,0
45,1,10,62,19,43,1,1.80659361202561,-31,0
45,1,10,49,97,-48,1,3.30988950164465,47,0
45,1,10,48,85,-37,1,3.94645677661174,35,0
45,1,10,39,79,-40,0,2.36580067776958,-29,0
45,1,10,55,29,26,1,2.68044624546019,-21,0
45,1,10,18,73,-55,0,2.87766848294996,-23,0
45,1,10,29,92,-63,0,2.99565007817,-42,0
45,1,10,99,45,54,1,3.23696352216939,-5,0
45,1,10,81,5,76,1,2.67628216759476,-45,0
45,1,10,19,51,-32,1,3.27417117072036,1,0
45,1,10,62,41,21,1,2.69618140130478,-9,0
45,1,10,64,6,58,0,2.79749532182177,44,0
45,1,10,9,60,-51,0,3.35874080631766,-10,0
45,1,10,22,74,-52,0,2.95336672660778,-24,0
45,1,10,78,16,62,1,3.80399876103911,-34,0
45,1,1.5,27,97,-70,0,0.641192480470636,-47,0
45,1,1.5,29,92,-63,0,0.448562458419474,-42,0
45,1,1.5,75,48,27,1,0.455205922073219,-2,0
45,1,1.5,35,75,-40,0,1.35782478249166,-25,0
45,1,1.5,19,50,-31,0,0.424485217707115,0,0
45,1,1.5,57,28,29,1,0.416447007883107,-22,0
45,1,1.5,68,22,46,0,0.496402434655465,28,0
45,1,1.5,49,99,-50,1,0.413731926499167,49,0
45,1,1.5,77,2,75,1,0.422409410224645,-48,0
45,1,1.5,49,97,-48,1,0.4943907745037,47,0
45,1,1.5,2,98,-96,0,0.659044498082949,-48,0
45,1,1.5,51,4,47,1,0.457682741995086,-46,0
45,1,1.5,77,2,75,1,0.656318419991294,-48,0
45,1,1.5,26,76,-50,1,0.990931767402799,26,0
45,1,1.5,7,81,-74,0,0.640262894070474,-31,0
45,1,1.5,68,44,24,1,0.615595131399459,-6,0
45,1,1.5,49,97,-48,0,1.31958784426388,-47,0
45,1,1.5,54,48,6,1,0.723526123547344,-2,0
45,1,1.5,64,6,58,0,0.719479343650164,44,0
45,1,1.5,71,12,59,1,0.619437739529531,-38,0
45,1,10,43,73,-30,1,2.39938271943538,23,0
45,1,10,53,0,53,0,1.78405847304384,50,0
45,1,10,49,97,-48,0,1.89735401443613,-47,0
45,1,10,19,51,-32,0,1.6786409564229,-1,0
45,1,10,89,38,51,1,0.932610118048615,-12,0
45,1,10,55,22,33,1,1.00796783102851,-28,0
45,1,10,49,96,-47,1,2.66312316837138,46,0
45,1,10,46,76,-30,1,2.39731099497294,26,0
45,1,10,49,57,-8,1,1.87910868207109,7,0
45,1,10,76,21,55,1,1.89307703726809,-29,0
45,1,10,49,99,-50,1,3.00961586748599,49,0
45,1,10,76,9,67,1,2.61833257273247,-41,0
45,1,10,87,11,76,1,2.83428326359717,-39,0
45,1,10,52,38,14,1,2.72958859571372,-12,0
45,1,10,32,97,-65,1,2.95743476675125,47,0
45,1,10,16,53,-37,1,2.20817163625907,3,0
45,1,10,100,12,88,1,2.65679860855744,-38,0
45,1,10,53,2,51,1,1.5914445794624,-48,0
45,1,10,60,18,42,1,3.12731778035231,-32,0
45,1,10,51,3,48,1,3.59523147104483,-47,0
45,1,1.5,49,97,-48,1,0.498099223084864,47,0
45,1,1.5,99,42,57,1,0.463462599363993,-8,0
45,1,1.5,92,8,84,1,0.469428300697473,-42,0
45,1,1.5,19,51,-32,0,0.610748159422656,-1,0
45,1,1.5,72,40,32,1,0.45941655257775,-10,0
45,1,1.5,63,8,55,1,0.402048682328314,-42,0
45,1,1.5,83,46,37,1,0.378619512877776,-4,0
45,1,1.5,34,71,-37,0,0.596599458600394,-21,0
45,1,1.5,10,88,-78,0,0.581960305644316,-38,0
45,1,1.5,81,5,76,1,0.559195702488068,-45,0
45,1,1.5,51,2,49,1,1.20060811664735,-48,0
45,1,1.5,51,9,42,0,1.2732533141243,41,0
45,1,1.5,67,27,40,1,0.679141672124388,-23,0
45,1,1.5,21,61,-40,0,0.757142254937207,-11,0
45,1,1.5,51,4,47,0,0.887820255520637,46,0
45,1,1.5,44,88,-44,NaN,NaN,0,0
45,1,1.5,58,24,34,1,0.635755719646113,-26,0
45,1,1.5,61,8,53,1,0.395074951564311,-42,0
45,1,1.5,51,0,51,1,0.49971426949196,-50,0
45,1,1.5,76,43,33,1,0.584332657032064,-7,0
46,1,10,75,0,75,1,3.30635005873046,-50,0
46,1,10,100,0,100,1,4.54240098822629,-50,0
46,1,10,0,68,-68,0,5.99437920740456,-18,0
46,1,10,3,100,-97,0,5.50065045626252,-50,0
46,1,10,0,68,-68,0,6.1941204178147,-18,0
46,1,10,85,15,70,1,5.89224529292551,-35,0
46,1,10,53,23,30,1,5.98640071699629,-27,0
46,1,10,53,23,30,1,6.33257981331553,-27,0
46,1,10,25,55,-30,0,4.82464475996676,-5,0
46,1,10,100,15,85,1,5.61753134522587,-35,0
46,1,10,50,100,-50,0,6.07427004657802,-50,0
46,1,10,53,40,13,1,6.00915477337549,-10,0
46,1,10,48,100,-52,0,5.32261238194769,-50,0
46,1,10,50,43,7,1,5.92741061953711,-7,0
46,1,10,28,85,-57,0,5.58821774247917,-35,0
46,1,10,50,43,7,1,4.95839059265563,-7,0
46,1,10,53,40,13,1,5.8018877710856,-10,0
46,1,10,100,15,85,1,5.9633530479914,-35,0
46,1,10,98,38,60,1,6.73479565337766,-12,0
46,1,10,30,100,-70,0,5.69100376273855,-50,0
46,1,1.5,75,0,75,1,1.28465205448447,-50,0
46,1,1.5,80,45,35,1,1.01942571438849,-5,0
46,1,1.5,48,80,-32,0,0.700129944627406,-30,0
46,1,1.5,80,45,35,1,0.705496712878812,-5,0
46,1,1.5,48,60,-12,0,1.20687258645194,-10,0
46,1,1.5,5,83,-78,NaN,NaN,0,0
46,1,1.5,50,100,-50,0,0.80771346934489,-50,0
46,1,1.5,48,100,-52,0,0.657044776831754,-50,0
46,1,1.5,3,100,-97,0,0.728454941825476,-50,0
46,1,1.5,25,55,-30,0,0.57320354753756,-5,0
46,1,1.5,85,15,70,1,0.65585346496664,-35,0
46,1,1.5,30,100,-70,0,0.607251606881618,-50,0
46,1,1.5,53,0,53,1,0.544676577148493,-50,0
46,1,1.5,100,0,100,1,0.468730996275553,-50,0
46,1,1.5,98,38,60,1,0.458769429853419,-12,0
46,1,1.5,53,0,53,1,0.61011625372339,-50,0
46,1,1.5,48,80,-32,0,0.571474495838629,-30,0
46,1,1.5,48,60,-12,0,0.534213193517644,-10,0
46,1,1.5,5,83,-78,0,0.570263756468194,-33,0
46,1,1.5,28,85,-57,0,0.556988143711351,-35,0
46,1,10,51,2,49,1,3.57934668456437,-48,0
46,1,10,51,4,47,1,5.03012259514071,-46,0
46,1,10,79,37,42,1,5.42361913211062,-13,0
46,1,10,52,50,2,1,5.9123513380182,0,0
46,1,10,34,100,-66,0,5.4618862682255,-50,0
46,1,10,74,46,28,1,4.6853771051974,-4,0
46,1,10,51,1,50,1,5.0994279870356,-49,0
46,1,10,51,3,48,1,5.08893857777002,-47,0
46,1,10,93,10,83,1,5.53507606984931,-40,0
46,1,10,44,85,-41,0,5.59529303520685,-35,0
46,1,10,48,60,-12,0,4.70869419391965,-10,0
46,1,10,95,12,83,1,4.77813997730846,-38,0
46,1,10,49,97,-48,0,5.58897871585214,-47,0
46,1,10,62,20,42,1,5.09504395941622,-30,0
46,1,10,49,99,-50,0,5.50924732917338,-49,0
46,1,10,17,95,-78,0,4.93069644091884,-45,0
46,1,10,49,98,-49,0,4.74349442921812,-48,0
46,1,10,50,37,13,1,6.34761856761179,-13,0
46,1,10,51,1,50,1,5.39175062358845,-49,0
46,1,10,85,50,35,1,4.53797773897531,0,0
46,1,1.5,22,62,-40,1,0.83162071564584,12,0
46,1,1.5,38,59,-21,1,0.848387421952793,9,0
46,1,1.5,51,1,50,0,0.440477111231303,49,0
46,1,1.5,51,3,48,1,0.696462903462816,-47,0
46,1,1.5,49,98,-49,0,0.63920772264828,-48,0
46,1,1.5,21,79,-58,0,0.791244041145546,-29,0
46,1,1.5,4,72,-68,0,0.569264520716388,-22,0
46,1,1.5,49,99,-50,0,0.460695322923129,-49,0
46,1,1.5,65,22,43,1,0.516071163467132,-28,0
46,1,1.5,88,38,50,1,0.865496492973762,-12,0
46,1,1.5,93,18,75,1,0.664841821271693,-32,0
46,1,1.5,51,3,48,1,0.45623211885686,-47,0
46,1,1.5,92,47,45,1,0.431549603497842,-3,0
46,1,1.5,16,94,-78,0,0.584257088776212,-44,0
46,1,1.5,49,99,-50,0,0.706341994489776,-49,0
46,1,1.5,51,4,47,1,0.344418520689942,-46,0
46,1,1.5,11,73,-62,0,0.523762639350025,-23,0
46,1,1.5,50,76,-26,0,0.561171664361609,-26,0
46,1,1.5,49,100,-51,1,0.508546104683774,50,0
46,1,1.5,89,43,46,0,0.425921479705721,7,0
46,1,10,25,55,-30,0,3.95547719369642,-5,0
46,1,10,51,2,49,1,3.68691371419118,-48,0
46,1,10,6,74,-68,0,5.15701893452206,-24,0
46,1,10,59,17,42,1,4.5764578449598,-33,0
46,1,10,86,33,53,1,4.78728595332359,-17,0
46,1,10,49,98,-49,0,4.28541009535547,-48,0
46,1,10,49,100,-51,0,3.75548012615764,-50,0
46,1,10,56,6,50,1,5.3109774805489,-44,0
46,1,10,98,17,81,1,4.65245071175741,-33,0
46,1,10,49,99,-50,0,4.31587248930009,-49,0
46,1,10,51,3,48,1,4.79998387148953,-47,0
46,1,10,19,93,-74,0,4.84942038095323,-43,0
46,1,10,51,0,51,1,4.40158462803811,-50,0
46,1,10,45,94,-49,0,4.66706682526274,-44,0
46,1,10,49,98,-49,0,4.48917793983128,-48,0
46,1,10,73,17,56,1,5.03929423019872,-33,0
46,1,10,51,2,49,1,5.08746391700697,-48,0
46,1,10,60,5,55,1,6.077555501397,-45,0
46,1,10,91,42,49,1,5.90773711231304,-8,0
46,1,10,3,88,-85,0,4.56122591489111,-38,0
46,1,1.5,51,0,51,1,0.902218222676311,-50,0
46,1,1.5,51,3,48,1,0.674910789064597,-47,0
46,1,1.5,51,4,47,1,0.817632881691679,-46,0
46,1,1.5,40,56,-16,0,0.778329487540759,-6,0
46,1,1.5,12,63,-51,0,0.740425243362552,-13,0
46,1,1.5,49,96,-47,0,0.753166048729327,-46,0
46,1,1.5,4,89,-85,0,0.779865363409044,-39,0
46,1,1.5,93,36,57,1,0.566602580191102,-14,0
46,1,1.5,13,54,-41,0,0.568633308721473,-4,0
46,1,1.5,85,13,72,1,0.52262154588243,-37,0
46,1,1.5,51,14,37,1,0.686039841151796,-36,0
46,1,1.5,25,70,-45,0,0.731418192619458,-20,0
46,1,1.5,16,71,-55,0,0.823476541234413,-21,0
46,1,1.5,51,4,47,1,0.703555790969403,-46,0
46,1,1.5,59,32,27,1,1.07692905463045,-18,0
46,1,1.5,49,97,-48,0,0.706945714686299,-47,0
46,1,1.5,51,2,49,1,0.567002127878368,-48,0
46,1,1.5,63,30,33,1,0.697091549547622,-20,0
46,1,1.5,49,99,-50,0,0.566440195223549,-49,0
46,1,1.5,81,17,64,1,0.504523502750089,-33,0
46,1,10,51,4,47,1,4.51002443104517,-46,0
46,1,10,97,2,95,1,5.67481108542415,-48,0
46,1,10,49,97,-48,0,5.92095260959468,-47,0
46,1,10,54,3,51,1,4.95711020735325,-47,0
46,1,10,51,3,48,1,4.43989208547282,-47,0
46,1,10,38,52,-14,0,5.04802672937512,-2,0
46,1,10,49,96,-47,0,5.17485525560915,-46,0
46,1,10,26,78,-52,0,4.55359162195236,-28,0
46,1,10,90,19,71,1,4.48443028717884,-31,0
46,1,10,27,59,-32,0,4.20185258158017,-9,0
46,1,10,49,96,-47,0,4.29868167595123,-46,0
46,1,10,51,4,47,1,4.75945470907027,-46,0
46,1,10,49,100,-51,0,3.80219897840288,-50,0
46,1,10,34,74,-40,0,3.61102824876434,-24,0
46,1,10,53,47,6,1,3.59649937594077,-3,0
46,1,10,56,25,31,1,5.21385807261686,-25,0
46,1,10,51,2,49,1,4.98270105221309,-48,0
46,1,10,73,39,34,1,4.1601738948666,-11,0
46,1,10,66,9,57,1,3.93166048711282,-41,0
46,1,10,17,94,-77,0,4.35974538917071,-44,0
46,1,1.5,51,2,49,1,0.875349924928742,-48,0
46,1,1.5,64,24,40,1,0.489394575328333,-26,0
46,1,1.5,91,40,51,1,0.390844493493205,-10,0
46,1,1.5,60,13,47,1,0.400167150219204,-37,0
46,1,1.5,49,98,-49,0,0.616871908307076,-48,0
46,1,1.5,79,41,38,1,0.384960512572434,-9,0
46,1,1.5,98,16,82,1,0.842343255440937,-34,0
46,1,1.5,12,73,-61,0,0.849660476116696,-23,0
46,1,1.5,49,96,-47,0,0.520410104538314,-46,0
46,1,1.5,49,100,-51,0,0.492487587442156,-50,0
46,1,1.5,89,33,56,1,0.433192514174152,-17,0
46,1,1.5,10,58,-48,0,0.496552710043034,-8,0
46,1,1.5,49,98,-49,0,0.629906326241326,-48,0
46,1,1.5,100,20,80,1,0.453999050601851,-30,0
46,1,1.5,71,33,38,1,0.836718430713518,-17,0
46,1,1.5,1,70,-69,0,0.820088083768496,-20,0
46,1,1.5,51,4,47,1,0.428831579658436,-46,0
46,1,1.5,94,15,79,0,0.40487411498907,35,0
46,1,1.5,49,99,-50,0,0.574308718409156,-49,0
46,1,1.5,51,0,51,1,0.456965233839583,-50,0
46,1,10,51,3,48,1,4.05977563015767,-47,0
46,1,10,94,23,71,1,4.33050656411797,-27,0
46,1,10,0,71,-71,0,3.95862482290249,-21,0
46,1,10,87,35,52,1,4.00941136365873,-15,0
46,1,10,73,38,35,1,4.19419079684303,-12,0
46,1,10,51,0,51,1,4.53163116250653,-50,0
46,1,10,51,4,47,1,4.88045680394862,-46,0
46,1,10,51,2,49,1,4.21455929707736,-48,0
46,1,10,84,47,37,1,3.4720487081504,-3,0
46,1,10,27,78,-51,0,3.29415579058696,-28,0
46,1,10,59,20,39,1,3.50692885302124,-30,0
46,1,10,49,96,-47,0,4.08766479048063,-46,0
46,1,10,31,72,-41,0,3.90913846160402,-22,0
46,1,10,49,98,-49,0,3.18590329846484,-48,0
46,1,10,59,21,38,1,3.09131973527838,-29,0
46,1,10,49,100,-51,0,3.440780987381,-50,0
46,1,10,51,0,51,1,3.60886116084293,-50,0
46,1,10,52,44,8,1,3.74563109286828,-6,0
46,1,10,44,85,-41,0,3.57308295014082,-35,0
46,1,10,82,35,47,1,3.23187290717033,-15,0
46,1,1.5,91,29,62,1,0.613455592480022,-21,0
46,1,1.5,51,3,48,1,0.406104281923035,-47,0
46,1,1.5,51,2,49,1,0.334910019300878,-48,0
46,1,1.5,94,13,81,1,0.418300016288413,-37,0
46,1,1.5,49,98,-49,0,0.506332097400445,-48,0
46,1,1.5,31,81,-50,1,0.399044751189649,31,0
46,1,1.5,41,51,-10,0,0.608366674772697,-1,0
46,1,1.5,71,10,61,1,0.55302858966752,-40,0
46,1,1.5,49,99,-50,0,0.531823971745325,-49,0
46,1,1.5,80,10,70,1,0.503228821704397,-40,0
46,1,1.5,78,13,65,1,0.626588980900124,-37,0
46,1,1.5,49,97,-48,0,0.578662688290933,-47,0
46,1,1.5,33,74,-41,0,0.7400850779959,-24,0
46,1,1.5,98,37,61,1,0.399438800493954,-13,0
46,1,1.5,74,50,24,1,0.752803523355396,0,0
46,1,1.5,49,98,-49,0,0.547530227224343,-48,0
46,1,1.5,49,100,-51,0,0.502928977657575,-50,0
46,1,1.5,49,80,-31,0,0.60362745297607,-30,0
46,1,1.5,51,0,51,1,0.667708300868981,-50,0
46,1,1.5,58,38,20,1,0.737089570146054,-12,0
47,1,10,0,68,-68,0,1.83661759126699,-18,0
47,1,10,50,100,-50,0,1.35592267921311,-50,0
47,1,10,30,100,-70,0,2.51121158748902,-50,0
47,1,10,48,100,-52,0,1.53252227270605,-50,0
47,1,10,5,83,-78,0,1.41649600548408,-33,0
47,1,10,100,0,100,1,2.7036642516905,-50,0
47,1,10,3,100,-97,0,2.26096407226214,-50,0
47,1,10,50,43,7,1,2.63626753271092,-7,0
47,1,10,75,0,75,1,3.05216568949618,-50,0
47,1,10,48,100,-52,0,2.17147590919012,-50,0
47,1,10,100,15,85,1,2.22211233764028,-35,0
47,1,10,53,0,53,1,2.10268298807023,-50,0
47,1,10,28,85,-57,0,2.13201826169461,-35,0
47,1,10,53,40,13,1,2.31995535378883,-10,0
47,1,10,53,40,13,1,2.75661326593581,-10,0
47,1,10,0,68,-68,0,3.09579288263012,-18,0
47,1,10,50,43,7,1,2.5658346513992,-7,0
47,1,10,53,0,53,1,2.91250772053172,-50,0
47,1,10,48,60,-12,0,2.83770002364327,-10,0
47,1,10,48,60,-12,0,2.35764987912808,-10,0
47,1,1.5,28,85,-57,0,0.725663690864167,-35,0
47,1,1.5,75,0,75,1,0.626280417065573,-50,0
47,1,1.5,53,23,30,1,0.818898396879376,-27,0
47,1,1.5,25,55,-30,0,0.819527769175693,-5,0
47,1,1.5,25,55,-30,0,0.924177316572241,-5,0
47,1,1.5,80,45,35,1,0.904765011739073,-5,0
47,1,1.5,48,80,-32,0,0.982075902225915,-30,0
47,1,1.5,98,38,60,1,1.36010212179644,-12,0
47,1,1.5,30,100,-70,0,0.859421981844207,-50,0
47,1,1.5,85,15,70,1,0.754689226809205,-35,0
47,1,1.5,50,100,-50,0,1.14197458684976,-50,0
47,1,1.5,3,100,-97,0,0.921956002588558,-50,0
47,1,1.5,5,83,-78,0,1.15060618778989,-33,0
47,1,1.5,48,80,-32,0,1.26589238356792,-30,0
47,1,1.5,100,15,85,1,0.91255610558801,-35,0
47,1,1.5,85,15,70,1,1.18984866840219,-35,0
47,1,1.5,100,0,100,1,1.21579588836903,-50,0
47,1,1.5,53,23,30,0,1.16043165335759,27,0
47,1,1.5,98,38,60,1,1.37976844817786,-12,0
47,1,1.5,80,45,35,1,0.782393704077549,-5,0
47,1,10,98,38,60,1,2.85408349721365,-12,0
47,1,10,51,0,51,1,1.98135929020646,-50,0
47,1,10,42,99,-57,1,3.29387324214622,49,0
47,1,10,49,100,-51,0,1.85188234366797,-50,0
47,1,10,51,1,50,1,1.86567501736681,-49,0
47,1,10,27,72,-45,0,1.49494541102467,-22,0
47,1,10,12,55,-43,0,3.12342661508046,-5,0
47,1,10,74,22,52,1,3.18407398515228,-28,0
47,1,10,51,3,48,1,2.6099717203997,-47,0
47,1,10,3,71,-68,0,2.10730669344957,-21,0
47,1,10,92,9,83,1,2.55996136526483,-41,0
47,1,10,67,0,67,0,3.19522674080872,50,0
47,1,10,49,98,-49,0,3.30912553173221,-48,0
47,1,10,49,96,-47,0,4.35441394516056,-46,0
47,1,10,7,55,-48,0,2.72572050664894,-5,0
47,1,10,49,99,-50,0,2.23433432974707,-49,0
47,1,10,90,33,57,1,3.45826587222291,-17,0
47,1,10,94,43,51,1,2.80959380377863,-7,0
47,1,10,73,41,32,1,3.10684593574842,-9,0
47,1,10,49,97,-48,0,2.60009713666659,-47,0
47,1,1.5,51,18,33,1,0.819428433185749,-32,0
47,1,1.5,84,22,62,1,1.11604569455449,-28,0
47,1,1.5,51,2,49,0,1.05670178859873,48,0
47,1,1.5,51,0,51,0,0.784013870383205,50,0
47,1,1.5,12,81,-69,0,1.0659576300859,-31,0
47,1,1.5,49,97,-48,0,1.36058413959836,-47,0
47,1,1.5,51,1,50,0,0.891887988593226,49,0
47,1,1.5,41,60,-19,1,1.16187074225309,10,0
47,1,1.5,36,63,-27,0,1.3171559849925,-13,0
47,1,1.5,30,79,-49,0,0.89777593686631,-29,0
47,1,1.5,49,96,-47,0,0.887054981185429,-46,0
47,1,1.5,35,74,-39,0,0.773066018111422,-24,0
47,1,1.5,16,55,-39,0,0.767741462512276,-5,0
47,1,1.5,56,25,31,0,0.890366791722045,25,0
47,1,1.5,51,0,51,1,0.856303344984553,-50,0
47,1,1.5,90,17,73,1,0.783628256140219,-33,0
47,1,1.5,39,66,-27,0,1.13756201626347,-16,0
47,1,1.5,49,99,-50,0,1.10153567573252,-49,0
47,1,1.5,51,1,50,1,0.986877752586224,-49,0
47,1,1.5,26,56,-30,0,0.764850821904474,-6,0
47,1,10,51,2,49,0,3.34468561625908,48,0
47,1,10,18,85,-67,0,2.5326879548702,-35,0
47,1,10,99,6,93,0,3.22329337289557,44,0
47,1,10,61,32,29,1,2.03186999081663,-18,0
47,1,10,49,100,-51,1,2.6057094367352,50,0
47,1,10,51,0,51,0,2.49501908827187,50,0
47,1,10,72,3,69,0,2.00431360114999,47,0
47,1,10,22,93,-71,0,2.73218687628469,-43,0
47,1,10,49,99,-50,0,3.07948675184161,-49,0
47,1,10,26,92,-66,0,2.27804876260598,-42,0
47,1,10,38,50,-12,0,2.55540547227611,0,0
47,1,10,51,1,50,0,2.91061557155808,49,0
47,1,10,64,26,38,1,2.64327713457897,-24,0
47,1,10,49,97,-48,0,2.62722062669673,-47,0
47,1,10,51,3,48,0,2.85119872146242,47,0
47,1,10,30,94,-64,0,2.44182265043855,-44,0
47,1,10,38,87,-49,0,3.59308313615838,-37,0
47,1,10,62,36,26,1,3.30638151250787,-14,0
47,1,10,49,100,-51,0,2.83899175804618,-50,0
47,1,10,10,95,-85,0,3.39816246749069,-45,0
47,1,1.5,52,10,42,1,1.19558926218269,-40,0
47,1,1.5,45,63,-18,0,1.13284887183909,-13,0
47,1,1.5,38,53,-15,0,0.936177910387414,-3,0
47,1,1.5,93,13,80,1,0.571424958257921,-37,0
47,1,1.5,49,100,-51,0,0.741454080931362,-50,0
47,1,1.5,49,98,-49,0,0.688086096077313,-48,0
47,1,1.5,49,99,-50,0,0.605404830806947,-49,0
47,1,1.5,20,90,-70,0,0.646019321033236,-40,0
47,1,1.5,51,0,51,0,0.645369788297103,50,0
47,1,1.5,61,23,38,1,0.941286932553339,-27,0
47,1,1.5,51,1,50,0,0.792603317675457,49,0
47,1,1.5,51,3,48,0,0.841923086087263,47,0
47,1,1.5,49,98,-49,0,1.08918502335837,-48,0
47,1,1.5,82,27,55,1,1.02249941809714,-23,0
47,1,1.5,56,38,18,1,0.910488744058966,-12,0
47,1,1.5,54,16,38,0,0.923102948372616,34,0
47,1,1.5,63,24,39,NaN,NaN,0,0
47,1,1.5,49,100,-51,0,0.778379577108353,-50,0
47,1,1.5,73,27,46,1,0.66836332046114,-23,0
47,1,1.5,4,83,-79,0,0.546361132135644,-33,0
47,1,10,51,3,48,1,2.85129952366333,-47,0
47,1,10,66,40,26,0,1.81798861118477,10,0
47,1,10,51,4,47,0,1.76995911096128,46,0
47,1,10,14,84,-70,1,2.3398757017203,34,0
47,1,10,54,24,30,0,1.79113343828976,26,0
47,1,10,49,98,-49,0,1.28708797099898,-48,0
47,1,10,49,97,-48,0,0.931614319777509,-47,0
47,1,10,24,55,-31,0,3.03010173691473,-5,0
47,1,10,2,74,-72,0,2.45406993473625,-24,0
47,1,10,88,44,44,1,2.10869923005521,-6,0
47,1,10,49,99,-50,0,2.46527803996469,-49,0
47,1,10,39,89,-50,0,2.47927231806534,-39,0
47,1,10,70,37,33,1,2.32525278443245,-13,0
47,1,10,63,18,45,1,2.57719817529687,-32,0
47,1,10,49,96,-47,0,1.86715112815909,-46,0
47,1,10,32,51,-19,0,2.2490752772519,-1,0
47,1,10,51,4,47,0,1.83975675512193,46,0
47,1,10,4,55,-51,0,2.55103835432237,-5,0
47,1,10,46,86,-40,0,2.48959849566563,-36,0
47,1,10,51,0,51,0,2.45490164454168,50,0
47,1,1.5,49,98,-49,0,0.703585809249489,-48,0
47,1,1.5,94,35,59,1,0.956209690573814,-15,0
47,1,1.5,43,82,-39,0,0.878846016388707,-32,0
47,1,1.5,20,56,-36,0,0.788797026518296,-6,0
47,1,1.5,51,2,49,0,0.758085711197054,48,0
47,1,1.5,49,99,-50,0,0.640771741660501,-49,0
47,1,1.5,49,100,-51,0,0.608042182971985,-50,0
47,1,1.5,98,4,94,0,0.720697624548848,46,0
47,1,1.5,41,58,-17,1,1.10065228188614,8,0
47,1,1.5,40,55,-15,0,0.801288435421156,-5,0
47,1,1.5,49,99,-50,0,0.929224391200478,-49,0
47,1,1.5,49,97,-48,0,0.661216627597241,-47,0
47,1,1.5,84,30,54,1,0.72387637617976,-20,0
47,1,1.5,84,24,60,1,0.703825168660842,-26,0
47,1,1.5,49,100,-51,0,0.908491760794277,-50,0
47,1,1.5,49,98,-49,0,0.673141344848773,-48,0
47,1,1.5,23,89,-66,0,0.687094202407025,-39,0
47,1,1.5,2,64,-62,0,0.596378085234392,-14,0
47,1,1.5,36,64,-28,0,0.901719319015683,-14,0
47,1,1.5,28,60,-32,0,0.75436079490828,-10,0
47,1,10,84,46,38,1,2.8071884799574,-4,0
47,1,10,51,2,49,0,2.47982874622176,48,0
47,1,10,10,56,-46,0,2.05378145716168,-6,0
47,1,10,85,1,84,0,2.53236941991054,49,0
47,1,10,90,34,56,1,2.3996224499333,-16,0
47,1,10,49,98,-49,0,3.51952611968227,-48,0
47,1,10,49,96,-47,0,2.19544997186858,-46,0
47,1,10,51,3,48,0,3.07537255577517,47,0
47,1,10,97,5,92,0,1.80927160328793,45,0
47,1,10,22,81,-59,0,1.82592779263177,-31,0
47,1,10,49,99,-50,0,1.52919983211723,-49,0
47,1,10,51,0,51,0,2.66706388843522,50,0
47,1,10,44,85,-41,0,2.93697992936541,-35,0
47,1,10,81,47,34,0,2.66835342351624,3,0
47,1,10,45,96,-51,0,2.57824395232637,-46,0
47,1,10,51,4,47,0,2.93952234418248,46,0
47,1,10,94,48,46,1,2.61484028349332,-2,0
47,1,10,49,98,-49,0,2.85476821908196,-48,0
47,1,10,11,61,-50,0,2.44537088795732,-11,0
47,1,10,84,7,77,0,2.83603953645616,43,0
47,1,1.5,71,7,64,1,0.635978688582327,-43,0
47,1,1.5,50,39,11,0,0.842652527477185,11,0
47,1,1.5,16,71,-55,0,0.745863719086628,-21,0
47,1,1.5,48,62,-14,0,0.829195983307727,-12,0
47,1,1.5,51,3,48,0,0.821186790146385,47,0
47,1,1.5,51,2,49,0,0.661215161384462,48,0
47,1,1.5,51,0,51,0,0.731851113316225,50,0
47,1,1.5,49,98,-49,0,0.55181947975143,-48,0
47,1,1.5,51,13,38,0,0.681793472782374,37,0
47,1,1.5,35,67,-32,0,0.631088132282457,-17,0
47,1,1.5,51,0,51,0,0.57436728290304,50,0
47,1,1.5,33,95,-62,0,0.816362213468892,-45,0
47,1,1.5,49,99,-50,0,0.567703340951994,-49,0
47,1,1.5,43,88,-45,0,0.641594654183791,-38,0
47,1,1.5,75,20,55,1,0.688932468023268,-30,0
47,1,1.5,20,100,-80,0,0.630299675784045,-50,0
47,1,1.5,51,2,49,0,0.526213521057798,48,0
47,1,1.5,97,9,88,0,0.634133091896729,41,0
47,1,1.5,49,96,-47,0,0.617523454839102,-46,0
47,1,1.5,55,0,55,0,0.440831856427394,50,0
48,1,10,98,38,60,NaN,NaN,0,0
48,1,10,98,38,60,1,3.28096939087845,-12,0
48,1,10,5,83,-78,1,3.26290556997992,33,0
48,1,10,48,80,-32,1,1.90222883649403,30,0
48,1,10,48,100,-52,1,3.25953069987008,50,0
48,1,10,100,15,85,0,2.65086351148784,35,0
48,1,10,25,55,-30,1,1.97816396364942,5,0
48,1,10,48,80,-32,1,1.26741529378342,30,0
48,1,10,50,43,7,1,3.53799138963223,-7,0
48,1,10,53,40,13,1,3.55785169563023,-10,0
48,1,10,50,43,7,1,4.6571814501076,-7,0
48,1,10,85,15,70,0,5.37643785704859,35,0
48,1,10,48,100,-52,0,3.25908276991686,-50,0
48,1,10,100,0,100,0,2.06642706197454,50,0
48,1,10,0,68,-68,0,5.14357915107394,-18,0
48,1,10,53,0,53,0,3.53956281009596,50,0
48,1,10,85,15,70,0,3.49550805409672,35,0
48,1,10,80,45,35,1,5.17336319532478,-5,0
48,1,10,100,0,100,0,5.4000498514506,50,0
48,1,10,25,55,-30,1,5.1532598634949,5,0
48,1,1.5,0,68,-68,0,1.12319907039637,-18,0
48,1,1.5,28,85,-57,NaN,NaN,0,0
48,1,1.5,50,100,-50,0,0.999117336061317,-50,0
48,1,1.5,53,23,30,1,1.30443952855421,-27,0
48,1,1.5,48,60,-12,1,1.01309883600334,10,0
48,1,1.5,80,45,35,1,0.654442552593537,-5,0
48,1,1.5,50,100,-50,1,1.1977493535378,50,0
48,1,1.5,3,100,-97,0,0.719724497408606,-50,0
48,1,1.5,53,0,53,0,0.804353204905055,50,0
48,1,1.5,30,100,-70,0,1.03761182213202,-50,0
48,1,1.5,100,15,85,0,1.03767083742423,35,0
48,1,1.5,5,83,-78,0,1.42162966600154,-33,0
48,1,1.5,75,0,75,0,0.870244730322156,50,0
48,1,1.5,75,0,75,0,0.636843523243442,50,0
48,1,1.5,28,85,-57,NaN,NaN,0,0
48,1,1.5,48,60,-12,1,1.06082280556438,10,0
48,1,1.5,30,100,-70,0,1.16411538416287,-50,0
48,1,1.5,3,100,-97,0,0.911455754074268,-50,0
48,1,1.5,53,23,30,1,1.40471169544617,-27,0
48,1,1.5,53,40,13,1,0.894026806170586,-10,0
48,1,10,94,13,81,0,5.71251839649631,37,0
48,1,10,56,0,56,0,6.5897877831012,50,0
48,1,10,8,66,-58,0,5.48834777250886,-16,0
48,1,10,2,99,-97,0,4.86232421407476,-49,0
48,1,10,50,97,-47,1,5.06955744005973,47,0
48,1,10,96,15,81,0,4.49219806422479,35,0
48,1,10,91,11,80,0,4.96205387992086,39,0
48,1,10,51,9,42,0,4.66934813727858,41,0
48,1,10,0,87,-87,0,4.39601738203783,-37,0
48,1,10,46,79,-33,1,3.68591824732721,29,0
48,1,10,78,26,52,1,3.57856314181117,-24,0
48,1,10,42,82,-40,1,3.85323475452606,32,0
48,1,10,50,91,-41,1,4.98849677707767,41,0
48,1,10,86,39,47,1,5.11773080582498,-11,0
48,1,10,67,46,21,1,5.12240181374364,-4,0
48,1,10,23,96,-73,0,3.51898185734171,-46,0
48,1,10,88,14,74,0,4.64430511288811,36,0
48,1,10,85,15,70,0,5.03618995600846,35,0
48,1,10,40,65,-25,1,4.03611187986098,15,0
48,1,10,80,17,63,0,4.56412124901544,33,0
48,1,1.5,60,10,50,0,1.13263309147442,40,0
48,1,1.5,9,100,-91,0,0.976635430066381,-50,0
48,1,1.5,100,0,100,0,0.707295723550487,50,0
48,1,1.5,55,24,31,1,1.29661394993309,-26,0
48,1,1.5,69,50,19,1,0.790571843856014,0,0
48,1,1.5,6,77,-71,0,0.768592484528199,-27,0
48,1,1.5,96,30,66,1,0.779157327138819,-20,0
48,1,1.5,55,37,18,1,0.837838353007101,-13,0
48,1,1.5,25,55,-30,NaN,NaN,0,0
48,1,1.5,45,76,-31,1,0.737123021273874,26,0
48,1,1.5,17,60,-43,1,0.443088517524302,10,0
48,1,1.5,17,85,-68,0,0.835045571904629,-35,0
48,1,1.5,9,97,-88,0,1.13099459145451,-47,0
48,1,1.5,70,13,57,0,1.05631674733013,37,0
48,1,1.5,6,91,-85,0,0.871655966329854,-41,0
48,1,1.5,70,9,61,0,0.598328510124702,41,0
48,1,1.5,45,57,-12,1,0.752278596337419,7,0
48,1,1.5,36,71,-35,1,0.732325185439549,21,0
48,1,1.5,41,72,-31,1,0.696209273475688,22,0
48,1,1.5,45,79,-34,1,0.662136538012419,29,0
48,1,10,41,72,-31,1,4.02410464407876,22,0
48,1,10,2,52,-50,0,4.26467383041745,-2,0
48,1,10,47,59,-12,1,3.63198117376305,9,0
48,1,10,93,30,63,1,4.26394585252274,-20,0
48,1,10,89,19,70,0,4.51919225981692,31,0
48,1,10,69,50,19,1,3.26709785725689,0,0
48,1,10,40,90,-50,1,3.80974632571451,40,0
48,1,10,16,57,-41,0,3.67435784178087,-7,0
48,1,10,39,56,-17,1,3.74502557638334,6,0
48,1,10,92,23,69,0,3.69228053902043,27,0
48,1,10,77,27,50,1,3.31290914386045,-23,0
48,1,10,49,91,-42,1,4.57353107747622,41,0
48,1,10,93,13,80,0,2.9674510328332,37,0
48,1,10,6,79,-73,0,3.73737924313173,-29,0
48,1,10,78,28,50,1,2.22140863345703,-22,0
48,1,10,56,49,7,1,3.57340828154702,-1,0
48,1,10,13,87,-74,0,2.02394079405349,-37,0
48,1,10,2,70,-68,0,3.95055322279222,-20,0
48,1,10,36,66,-30,1,3.56911335891346,16,0
48,1,10,49,69,-20,1,3.72309643507469,19,0
48,1,1.5,73,35,38,1,0.689683131698985,-15,0
48,1,1.5,89,17,72,0,0.719007516221609,33,0
48,1,1.5,77,5,72,0,0.714957085554488,45,0
48,1,1.5,22,99,-77,0,1.14367628813488,-49,0
48,1,1.5,94,18,76,1,0.826943244494032,-32,0
48,1,1.5,45,81,-36,1,0.858929916576017,31,0
48,1,1.5,74,7,67,0,0.817506290972233,43,0
48,1,1.5,16,69,-53,0,1.32952067459701,-19,0
48,1,1.5,42,66,-24,1,1.46946250234032,16,0
48,1,1.5,97,13,84,0,0.827493443212006,37,0
48,1,1.5,80,38,42,1,0.658828380866908,-12,0
48,1,1.5,41,61,-20,1,0.745423654851038,11,0
48,1,1.5,95,25,70,1,0.644749010738451,-25,0
48,1,1.5,39,77,-38,1,0.500756752386224,27,0
48,1,1.5,49,64,-15,1,0.51335010927869,14,0
48,1,1.5,84,43,41,1,0.606001235311851,-7,0
48,1,1.5,39,52,-13,1,0.47072088503046,2,0
48,1,1.5,60,10,50,0,0.916645803605206,40,0
48,1,1.5,50,98,-48,1,0.56063677900238,48,0
48,1,1.5,48,84,-36,1,0.435934833891224,34,0
48,1,10,98,4,94,0,4.57573443837464,46,0
48,1,10,7,88,-81,0,4.04965021507815,-38,0
48,1,10,97,16,81,0,3.680313624267,34,0
48,1,10,82,31,51,1,3.5902456100448,-19,0
48,1,10,3,80,-77,0,3.71939349843888,-30,0
48,1,10,88,17,71,0,3.73150483577047,33,0
48,1,10,13,77,-64,0,2.98346911132103,-27,0
48,1,10,90,26,64,1,2.41672186367214,-24,0
48,1,10,100,11,89,0,3.98465931479586,39,0
48,1,10,7,54,-47,0,2.32997556909686,-4,0
48,1,10,100,21,79,0,2.92532362206839,29,0
48,1,10,64,7,57,0,3.8811270094011,43,0
48,1,10,48,69,-21,1,2.67123919352889,19,0
48,1,10,35,67,-32,1,2.66118276235647,17,0
48,1,10,6,74,-68,0,1.7151187362615,-24,0
48,1,10,26,51,-25,1,3.54237611824647,1,0
48,1,10,45,61,-16,1,1.99365530285286,11,0
48,1,10,88,3,85,0,0.97756391344592,47,0
48,1,10,38,66,-28,1,3.50603294227039,16,0
48,1,10,49,70,-21,1,4.21468638489023,20,0
48,1,1.5,31,63,-32,1,0.839281845837831,13,0
48,1,1.5,98,16,82,0,0.646610742609482,34,0
48,1,1.5,2,83,-81,0,0.558648585749324,-33,0
48,1,1.5,100,30,70,0,0.833245787827764,20,0
48,1,1.5,12,69,-57,0,0.816544084635098,-19,0
48,1,1.5,34,52,-18,1,0.648487136641052,2,0
48,1,1.5,41,64,-23,1,0.839785125572234,14,0
48,1,1.5,47,72,-25,1,1.18304574053036,22,0
48,1,1.5,24,78,-54,1,0.768455759563949,28,0
48,1,1.5,38,72,-34,1,0.922376154921949,22,0
48,1,1.5,2,78,-76,0,1.42102375091054,-28,0
48,1,1.5,89,12,77,NaN,NaN,0,0
48,1,1.5,39,74,-35,1,0.65231360233156,24,0
48,1,1.5,37,76,-39,1,0.666976161126513,26,0
48,1,1.5,37,90,-53,1,0.625559500127565,40,0
48,1,1.5,40,91,-51,1,0.673613368999213,41,0
48,1,1.5,2,65,-63,1,0.471590719535016,15,0
48,1,1.5,60,48,12,1,0.453521766932681,-2,0
48,1,1.5,48,54,-6,1,0.628193196374923,4,0
48,1,1.5,97,26,71,1,0.436222579388414,-24,0
48,1,10,49,77,-28,1,4.26063989469549,27,0
48,1,10,65,21,44,1,3.79530956468079,-29,0
48,1,10,65,1,64,0,3.40457277122186,49,0
48,1,10,54,36,18,1,3.06115673697786,-14,0
48,1,10,92,13,79,0,3.94778536749072,37,0
48,1,10,94,15,79,0,3.94307110615773,35,0
48,1,10,86,38,48,1,2.35438115464058,-12,0
48,1,10,36,65,-29,1,2.60500310652424,15,0
48,1,10,46,58,-12,1,3.05437693931162,8,0
48,1,10,17,93,-76,0,2.87688193819486,-43,0
48,1,10,48,67,-19,1,2.10555458825547,17,0
48,1,10,94,25,69,0,4.10077984532109,25,0
48,1,10,66,44,22,1,4.29737125220709,-6,0
48,1,10,40,67,-27,1,5.61466732400004,17,0
48,1,10,93,31,62,1,4.8872349121375,-19,0
48,1,10,88,15,73,0,3.79591694602277,35,0
48,1,10,5,54,-49,0,4.94848585373256,-4,0
48,1,10,9,89,-80,0,5.26370392634999,-39,0
48,1,10,92,17,75,0,4.0456467034528,33,0
48,1,10,63,11,52,0,4.7729911422357,39,0
48,1,1.5,39,72,-33,1,0.574247325537726,22,0
48,1,1.5,43,86,-43,1,0.392215108964592,36,0
48,1,1.5,36,72,-36,1,0.680919539416209,22,0
48,1,1.5,53,38,15,1,0.574919587059412,-12,0
48,1,1.5,41,79,-38,1,0.552192455972545,29,0
48,1,1.5,44,58,-14,1,0.330190736800432,8,0
48,1,1.5,72,48,24,1,0.421460684272461,-2,0
48,1,1.5,23,72,-49,1,0.349436696851626,22,0
48,1,1.5,79,33,46,1,0.431375991727691,-17,0
48,1,1.5,43,73,-30,1,0.423450343718287,23,0
48,1,1.5,97,12,85,1,0.44609060138464,-38,0
48,1,1.5,41,60,-19,1,0.741349031683058,10,0
48,1,1.5,35,67,-32,1,0.42403976386413,17,0
48,1,1.5,86,43,43,1,0.367980337992776,-7,0
48,1,1.5,97,30,67,1,0.417294422280975,-20,0
48,1,1.5,88,30,58,1,0.281315418542363,-20,0
48,1,1.5,18,52,-34,1,0.463325275224634,2,0
48,1,1.5,6,75,-69,0,0.773941985331476,-25,0
48,1,1.5,59,39,20,1,0.575909651583061,-11,0
48,1,1.5,96,17,79,0,0.993916289880872,33,0
49,1,10,100,15,85,0,1.84591975691728,35,0
49,1,10,28,85,-57,0,1.98637432482792,-35,0
49,1,10,3,100,-97,0,2.73090244620107,-50,0
49,1,10,48,80,-32,0,3.07956460298738,-30,0
49,1,10,53,23,30,0,2.75018227071268,27,0
49,1,10,25,55,-30,0,3.12147605372593,-5,0
49,1,10,75,0,75,0,2.87007003085455,50,0
49,1,10,98,38,60,1,2.77273545361822,-12,0
49,1,10,3,100,-97,0,2.07933623768622,-50,0
49,1,10,48,80,-32,1,2.30052692641038,30,0
49,1,10,80,45,35,1,3.03379073599353,-5,0
49,1,10,5,83,-78,0,2.24174723296892,-33,0
49,1,10,50,43,7,0,2.39366442029132,7,0
49,1,10,5,83,-78,0,2.32227551564574,-33,0
49,1,10,100,15,85,0,3.05482857022434,35,0
49,1,10,25,55,-30,0,3.13412631937535,-5,0
49,1,10,48,60,-12,0,4.18608071230119,-10,0
49,1,10,98,38,60,1,3.54798805754399,-12,0
49,1,10,28,85,-57,0,3.4472529264749,-35,0
49,1,10,0,68,-68,0,2.15923770703375,-18,0
49,1,1.5,100,0,100,0,0.757134400133509,50,0
49,1,1.5,50,100,-50,1,1.07245448732283,50,0
49,1,1.5,53,40,13,0,1.21512672805693,10,0
49,1,1.5,50,100,-50,1,0.783773599425331,50,0
49,1,1.5,48,100,-52,0,1.2337350192829,-50,0
49,1,1.5,85,15,70,0,1.40166343789315,35,0
49,1,1.5,53,0,53,0,0.946949600183871,50,0
49,1,1.5,100,0,100,0,0.598935883608647,50,0
49,1,1.5,30,100,-70,0,0.576259170775302,-50,0
49,1,1.5,53,23,30,0,1.11491467460291,27,0
49,1,1.5,48,100,-52,1,0.912195917626377,50,0
49,1,1.5,80,45,35,1,1.41351790720364,-5,0
49,1,1.5,75,0,75,0,0.830764070793521,50,0
49,1,1.5,85,15,70,0,1.1513871451607,35,0
49,1,1.5,30,100,-70,1,1.05074658599915,50,0
49,1,1.5,50,43,7,0,1.37005591834895,7,0
49,1,1.5,48,60,-12,1,1.37264857953414,10,0
49,1,1.5,53,40,13,0,1.48729859961895,10,0
49,1,1.5,53,0,53,0,0.901235115481541,50,0
49,1,1.5,0,68,-68,NaN,NaN,0,0
49,1,10,28,79,-51,1,2.24106873502024,29,0
49,1,10,10,63,-53,0,2.5370151589741,-13,0
49,1,10,50,23,27,0,2.0289822347695,27,0
49,1,10,92,14,78,0,2.61360368167516,36,0
49,1,10,93,14,79,1,2.83889468252892,-36,0
49,1,10,11,88,-77,0,2.40757014538394,-38,0
49,1,10,82,23,59,0,3.06471352616791,27,0
49,1,10,35,76,-41,1,2.72876285010716,26,0
49,1,10,43,70,-27,1,2.46936037554406,20,0
49,1,10,96,23,73,0,2.65198115166277,27,0
49,1,10,10,58,-48,0,2.91456607839791,-8,0
49,1,10,83,21,62,0,2.63255177164683,29,0
49,1,10,59,37,22,1,2.52116667915834,-13,0
49,1,10,90,13,77,0,2.49451025173767,37,0
49,1,10,55,4,51,0,1.86837396933697,46,0
49,1,10,74,3,71,0,1.16306090168655,47,0
49,1,10,23,97,-74,1,1.63828876300249,47,0
49,1,10,94,12,82,0,1.95687414432177,38,0
49,1,10,71,41,30,1,1.95140217401786,-9,0
49,1,10,53,4,49,0,1.69074204063509,46,0
49,1,1.5,70,22,48,0,0.948600208561402,28,0
49,1,1.5,6,66,-60,0,0.583913990994915,-16,0
49,1,1.5,23,74,-51,0,1.00993187527638,-24,0
49,1,1.5,61,33,28,0,0.867192187928595,17,0
49,1,1.5,90,14,76,0,0.665857552085072,36,0
49,1,1.5,94,7,87,0,0.70451800437877,43,0
49,1,1.5,70,32,38,1,1.18976058298722,-18,0
49,1,1.5,100,0,100,0,0.711785373277962,50,0
49,1,1.5,48,66,-18,1,1.10106320003979,16,0
49,1,1.5,47,51,-4,1,0.889720078383107,1,0
49,1,1.5,46,99,-53,0,1.3109800464008,-49,0
49,1,1.5,98,7,91,0,0.748279837309383,43,0
49,1,1.5,14,51,-37,0,0.991594836697914,-1,0
49,1,1.5,68,43,25,1,0.945517093525268,-7,0
49,1,1.5,95,14,81,0,0.837571776588447,36,0
49,1,1.5,26,80,-54,1,1.42956029594643,30,0
49,1,1.5,87,18,69,0,1.19016929453937,32,0
49,1,1.5,96,11,85,0,1.0081665343605,39,0
49,1,1.5,99,1,98,0,1.05738860776182,49,0
49,1,1.5,90,37,53,1,1.12940139329294,-13,0
49,1,10,100,9,91,0,1.91131984523963,41,0
49,1,10,73,47,26,1,1.58055669086752,-3,0
49,1,10,73,45,28,1,2.32720827980665,-5,0
49,1,10,2,61,-59,0,2.0118244116311,-11,0
49,1,10,17,85,-68,0,2.10914029437117,-35,0
49,1,10,92,13,79,0,1.68237426620908,37,0
49,1,10,55,4,51,0,1.51166917447699,46,0
49,1,10,26,58,-32,0,1.78034738654969,-8,0
49,1,10,5,60,-55,0,1.606987685489,-10,0
49,1,10,47,99,-52,1,1.09628365689423,49,0
49,1,10,14,60,-46,0,1.57289637235226,-10,0
49,1,10,76,21,55,0,2.10145065124379,29,0
49,1,10,9,72,-63,0,1.81874281773344,-22,0
49,1,10,98,14,84,1,2.11397225526161,-36,0
49,1,10,50,11,39,0,1.52725739852758,39,0
49,1,10,24,95,-71,1,2.14047142956406,45,0
49,1,10,55,32,23,0,3.21714792610146,18,0
49,1,10,11,78,-67,0,1.92112379195169,-28,0
49,1,10,94,13,81,0,2.69305465184152,37,0
49,1,10,97,4,93,0,1.92228871170664,46,0
49,1,1.5,79,17,62,0,0.902287868608255,33,0
49,1,1.5,85,15,70,1,1.22760947694769,-35,0
49,1,1.5,11,62,-51,0,0.587550607859157,-12,0
49,1,1.5,26,78,-52,0,0.756887340336107,-28,0
49,1,1.5,94,9,85,0,0.791477171704173,41,0
49,1,1.5,76,50,26,1,1.26478977012448,0,0
49,1,1.5,81,7,74,0,0.606778747751378,43,0
49,1,1.5,97,4,93,0,0.559332645440008,46,0
49,1,1.5,80,45,35,1,0.970023661269806,-5,0
49,1,1.5,96,12,84,0,0.996020651829895,38,0
49,1,1.5,4,54,-50,0,0.821287459868472,-4,0
49,1,1.5,85,17,68,1,1.30923339998117,-33,0
49,1,1.5,21,62,-41,0,0.385900366003625,-12,0
49,1,1.5,96,9,87,0,0.603242201032117,41,0
49,1,1.5,98,10,88,0,1.14785426406888,40,0
49,1,1.5,1,87,-86,0,0.5911813598359,-37,0
49,1,1.5,51,42,9,0,1.31244407710619,8,0
49,1,1.5,36,89,-53,1,1.33302737999475,39,0
49,1,1.5,98,2,96,0,0.584428271162324,48,0
49,1,1.5,17,54,-37,0,0.673749901470728,-4,0
49,1,10,81,33,48,1,2.26945934601827,-17,0
49,1,10,86,15,71,0,3.52337372186594,35,0
49,1,10,90,8,82,0,2.50334502040641,42,0
49,1,10,95,15,80,0,1.48396989097819,35,0
49,1,10,85,16,69,0,1.92785012198146,34,0
49,1,10,98,8,90,0,1.90781115693972,42,0
49,1,10,4,55,-51,0,1.59899343311554,-5,0
49,1,10,28,63,-35,0,2.51962567149894,-13,0
49,1,10,46,60,-14,1,2.35559229273349,10,0
49,1,10,12,52,-40,0,1.57426216558088,-2,0
49,1,10,10,97,-87,0,1.63148289005039,-47,0
49,1,10,40,62,-22,1,2.61338154785335,12,0
49,1,10,15,61,-46,0,2.21462711022468,-11,0
49,1,10,31,68,-37,0,2.79861881141551,-18,0
49,1,10,28,79,-51,1,2.19197935546981,29,0
49,1,10,61,33,28,0,2.47182730748318,17,0
49,1,10,10,59,-49,0,2.30974401457934,-9,0
49,1,10,25,78,-53,1,2.69836203788873,28,0
49,1,10,47,90,-43,1,3.2389005474397,40,0
49,1,10,100,15,85,1,1.45425050903577,-35,0
49,1,1.5,14,73,-59,0,0.530751057958696,-23,0
49,1,1.5,8,64,-56,0,0.486719805281609,-14,0
49,1,1.5,15,74,-59,0,0.420030534209218,-24,0
49,1,1.5,52,34,18,0,1.29201692761853,16,0
49,1,1.5,53,40,13,0,0.577269403263927,10,0
49,1,1.5,93,10,83,0,0.507259487872943,40,0
49,1,1.5,76,21,55,0,0.551870267954655,29,0
49,1,1.5,8,67,-59,0,0.459213697526138,-17,0
49,1,1.5,62,24,38,0,0.73786410613684,26,0
49,1,1.5,22,97,-75,0,0.389197184122168,-47,0
49,1,1.5,73,12,61,0,0.581811417185236,38,0
49,1,1.5,8,65,-57,0,0.503165407222696,-15,0
49,1,1.5,91,13,78,0,0.531722435320262,37,0
49,1,1.5,28,86,-58,1,0.751059076224919,36,0
49,1,1.5,13,71,-58,0,0.401732350699604,-21,0
49,1,1.5,74,3,71,0,0.586334736610297,47,0
49,1,1.5,78,42,36,1,0.851653449179139,-8,0
49,1,1.5,47,84,-37,0,0.490333695604932,-34,0
49,1,1.5,24,95,-71,1,0.839567682123743,45,0
49,1,1.5,93,44,49,1,0.590876017406117,-6,0
49,1,10,38,97,-59,1,0.720200800220482,47,0
49,1,10,86,45,41,1,2.34813101496547,-5,0
49,1,10,43,70,-27,1,2.13542173354654,20,0
49,1,10,3,97,-94,0,1.82668245310197,-47,0
49,1,10,62,6,56,0,1.89066286425805,44,0
49,1,10,23,95,-72,1,1.16798010328785,45,0
49,1,10,91,13,78,0,1.32048928091535,37,0
49,1,10,97,6,91,0,1.14708999166032,44,0
49,1,10,52,14,38,0,2.33292181149591,36,0
49,1,10,94,50,44,1,1.54423890751787,0,0
49,1,10,28,99,-71,1,2.17740209709154,49,0
49,1,10,92,36,56,1,2.61137611186132,-14,0
49,1,10,46,60,-14,1,2.97996433399385,10,0
49,1,10,48,60,-12,1,2.74190503597492,10,0
49,1,10,78,39,39,1,3.01723626651801,-11,0
49,1,10,37,77,-40,1,3.04917808645405,27,0
49,1,10,77,48,29,1,2.41577480174601,-2,0
49,1,10,22,96,-74,1,2.13576593104517,46,0
49,1,10,27,63,-36,0,2.25905607780442,-13,0
49,1,10,47,99,-52,1,2.36234318214701,49,0
49,1,1.5,93,9,84,0,0.916905081772711,41,0
49,1,1.5,48,91,-43,1,1.14489797787974,41,0
49,1,1.5,12,67,-55,0,0.548868895217311,-17,0
49,1,1.5,76,21,55,1,0.759504927438684,-29,0
49,1,1.5,42,95,-53,1,0.674822815286461,45,0
49,1,1.5,11,97,-86,0,0.52873865730362,-47,0
49,1,1.5,2,84,-82,0,0.628766698937397,-34,0
49,1,1.5,64,20,44,0,0.932752828462981,30,0
49,1,1.5,65,48,17,1,0.760672779637389,-2,0
49,1,1.5,39,53,-14,0,0.578682115883566,-3,0
49,1,1.5,52,14,38,0,0.779955903126393,36,0
49,1,1.5,71,29,42,0,1.00522674329113,21,0
49,1,1.5,50,3,47,0,0.877911795279942,47,0
49,1,1.5,73,29,44,0,0.883241907809861,21,0
49,1,1.5,49,88,-39,1,0.959793774760328,38,0
49,1,1.5,93,47,46,1,0.674502444046084,-3,0
49,1,1.5,29,99,-70,1,0.624455249751918,49,0
49,1,1.5,53,2,51,0,0.576414224633481,48,0
49,1,1.5,92,9,83,0,0.602358430915046,41,0
49,1,1.5,39,90,-51,1,0.779021548049059,40,0
50,1,10,100,0,100,0,1.74094567127759,50,0
50,1,10,53,0,53,0,1.76837816589978,50,0
50,1,10,53,23,30,0,2.09106800850714,27,0
50,1,10,80,45,35,0,2.91316605050815,5,0
50,1,10,48,60,-12,1,1.57454286201391,10,0
50,1,10,100,15,85,0,1.00135844713077,35,0
50,1,10,48,80,-32,1,1.04887587216217,30,0
50,1,10,53,40,13,0,2.72709911421407,10,0
50,1,10,50,43,7,0,3.1318008954986,7,0
50,1,10,25,55,-30,1,2.93658735061763,5,0
50,1,10,50,43,7,0,2.52468865865376,7,0
50,1,10,85,15,70,0,2.23348245950183,35,0
50,1,10,48,100,-52,1,2.97748298733495,50,0
50,1,10,53,0,53,0,1.4203088945942,50,0
50,1,10,0,68,-68,1,3.21302621043287,18,0
50,1,10,50,100,-50,1,4.2624357843888,50,0
50,1,10,5,83,-78,1,4.02987080824096,33,0
50,1,10,100,0,100,0,3.43068309070077,50,0
50,1,10,50,100,-50,1,2.99145967088407,50,0
50,1,10,0,68,-68,1,3.34550779568963,18,0
50,1,1.5,85,15,70,0,0.472414469346404,35,0
50,1,1.5,98,38,60,0,0.911124714359175,12,0
50,1,1.5,48,100,-52,1,0.764513592701405,50,0
50,1,1.5,25,55,-30,1,0.680574682541192,5,0
50,1,1.5,3,100,-97,1,0.479243360343389,50,0
50,1,1.5,48,60,-12,1,0.669974689488299,10,0
50,1,1.5,48,80,-32,1,0.556735694757663,30,0
50,1,1.5,75,0,75,0,0.568096652801614,50,0
50,1,1.5,28,85,-57,1,0.594807037094142,35,0
50,1,1.5,98,38,60,0,0.660192843759432,12,0
50,1,1.5,75,0,75,0,0.731566301255953,50,0
50,1,1.5,80,45,35,0,0.960239212785382,5,0
50,1,1.5,53,40,13,0,0.74765213340288,10,0
50,1,1.5,5,83,-78,1,0.887719909194857,33,0
50,1,1.5,30,100,-70,1,0.781776794581674,50,0
50,1,1.5,28,85,-57,1,0.848491357581224,35,0
50,1,1.5,3,100,-97,1,0.624550651293248,50,0
50,1,1.5,30,100,-70,1,0.649217500002123,50,0
50,1,1.5,53,23,30,0,0.936582585447468,27,0
50,1,1.5,100,15,85,0,0.844685066433158,35,0
50,1,10,49,96,-47,1,2.85486828815192,46,0
50,1,10,41,88,-47,1,2.91032672743313,38,0
50,1,10,51,2,49,0,2.79636818828294,48,0
50,1,10,74,42,32,0,2.92715263104765,8,0
50,1,10,18,78,-60,1,2.46788863372058,28,0
50,1,10,49,99,-50,1,2.13134600262856,49,0
50,1,10,18,90,-72,1,2.96004310669377,40,0
50,1,10,36,99,-63,1,2.68351370817982,49,0
50,1,10,51,0,51,0,2.88949146203231,50,0
50,1,10,61,41,20,0,1.78370303305564,9,0
50,1,10,96,24,72,0,2.76908451440977,26,0
50,1,10,49,99,-50,1,1.95585633302107,49,0
50,1,10,84,49,35,0,2.19990652886918,1,0
50,1,10,49,96,-47,1,2.51333649794105,46,0
50,1,10,51,2,49,0,1.59075735445367,48,0
50,1,10,83,28,55,0,3.16080333857099,22,0
50,1,10,51,1,50,0,3.06819580547744,49,0
50,1,10,59,14,45,0,1.65100041602273,36,0
50,1,10,47,78,-31,1,2.26521132723428,28,0
50,1,10,91,15,76,0,4.03193670354085,35,0
50,1,1.5,92,27,65,0,0.661525632196572,23,0
50,1,1.5,33,93,-60,1,0.700902637850959,43,0
50,1,1.5,49,98,-49,1,0.698225697968155,48,0
50,1,1.5,49,97,-48,1,0.88829209911637,47,0
50,1,1.5,85,44,41,0,0.813717896817252,6,0
50,1,1.5,31,88,-57,1,0.75111166498391,38,0
50,1,1.5,51,2,49,0,0.555140454089269,48,0
50,1,1.5,78,9,69,0,0.646517467161175,41,0
50,1,1.5,96,0,96,0,1.31126986950403,50,0
50,1,1.5,51,3,48,0,0.573284850514028,47,0
50,1,1.5,18,81,-63,1,0.783369469398167,31,0
50,1,1.5,49,96,-47,1,0.993395806290209,46,0
50,1,1.5,53,44,9,0,1.08346862206236,6,0
50,1,1.5,67,42,25,0,1.06552143150475,8,0
50,1,1.5,84,35,49,0,1.3216077768011,15,0
50,1,1.5,73,25,48,NaN,NaN,0,0
50,1,1.5,49,98,-49,NaN,NaN,0,0
50,1,1.5,49,99,-50,1,0.649825245607644,49,0
50,1,1.5,51,3,48,0,0.585172179329675,47,0
50,1,1.5,28,78,-50,1,0.547244525980204,28,0
50,1,10,51,2,49,0,0.806064627016895,48,0
50,1,10,90,28,62,0,2.14411635871511,22,0
50,1,10,90,50,40,0,3.98813613067614,0,0
50,1,10,49,100,-51,1,3.44628837128403,50,0
50,1,10,1,53,-52,1,2.4470486031496,3,0
50,1,10,51,1,50,0,2.82314235286321,49,0
50,1,10,45,52,-7,1,3.33652063785121,2,0
50,1,10,48,63,-15,1,2.52464613842312,13,0
50,1,10,51,0,51,0,3.28140345989959,50,0
50,1,10,59,47,12,0,2.34353170596296,3,0
50,1,10,51,2,49,0,2.47377291641897,48,0
50,1,10,49,99,-50,1,1.58451641519787,49,0
50,1,10,75,46,29,0,3.87453534768429,4,0
50,1,10,5,71,-66,1,1.24075378058478,21,0
50,1,10,49,97,-48,1,4.37551202933537,47,0
50,1,10,49,96,-47,1,3.30570668756263,46,0
50,1,10,50,70,-20,1,3.40713203069754,20,0
50,1,10,18,94,-76,1,3.57587821630295,44,0
50,1,10,3,86,-83,1,3.44265069469111,36,0
50,1,10,17,75,-58,1,4.02609274169663,25,0
50,1,1.5,51,4,47,0,0.454277037468273,46,0
50,1,1.5,80,35,45,0,0.661033350857906,15,0
50,1,1.5,19,50,-31,1,0.500412189401686,0,0
50,1,1.5,49,100,-51,1,0.553126975952182,50,0
50,1,1.5,99,21,78,0,0.395845483057201,29,0
50,1,1.5,64,8,56,0,0.53322495566681,42,0
50,1,1.5,52,5,47,0,0.512599725450855,45,0
50,1,1.5,49,97,-48,1,0.66125988092972,47,0
50,1,1.5,94,39,55,0,0.604664759361185,11,0
50,1,1.5,51,2,49,0,0.501423876907211,48,0
50,1,1.5,17,94,-77,1,0.490124866482802,44,0
50,1,1.5,49,100,-51,1,0.455518920556642,50,0
50,1,1.5,49,97,-48,1,0.494239795661997,47,0
50,1,1.5,32,72,-40,1,0.764310155529529,22,0
50,1,1.5,51,4,47,0,0.518945865565911,46,0
50,1,1.5,21,81,-60,1,0.475737643020693,31,0
50,1,1.5,51,3,48,0,0.426466626173351,47,0
50,1,1.5,100,28,72,0,0.529784118290991,22,0
50,1,1.5,12,94,-82,1,0.693835120589938,44,0
50,1,1.5,92,29,63,0,0.859880540228914,21,0
50,1,10,51,4,47,0,3.3780445472803,46,0
50,1,10,92,7,85,0,3.23621914762771,43,0
50,1,10,49,97,-48,1,1.96356605202891,47,0
50,1,10,35,57,-22,1,2.43902254855493,7,0
50,1,10,51,2,49,0,1.95912452373886,48,0
50,1,10,47,91,-44,1,2.0338559775264,41,0
50,1,10,33,74,-41,1,1.88922974292655,24,0
50,1,10,51,3,48,0,2.30264046788216,47,0
50,1,10,35,55,-20,1,1.70742472365964,5,0
50,1,10,83,31,52,0,1.58416489040246,19,0
50,1,10,54,12,42,0,5.60026905027917,38,0
50,1,10,0,91,-91,1,5.30506228661397,41,0
50,1,10,59,12,47,0,3.4379830029211,38,0
50,1,10,65,4,61,0,2.70945689606015,46,0
50,1,10,73,42,31,0,3.57013908872614,8,0
50,1,10,49,96,-47,1,3.39623402972938,46,0
50,1,10,51,1,50,0,2.08573025697842,49,0
50,1,10,51,2,49,0,3.16375885909656,48,0
50,1,10,1,68,-67,1,2.47051462269155,18,0
50,1,10,49,98,-49,1,3.16463052330073,48,0
50,1,1.5,80,41,39,0,0.9660864736652,9,0
50,1,1.5,68,23,45,0,0.68824298097752,27,0
50,1,1.5,51,1,50,0,0.461605907359626,49,0
50,1,1.5,49,82,-33,1,0.500256404164247,32,0
50,1,1.5,13,83,-70,1,0.505634109955281,33,0
50,1,1.5,51,2,49,0,0.454407530487515,48,0
50,1,1.5,86,45,41,0,0.597093597636558,5,0
50,1,1.5,49,96,-47,1,0.583211851364467,46,0
50,1,1.5,49,98,-49,1,0.688465845421888,48,0
50,1,1.5,9,69,-60,1,1.02191659808159,19,0
50,1,1.5,70,4,66,0,0.58194504264975,46,0
50,1,1.5,49,97,-48,1,0.552001290256158,47,0
50,1,1.5,95,30,65,0,0.810769707255531,20,0
50,1,1.5,63,5,58,0,0.627469516533893,45,0
50,1,1.5,18,51,-33,1,0.707532490429003,1,0
50,1,1.5,19,71,-52,1,0.728902190749068,21,0
50,1,1.5,38,81,-43,1,0.661611772258766,31,0
50,1,1.5,49,99,-50,1,0.644269761338364,49,0
50,1,1.5,51,3,48,0,0.707704403961543,47,0
50,1,1.5,51,2,49,0,0.624405496113468,48,0
50,1,10,83,4,79,0,3.36983594897902,46,0
50,1,10,57,44,13,0,2.58794918836793,6,0
50,1,10,63,4,59,0,5.83732503949432,46,0
50,1,10,40,76,-36,1,4.83680563321104,26,0
50,1,10,27,64,-37,1,3.53229390986962,14,0
50,1,10,49,97,-48,1,4.11167527758516,47,0
50,1,10,51,4,47,0,6.43641488719732,46,0
50,1,10,24,60,-36,1,4.42797279439401,10,0
50,1,10,51,1,50,0,4.47610932821408,49,0
50,1,10,51,0,51,0,2.93021921731997,50,0
50,1,10,68,32,36,0,3.47107911505736,18,0
50,1,10,83,2,81,0,4.2930792873376,48,0
50,1,10,56,28,28,0,3.33927272132132,22,0
50,1,10,51,1,50,0,4.35864543833304,49,0
50,1,10,94,10,84,0,2.05016064207302,40,0
50,1,10,51,4,47,0,3.50480716535822,46,0
50,1,10,26,60,-34,1,5.70223982492462,10,0
50,1,10,51,3,48,0,3.89977915154304,47,0
50,1,10,49,96,-47,1,3.52053194236942,46,0
50,1,10,25,90,-65,1,1.98868412803859,40,0
50,1,1.5,54,17,37,0,0.661514635547064,33,0
50,1,1.5,49,96,-47,1,0.563565318880137,46,0
50,1,1.5,29,93,-64,1,0.582287403580267,43,0
50,1,1.5,33,74,-41,1,0.816336554766167,24,0
50,1,1.5,49,100,-51,1,0.880376743676607,50,0
50,1,1.5,60,38,22,0,1.3910637931549,12,0
50,1,1.5,49,98,-49,1,0.680517500150017,48,0
50,1,1.5,9,76,-67,1,0.534555178193841,26,0
50,1,1.5,50,38,12,0,0.873921737191267,12,0
50,1,1.5,51,1,50,0,0.831949532905128,49,0
50,1,1.5,49,98,-49,1,1.02401694940636,48,0
50,1,1.5,47,66,-19,1,1.10409128648462,16,0
50,1,1.5,61,24,37,0,0.852771968930028,26,0
50,1,1.5,38,83,-45,1,0.651558310375549,33,0
50,1,1.5,48,74,-26,1,1.06688134482829,24,0
50,1,1.5,13,61,-48,1,0.728957540297415,11,0
50,1,1.5,49,99,-50,1,0.956932533998042,49,0
50,1,1.5,51,2,49,NaN,NaN,0,0
50,1,1.5,98,50,48,0,0.707845893572085,0,0
50,1,1.5,51,3,48,0,0.944552190834656,47,0
